愛	爱	ài
愛好	爱好	àihào
爸爸	爸爸	bàba
白	白	bái
八	八	bā
白天	白天	báitian
班	班	bān
百	百	bǎi
吧	吧	ba
半	半	bàn
半年	半年	bànnián
半天	半天	bàntiān
幫	帮	bāng
幫忙	帮忙	bāng máng
包	包	bāo
包子	包子	bāozi
杯	杯	bēi
杯子	杯子	bēizi
北邊	北边	běibian
本	本	běn
北京	北京	Běijīng
北	北	běi
本子	本子	běnzi
別	别	bié
別的	别的	biéde
別人	别人	biéren
病	病	bìng
病人	病人	bìngrén
比	比	bǐ
不大	不大	bùdà
不客氣	不客气	bù kèqì
不用	不用	bùyòng
菜	菜	cài
不對	不对	bù duì
差	差	chà
不	不	bù
茶	茶	chá
常常	常常	chángcháng
常	常	cháng
車	车	chē
唱歌	唱歌	chàng gē
車上	车上	chē shàng
車票	车票	chēpiào
唱	唱	chàng
吃	吃	chī
車站	车站	chēzhàn
吃飯	吃饭	chī fàn
出來	出来	chū lai
齣	出	chū
出去	出去	chū qu
床	床	chuáng
次	次	cì
穿	穿	chuān
錯	错	cuò
從	从	cóng
打	打	dǎ
打車	打车	dǎchē
打電話	打电话	dǎ diànhuà
打開	打开	dǎ kāi
打球	打球	dǎqiú
大學	大学	dàxué
大	大	dà
大學生	大学生	dàxuéshēng
得到	得到	dé dào
到	到	dào
等	等	děng
地點	地点	dìdiǎn
地	地	de
地方	地方	dìfang
地上	地上	dìshang
的	的	de
地圖	地图	dìtú
弟弟	弟弟	dìdi
第	第	dì
點	点	diǎn
電話	电话	diànhuà
電	电	diàn
電腦	电脑	diànnǎo
電視機	电视机	diànshìjī
電影	电影	diànyǐng
電視	电视	diànshì
電影院	电影院	diànyǐng yuàn
東邊	东边	dōngbiān
東	东	dōng
東西	东西	dōngxi
動	动	dòng
動作	动作	dòngzuò
讀	读	dú
都	都	dōu
讀書	读书	dú shū
對不起	对不起	duìbuqǐ
多	多	duō
多少	多少	duōshao
兒子	儿子	érzi
餓	饿	è
對	对	duì
二	二	èr
飯	饭	fàn
飯店	饭店	fàndiàn
房間	房间	fángjiān
房子	房子	fángzi
放	放	fàng
放假	放假	fàng jià
飛	飞	fēi
放學	放学	fàng xué
飛機	飞机	fēijī
非常	非常	fēicháng
分	分	fēn
風	风	fēng
幹	干	gàn
乾淨	干净	gānjìng
高興	高兴	gāoxìng
高	高	gāo
告訴	告诉	gàosu
哥哥	哥哥	gēge
歌	歌	gē
幹什麼	干什么	gànshénme
個	个	gè
給	给	gěi
跟	跟	gēn
工人	工人	gōngren
工作	工作	gōngzuò
關	关	guān
關上	关上	guānshàng
國	国	guó
國家	国家	guójiā
貴	贵	guì
國外	国外	guówài
還是	还是	háishi
孩子	孩子	háizi
還有	还有	háiyǒu
過	过	guò
漢語	汉语	Hànyǔ
還	还	hái
漢字	汉字	Hànzì
好	好	hǎo
好吃	好吃	hǎochī
好看	好看	hǎokàn
好聽	好听	hǎotīng
好玩兒	好玩儿	hǎowánr
號	号	hào
喝	喝	hē
和	和	hé
很	很	hěn
後	后	hòu
後邊	后边	hòubian
話	话	huà
後天	后天	hòutiān
壞	坏	huài
回答	回答	huídá
回	回	huí
花	花	huā
回到	回到	huídào
回家	回家	huí jiā
回去	回去	huí  qu
回來	回来	huí lai
會	会	huì
火車	火车	huǒchē
機場	机场	jīchǎng
雞蛋	鸡蛋	jīdàn
機票	机票	jīpiào
幾	几	jǐ
記得	记得	jì de
記住	记住	jì zhu
家	家	jiā
記	记	jì
家裡	家里	jiālǐ
見面	见面	jiàn miàn
教	教	jiào
家人	家人	jiārén
間	间	jiān
見	见	jiàn
叫	叫	jiào
教學樓	教学楼	jiàoxuélóu
介紹	介绍	jièshào
今年	今年	jīnnián
姐姐	姐姐	jiějie
今天	今天	jīntiān
進	进	jìn
進來	进来	jìn lai
進去	进去	jìn qu
就	就	jiù
覺得	觉得	juéde
九	九	jiǔ
開	开	kāi
開車	开车	kāi chē
開會	开会	kāi huì
開玩笑	开玩笑	kāi wánxiào
看	看	kàn
看病	看病	kàn bìng
看到	看到	kàn dào
考	考	kǎo
看見	看见	kàn jian
考試	考试	kǎoshì
渴	渴	kě
課	课	kè
課本	课本	kèběn
課文	课文	kèwén
口	口	kǒu
塊	块	kuài
快	快	kuài
來	来	lái
來到	来到	láidào
老	老	lǎo
老人	老人	lǎoren
老師	老师	lǎoshī
了	了	le
累	累	lèi
冷	冷	lěng
裏	里	lǐ
裡邊	里边	lǐbian
兩	两	liǎng
零	零	líng
六	六	liù
樓	楼	lóu
樓上	楼上	lóushàng
樓下	楼下	lóuxià
路口	路口	lùkǒu
路上	路上	lùshang
媽媽	妈妈	māma
馬路	马路	mǎlù
路	路	lù
馬上	马上	mǎshàng
買	买	mǎi
嗎	吗	ma
慢	慢	màn
忙	忙	máng
毛	毛	máo
沒	没	méi
沒關係	没关系	méiguānxi
沒什麼	没什么	méishénme
沒有	没有	méiyou
沒事兒	没事儿	méishìr
妹妹	妹妹	mèimei
門	门	mén
門口	门口	ménkǒu
門票	门票	ménpiào
米飯	米饭	mǐfàn
們	们	men
麵包	面包	miànbāo
麵條兒	面条儿	miàntiáor
名字	名字	míngzi
明白	明白	míngbai
明年	明年	míngnián
明天	明天	míngtiān
哪	哪	nǎ
哪裡	哪里	nǎli
哪兒	哪儿	nǎr
哪些	哪些	nǎxiē
拿	拿	ná
那邊	那边	nàbian
那	那	nà
那裡	那里	nàlǐ
那些	那些	nàxiē
奶	奶	nǎi
那兒	那儿	nàr
奶奶	奶奶	nǎinai
男孩兒	男孩儿	nánháir
男朋友	男朋友	nánpéngyou
男	男	nán
男生	男生	nánshēng
南	南	nán
男人	男人	nánren
南邊	南边	nánbian
呢	呢	ne
難	难	nán
你	你	nǐ
能	能	néng
你們	你们	nǐmen
您	您	nín
牛奶	牛奶	niúnǎi
女	女	nǚ
年	年	nián
女孩兒	女孩儿	nǚháir
女兒	女儿	nǚér
女生	女生	nǚshēng
女朋友	女朋友	nǚpéngyou
旁邊	旁边	pángbiān
跑	跑	pǎo
女人	女人	nǚren
朋友	朋友	péngyou
票	票	piào
七	七	qī
起床	起床	qǐ chuáng
起來	起来	qǐ  lai
起	起	qǐ
汽車	汽车	qìchē
前	前	qián
前邊	前边	qiánbian
錢	钱	qián
錢包	钱包	qiánbāo
請	请	qǐng
前天	前天	qiántiān
請假	请假	qǐng jià
請問	请问	qǐngwèn
請進	请进	qǐngjìn
請坐	请坐	qǐng zuò
球	球	qiú
去年	去年	qùnián
熱	热	rè
人	人	rén
認識	认识	rènshi
認真	认真	rènzhēn
去	去	qù
日	日	rì
日期	日期	rìqī
肉	肉	ròu
山	山	shān
商場	商场	shāngchǎng
上	上	shàng
三	三	sān
商店	商店	shāngdiàn
上班	上班	shàng bān
上車	上车	shàngchē
上課	上课	shàng kè
上網	上网	shàng wǎng
上邊	上边	shàngbian
上學	上学	shàng xué
上午	上午	shàngwǔ
少	少	shǎo
上次	上次	shàngcì
身上	身上	shēnshang
誰	谁	shéi
身體	身体	shēntǐ
生病	生病	shēng bìng
生氣	生气	shēng qì
十	十	shí
時候	时候	shíhou
時間	时间	shíjiān
事	事	shì
試	试	shì
生日	生日	shēngri
是不是	是不是	shìbùshì
是	是	shì
手機	手机	shǒujī
手	手	shǒu
書包	书包	shūbāo
書	书	shū
書店	书店	shūdiàn
樹	树	shù
水	水	shuǐ
水果	水果	shuǐguǒ
睡	睡	shuì
說	说	shuō
說話	说话	shuō huà
睡覺	睡觉	shuì jiào
送	送	sòng
四	四	sì
嵗	岁	suì
他們	他们	tāmen
什麼	什么	shénme
她	她	tā
她們	她们	tāmen
天	天	tiān
他	他	tā
太	太	tài
天氣	天气	tiānqì
聽到	听到	tīngdào
聽見	听见	tīng jian
聽寫	听写	tīngxiě
聽	听	tīng
圖書館	图书馆	túshūguǎn
外	外	wài
外邊	外边	wàibian
同學	同学	tóngxué
外國	外国	wàiguó
玩兒	玩儿	wánr
晚	晚	wǎn
晚飯	晚饭	wǎnfàn
晚上	晚上	wǎnshang
網上	网上	wǎngshàng
網友	网友	wǎngyǒu
外語	外语	wàiyǔ
忘記	忘记	wàngjì
忘	忘	wàng
問	问	wèn
我們	我们	wǒmen
我	我	wǒ
五	五	wǔ
午飯	午饭	wǔfàn
西	西	xī
西邊	西边	xībian
洗	洗	xǐ
洗手間	洗手间	xǐshǒujiān
喜歡	喜欢	xǐhuan
下	下	xià
下班	下班	xià bān
下邊	下边	xiàbian
下車	下车	xiàchē
下次	下次	xiàcì
下課	下课	xià kè
下午	下午	xiàwǔ
下雨	下雨	xiàyǔ
先	先	xiān
先生	先生	xiānsheng
想	想	xiǎng
現在	现在	xiànzài
小	小	xiǎo
小孩兒	小孩儿	xiǎoháir
小姐	小姐	xiǎojiě
小時	小时	xiǎoshí
小朋友	小朋友	xiǎopéngyǒu
小學	小学	xiǎoxué
小學生	小学生	xiǎo xuésheng
笑	笑	xiào
寫	写	xiě
謝謝	谢谢	xièxie
新	新	xīn
新年	新年	xīnnián
星期	星期	xīngqī
星期日	星期日	Xīngqīrì
星期天	星期天	xīngqītiān
行	行	xíng
休息	休息	xiūxi
學生	学生	xuésheng
學	学	xué
學習	学习	xuéxí
學校	学校	xuéxiào
學院	学院	xuéyuàn
要	要	yào
爺爺	爷爷	yéye
頁	页	yè
衣服	衣服	yīfu
也	也	yě
醫生	医生	yīshēng
醫院	医院	yīyuàn
一	一	yī
一會兒	一会儿	yīhuìr
一塊兒	一块儿	yīkuàir
一下兒	一下儿	yīxiàr
一半	一半	yībàn
一邊	一边	yībiān
一點兒	一点儿	yīdiǎnr
一起	一起	yīqǐ
一些	一些	yīxiē
一樣	一样	yīyàng
有的	有的	yǒude
有	有	yǒu
有名	有名	yǒu míng
用	用	yòng
有時候	有时候	yǒushíhou
有些	有些	yǒuxiē
有用	有用	yǒuyòng
右	右	yòu
右邊	右边	yòubian
雨	雨	yǔ
元	元	yuán
遠	远	yuǎn
月	月	yuè
再	再	zài
再見	再见	zàijiàn
在	在	zài
在家	在家	zàijiā
早	早	zǎo
早飯	早饭	zǎofàn
早上	早上	zǎoshang
怎麼	怎么	zěnme
站	站	zhàn
找	找	zhǎo
找到	找到	zhǎodào
這邊	这边	zhèbiān
這	这	zhè
這裡	这里	zhèlǐ
這兒	这儿	zhèr
這些	这些	zhèxiē
著	着	zhe
真	真	zhēn
真的	真的	zhēn de
正	正	zhèng
正在	正在	zhèngzài
知道	知道	zhīdao
知識	知识	zhīshi
中國	中国	Zhōngguó
中	中	zhōng
中間	中间	zhōngjiān
中文	中文	Zhōngwén
中午	中午	zhōngwǔ
中學	中学	zhōngxué
中學生	中学生	zhōngxuéshēng
重	重	zhòng
重要	重要	zhòngyào
住	住	zhù
準備	准备	zhǔnbèi
桌子	桌子	zhuōzi
字	字	zì
子	子	zi
走	走	zǒu
最	最	zuì
走路	走路	zǒu lù
最好	最好	zuìhǎo
最後	最后	zuìhòu
昨天	昨天	zuótiān
左邊	左边	zuǒbian
左	左	zuǒ
坐	坐	zuò
坐下	坐下	zuòxià
做	做	zuò
