啊	啊	a
愛情	爱情	àiqíng
安靜	安静	ānjìng
安全	安全	ānquán
愛人	爱人	àiren
班長	班长	bānzhǎng
辦	办	bàn
辦法	办法	bànfǎ
辦公室	办公室	bàngōngshì
白色	白色	báisè
幫助	帮助	bāngzhù
報名	报名	bào míng
飽	饱	bǎo
半夜	半夜	bànyè
報紙	报纸	bàozhǐ
北方	北方	běifāng
比如說	比如说	bǐrúshuō
比如	比如	bǐrú
筆記	笔记	bǐjì
筆	笔	bǐ
背	背	bèi
筆記本	笔记本	bǐjìběn
邊	边	biān
變	变	biàn
必須	必须	bìxū
遍	遍	biàn
變成	变成	biàn chéng
表示	表示	biǎoshì
不錯	不错	bùcuò
不夠	不够	bùgòu
不但	不但	bùdàn
不過	不过	bùguò
不太	不太	bù tài
錶	表	biǎo
不好意思	不好意思	bù hǎoyìsi
不滿	不满	bùmǎn
不要	不要	bùyào
不如	不如	bùrú
不久	不久	bùjiǔ
不少	不少	bùshǎo
不同	不同	bùtóng
不行	不行	bù xíng
不一定	不一定	bùyīdìng
不一會兒	不一会儿	bù yīhuǐr5
部分	部分	bùfen
菜單	菜单	càidān
參觀	参观	cānguān
才	才	cái
參加	参加	cānjiā
草地	草地	cǎodì
層	层	céng
草	草	cǎo
差不多	差不多	chàbuduō
長	长	zhǎng
查	查	chá
常見	常见	chángjiàn
常用	常用	chángyòng
場	场	chǎng
超過	超过	chāo guò
超市	超市	chāoshì
車輛	车辆	chēliàng
成績	成绩	chéngjì
稱	称	chēng
重複	重复	chóngfù
重新	重新	chóngxīn
出發	出发	chūfā
成為	成为	chéngwéi
成	成	chéng
出國	出国	chū guó
出口	出口	chū kǒu
出門	出门	chū mén
出生	出生	chūshēng
出現	出现	chūxiàn
出院	出院	chū yuàn
出租	出租	chūzū
出租車	出租车	chūzūchē
吹	吹	chuī
春節	春节	Chūn Jié
船	船	chuán
春天	春天	chūntiān
詞典	词典	cídiǎn
詞	词	cí
詞語	词语	cíyǔ
答應	答应	dāying
打工	打工	dǎ gōng
從小	从小	cóngxiǎo
打算	打算	dǎsuan
打印	打印	dǎyìn
大部分	大部分	dàbùfen
大大	大大	dàda
大多數	大多数	dàduōshù
大家	大家	dàjiā
大海	大海	dǎhǎi
大量	大量	dàliàng
大門	大门	dàmén
大人	大人	dàren
大聲	大声	dàshēng
大衣	大衣	dàyī
大自然	大自然	dàzìrán
帶	带	dài
帶來	带来	dài lái
單位	单位	dānwèi
大小	大小	dàxiǎo
但	但	dàn
但是	但是	dànshì
蛋	蛋	dàn
當	当	dāng
當時	当时	dāngshí
到處	到处	dàochù
道	道	dào
道路	道路	dàolù
倒	倒	dào
道理	道理	dàoli
得	得	de
得出	得出	dé chū
的話	的话	dehuà
等	等	děng
等到	等到	děngdào
燈	灯	dēng
低	低	dī
等於	等于	děngyú
地鐵	地铁	dìtiě
地球	地球	dìqiú
地鐵站	地铁站	dìtiězhàn
店	店	diàn
點頭	点头	diǎntóu
東北	东北	dōngběi
東方	东方	dōngfāng
冬天	冬天	dōngtiān
掉	掉	diào
東南	东南	dōngnán
懂得	懂得	dǒngde
動物	动物	dòngwù
動物園	动物园	dòngwùyuán
度	度	dù
讀音	读音	dúyīn
短	短	duǎn
短信	短信	duǎnxìn
段	段	duàn
隊	队	duì
隊長	队长	duìzhǎng
懂	懂	dǒng
對話	对话	duìhuà
對面	对面	duìmiàn
多	多	duō
多久	多久	duōjiǔ
對	对	duì
多麼	多么	duōme
多數	多数	duōshù
多雲	多云	duōyún
而且	而且	érqiě
發	发	fā
發現	发现	fāxiàn
飯館	饭馆	fànguǎn
方便	方便	fāngbiàn
方便麵	方便面	fāngbiànmiàn
方法	方法	fāngfǎ
方面	方面	fāngmiàn
放下	放下	fàngxià
方向	方向	fāngxiang
分	分	fēn
分開	分开	fēn kāi
分數	分数	fēnshù
放心	放心	fàng xīn
分鐘	分钟	fēnzhōng
服務	服务	fúwù
複習	复习	fùxí
份	份	fèn
封	封	fēng
改	改	gǎi
改變	改变	gǎibiàn
該	该	gāi
感到	感到	gǎndào
感動	感动	gǎndòng
乾杯	干杯	gān bēi
感覺	感觉	gǎnjué
幹活兒	干活儿	gànhuór5
剛	刚	gāng
剛纔	刚才	gāngcái
剛剛	刚刚	gānggāng
高級	高级	gāojí
感謝	感谢	gǎnxiè
高中	高中	gāozhōng
個子	个子	gèzi
更	更	gèng
公共汽車	公共汽车	gōnggòng qìchē
公交車	公交车	gōngjiāochē
公斤	公斤	gōngjīn
公路	公路	gōnglù
公平	公平	gōngpíng
公里	公里	gōnglǐ
公園	公园	gōngyuán
公司	公司	gōngsī
故事	故事	gùshi
狗	狗	gǒu
夠	够	gòu
故意	故意	gùyì
顧客	顾客	gùkè
關機	关机	guān jī
關心	关心	guānxīn
觀點	观点	guāndiǎn
廣場	广场	guǎngchǎng
廣告	广告	guǎnggào
過來	过来	guò lai
過年	过年	guònian
國際	国际	guójì
過去	过去	guò qu
海	海	hǎi
過	过	guò
海邊	海边	hǎibiān
好	好	hǎo
喊	喊	hǎn
好多	好多	hǎoduō
好處	好处	hǎochu
好久	好久	hǎojiǔ
好人	好人	hǎorén
好事	好事	hǎoshì
好像	好像	hǎoxiàng
合適	合适	héshì
黑	黑	hēi
河	河	hé
黑板	黑板	hēibǎn
紅	红	hóng
黑色	黑色	hēisè
紅色	红色	hóngsè
忽然	忽然	hūrán
後來	后来	hòulái
護照	护照	hùzhào
花	花	huā
花園	花园	huāyuán
湖	湖	hú
畫	画	huà
畫兒	画儿	huàr5
畫家	画家	huàjiā
壞人	坏人	huàirén
壞處	坏处	huàichu
歡迎	欢迎	huānyíng
黃	黄	huáng
換	换	huàn
黃色	黄色	huángsè
回	回	huí
回國	回国	huí guó
會	会	huì
活動	活动	huódong
或	或	huò
或者	或者	huòzhě
鷄	鸡	jī
機會	机会	jīhui
級	级	jí
急	急	jí
計劃	计划	jìhuà
計算機	计算机	jìsuànjī
加	加	jiā
加油	加油	jiā yóu
家	家	jiā
家庭	家庭	jiātíng
家長	家长	jiāzhǎng
假	假	jiǎ
假期	假期	jiàqī
檢查	检查	jiǎnchá
件	件	jiàn
見過	见过	jiànguò
講	讲	jiǎng
見到	见到	jiàndào
健康	健康	jiànkāng
講話	讲话	jiǎnghuà
交	交	jiāo
交給	交给	jiāogěi
交朋友	交朋友	jiāo péngyou
交通	交通	jiāotōng
角	角	jiǎo
角度	角度	jiǎodù
餃子	饺子	jiǎozi
叫作	叫作	jiàozuò
教師	教师	jiàoshī
腳	脚	jiǎo
教學	教学	jiāo xué
教育	教育	jiàoyù
教室	教室	jiàoshì
接到	接到	jiēdào
接受	接受	jiēshòu
接下來	接下来	jiēxiàlái
接著	接着	jiēzhe
街	街	jiē
節	节	jié
節目	节目	jiémù
節日	节日	jiérì
結果	结果	jiē guǒ
斤	斤	jīn
接	接	jiē
借	借	jiè
進入	进入	jìnrù
今後	今后	jīnhòu
進行	进行	jìnxíng
經常	经常	jīngcháng
經過	经过	jīngguò
近	近	jìn
經理	经理	jīnglǐ
酒店	酒店	jiǔdiàn
就要	就要	jiùyào
酒	酒	jiǔ
舉手	举手	jǔ shǒu
舉行	举行	jǔxíng
舉	举	jǔ
句子	句子	jùzi
卡	卡	kǎ
開機	开机	kāi jī
句	句	jù
看法	看法	kànfa
開心	开心	kāi xīn
考生	考生	kǎoshēng
靠	靠	kào
開學	开学	kāi xué
科	科	kē
科學	科学	kēxué
可愛	可爱	kěài
可怕	可怕	kěpà
可是	可是	kěshì
可能	可能	kěnéng
克	克	kè
可以	可以	kěyǐ
刻	刻	kè
課堂	课堂	kètáng
空氣	空气	kōngqì
快餐	快餐	kuàicān
快點兒	快点儿	kuàidiǎnr5
客人	客人	kèren
快樂	快乐	kuàilè
快要	快要	kuàiyào
哭	哭	kū
筷子	筷子	kuàizi
來自	来自	láizì
拉	拉	lā
藍	蓝	lán
藍色	蓝色	lánsè
籃球	篮球	lánqiú
老年	老年	lǎonián
老朋友	老朋友	lǎopéngyou
離	离	lí
老	老	lǎo
老是	老是	lǎoshi
離開	离开	lí kāi
裡頭	里头	lǐtou
理想	理想	lǐxiǎng
禮物	礼物	lǐwù
例如	例如	lìrú
例子	例子	lìzi
臉	脸	liǎn
練習	练习	liànxí
練	练	liàn
涼	凉	liáng
涼快	凉快	liángkuai
輛	辆	liàng
亮	亮	liàng
零下	零下	língxià
兩	两	liǎng
留下	留下	liú xià
留	留	liú
留學生	留学生	liúxuéshēng
流利	流利	liúlì
流	流	liú
流行	流行	liúxíng
旅客	旅客	lǚkè
旅行	旅行	lǚxíng
綠	绿	lǜ
綠色	绿色	lǜsè
路邊	路边	lùbiān
賣	卖	mài
旅遊	旅游	lǚyóu
滿意	满意	mǎnyì
貓	猫	māo
米	米	mǐ
面	面	miàn
面前	面前	miànqián
名稱	名称	míngchēng
名	名	míng
名單	名单	míngdān
滿	满	mǎn
目的	目的	mùdì
拿到	拿到	nádào
拿出	拿出	náchū
那	那	nà
那會兒	那会儿	nàhuìr5
那麼	那么	nàme
那時候	那时候	nà shíhou
明星	明星	míngxīng
那樣	那样	nàyàng
南方	南方	nánfāng
難過	难过	nánguò
難看	难看	nánkàn
難受	难受	nánshòu
難聽	难听	nántīng
能夠	能够	nénggòu
年級	年级	niánjí
難題	难题	nántí
年輕	年轻	niánqīng
鳥	鸟	niǎo
弄	弄	nòng
努力	努力	nǔlì
爬山	爬山	páshān
排	排	pái
排隊	排队	pái duì
怕	怕	pà
排球	排球	páiqiú
碰	碰	pèng
爬	爬	pá
碰到	碰到	pèngdào
碰見	碰见	pèng jian
篇	篇	piān
片	片	piàn
便宜	便宜	biànyí
平安	平安	píngān
平	平	píng
漂亮	漂亮	piàoliang
平時	平时	píngshí
平常	平常	píngcháng
瓶子	瓶子	píngzi
平等	平等	píngděng
瓶	瓶	píng
普通話	普通话	pǔtōnghuà
其中	其中	qízhōng
普通	普通	pǔtōng
其他	其他	qítā
騎車	骑车	qíchē
起飛	起飞	qǐfēi
氣	气	qì
騎	骑	qí
千	千	qiān
氣溫	气温	qìwēn
千克	千克	qiānkè
前年	前年	qiánnián
墻	墙	qiáng
青少年	青少年	qīngshàonián
輕	轻	qīng
青年	青年	qīngnián
清楚	清楚	qīngchu
晴天	晴天	qíngtiān
請客	请客	qǐng kè
晴	晴	qíng
請求	请求	qǐngqiú
球場	球场	qiúchǎng
求	求	qiú
球隊	球队	qiúduì
取	取	qǔ
球鞋	球鞋	qiúxié
秋天	秋天	qiūtiān
全	全	quán
取得	取得	qǔdé
全部	全部	quánbù
全家	全家	quánjiā
全年	全年	quánnián
全身	全身	quánshēn
全體	全体	quántǐ
全國	全国	quánguó
熱情	热情	rèqíng
讓	让	ràng
人們	人们	rénmen
人口	人口	rénkǒu
人數	人数	rénshù
然後	然后	ránhòu
認為	认为	rènwéi
日子	日子	rìzi
日報	日报	rìbào
入口	入口	rù kǒu
如果	如果	rúguǒ
商量	商量	shāngliang
商人	商人	shāngrén
上週	上周	shàngzhōu
身邊	身边	shēnbiān
少年	少年	shàonián
少數	少数	shǎoshù
什麼樣	什么样	shénmeyàng
生	生	shēng
生詞	生词	shēngcí
聲音	声音	shēngyīn
十分	十分	shífēn
生活	生活	shēnghuó
實習	实习	shíxí
實際	实际	shíjì
省	省	shěng
實現	实现	shíxiàn
食物	食物	shíwù
實在	实在	shízai
使用	使用	shǐyòng
市長	市长	shìzhǎng
市	市	shì
事情	事情	shìqing
收到	收到	shōu dào
收入	收入	shōurù
手錶	手表	shǒubiǎo
受到	受到	shòudào
舒服	舒服	shūfu
熟	熟	shú
收	收	shōu
數字	数字	shùzì
水平	水平	shuǐpíng
順利	顺利	shùnlì
說明	说明	shuōmíng
司機	司机	sījī
送到	送到	sòng dào
數	数	shù
算	算	suàn
送給	送给	sònggěi
隨便	随便	suí biàn
隨時	随时	suíshí
所以	所以	suǒyǐ
雖然	虽然	suīrán
所有	所有	suǒyǒu
它	它	tā
它們	它们	tāmen
太太	太太	tàitai
太陽	太阳	tàiyáng
討論	讨论	tǎolùn
態度	态度	tàidu
套	套	tào
特點	特点	tèdiǎn
疼	疼	téng
提	提	tí
特別	特别	tèbié
提出	提出	tí chū
提到	提到	tídào
提高	提高	tí gāo
體育	体育	tǐyù
題	题	tí
體育場	体育场	tǐyùchǎng
體育館	体育馆	tǐyùguǎn
天上	天上	tiānshang
條	条	tiáo
條件	条件	tiáojiàn
聽說	听说	tīngshuō
停車	停车	tíng chē
聽講	听讲	tīng jiǎng
停	停	tíng
挺	挺	tǐng
停車場	停车场	tíngchēchǎng
通	通	tōng
挺好	挺好	tǐnghǎo
通知	通知	tōngzhī
同時	同时	tóngshí
同樣	同样	tóngyàng
同事	同事	tóngshì
通過	通过	tōngguò
頭	头	tóu
頭髮	头发	tóufa
圖片	图片	túpiàn
腿	腿	tuǐ
外地	外地	wàidì
完	完	wán
完成	完成	wán chéng
完全	完全	wánquán
外賣	外卖	wàimài
推	推	tuī
晚報	晚报	wǎnbào
晚安	晚安	wǎnān
晚餐	晚餐	wǎncān
晚會	晚会	wǎnhuì
碗	碗	wǎn
網	网	wǎng
萬	万	wàn
網球	网球	wǎngqiú
網站	网站	wǎngzhàn
往	往	wǎng
為什麼	为什么	wèishénme
為	为	wèi
位	位	wèi
味道	味道	wèidao
喂	喂	wèi
聞	闻	wén
問路	问路	wèn lù
午餐	午餐	wǔcān
問題	问题	wèntí
午睡	午睡	wǔshuì
西北	西北	xīběi
溫度	温度	wēndù
西南	西南	xīnán
西方	西方	xīfāng
西醫	西医	xīyī
西餐	西餐	xīcān
習慣	习惯	xíguàn
洗衣機	洗衣机	xǐyījī
下	下	xià
洗澡	洗澡	xǐ zǎo
下週	下周	xiàzhōu
相同	相同	xiāngtóng
夏天	夏天	xiàtiān
相信	相信	xiāngxìn
想到	想到	xiǎng dào
想法	想法	xiǎngfa
下雪	下雪	xiàxuě
想起	想起	xiǎng qǐ
嚮	向	xiàng
相機	相机	xiàngjī
響	响	xiǎng
像	像	xiàng
小聲	小声	xiǎoshēng
小時候	小时候	xiǎoshíhou
小說	小说	xiǎoshuō
小心	小心	xiǎoxin
小	小	xiǎo
小組	小组	xiǎozǔ
校園	校园	xiàoyuán
校長	校长	xiàozhǎng
笑話兒	笑话儿	xiàohuar5
笑話	笑话	xiàohua
心裡	心里	xīnli
心情	心情	xīnqíng
鞋	鞋	xié
心中	心中	xīnzhōng
信	信	xìn
新聞	新闻	xīnwén
信號	信号	xìnhào
信心	信心	xìnxīn
信用卡	信用卡	xìnyòngkǎ
信息	信息	xìnxī
星星	星星	xīngxing
行動	行动	xíngdòng
行人	行人	xíngrén
姓	姓	xìng
行為	行为	xíngwéi
姓名	姓名	xìngmíng
學期	学期	xuéqī
休假	休假	xiū jià
許多	许多	xǔduō
選	选	xuǎn
顏色	颜色	yánsè
雪	雪	xuě
眼睛	眼睛	yǎnjing
眼	眼	yǎn
養	养	yǎng
樣子	样子	yàngzi
要求	要求	yāoqiú
藥片	药片	yàopiàn
藥	药	yào
也許	也许	yěxǔ
藥水	药水	yàoshuǐ
夜	夜	yè
藥店	药店	yàodiàn
夜裡	夜里	yèli
一定	一定	yīdìng
一部分	一部分	yībùfen
一會兒	一会儿	yīhuìr5
一路平安	一路平安	yīlù-píngān
已經	已经	yǐjīng
一路順風	一路顺风	yīlùshùnfēng
以前	以前	yǐqián
一共	一共	yīgòng
以後	以后	yǐhòu
以上	以上	yǐshàng
以外	以外	yǐwài
椅子	椅子	yǐzi
以下	以下	yǐxià
一點點	一点点	yīdiǎndiǎn
一般	一般	yībān
一生	一生	yīshēng
一直	一直	yīzhí
億	亿	yì
以為	以为	yǐwéi
因為	因为	yīnwei
意見	意见	yìjian
意思	意思	yìsi
陰天	阴天	yīntiān
音節	音节	yīnjié
音樂	音乐	yīnyuè
音樂會	音乐会	yīnyuèhuì
銀行卡	银行卡	yínhángkǎ
應該	应该	yīnggāi
銀行	银行	yínháng
英文	英文	Yīngwén
英語	英语	Yīngyǔ
影片	影片	yǐngpiàn
陰	阴	yīn
影響	影响	yǐngxiǎng
油	油	yóu
永遠	永远	yǒngyuǎn
有空兒	有空儿	yǒukòngr5
友好	友好	yǒuhǎo
有點兒	有点儿	yǒudiǎnr5
遊客	游客	yóukè
有人	有人	yǒurén
有意思	有意思	yǒuyìsi
語言	语言	yǔyán
又	又	yòu
原來	原来	yuánlái
原因	原因	yuányīn
魚	鱼	yú
院長	院长	yuànzhǎng
院	院	yuàn
願意	愿意	yuànyi
月份	月份	yuèfèn
月亮	月亮	yuèliang
越來越	越来越	yuèláiyuè
越	越	yuè
運動	运动	yùndong
雲	云	yún
咱們	咱们	zánmen
咱	咱	zán
臟	脏	zàng
院子	院子	yuànzi
早餐	早餐	zǎocān
早晨	早晨	zǎochen
怎麼辦	怎么办	zěnmebàn
怎麼樣	怎么样	zěnmeyàng
早就	早就	zǎojiù
怎樣	怎样	zěnyàng
占	占	zhàn
站住	站住	zhànzhù
長大	长大	zhǎng dà
站	站	zhàn
找出	找出	zhǎochū
照片	照片	zhàopiàn
照相	照相	zhào xiàng
照顧	照顾	zhàogu
這麼	这么	zhème
這時候	这时候	zhè shíhòu
真正	真正	zhēnzhèng
正常	正常	zhèngcháng
正是	正是	zhèngshì
這樣	这样	zhèyàng
正確	正确	zhèngquè
只	只	zhǐ
只能	只能	zhǐnéng
直接	直接	zhíjiē
正好	正好	zhènghǎo
紙	纸	zhǐ
只要	只要	zhǐyào
中級	中级	zhōngjí
中年	中年	zhōngnián
中小學	中小学	zhōngxiǎoxué
中心	中心	zhōngxīn
中餐	中餐	zhōngcān
中醫	中医	zhōngyī
重視	重视	zhòngshì
周	周	zhōu
週末	周末	zhōumò
週年	周年	zhōunián
重點	重点	zhòngdiǎn
住房	住房	zhùfáng
主人	主人	zhǔrén
住院	住院	zhù yuàn
自己	自己	zìjǐ
裝	装	zhuāng
準確	准确	zhǔnquè
自行車	自行车	zìxíngchē
自由	自由	zìyóu
字典	字典	zìdiǎn
走過	走过	zǒuguò
走進	走进	zǒujìn
租	租	zū
組	组	zǔ
走開	走开	zǒukāi
組成	组成	zǔ chéng
主要	主要	zhǔyào
嘴	嘴	zuǐ
最近	最近	zuìjìn
組長	组长	zǔzhǎng
作家	作家	zuòjiā
作文	作文	zuòwén
作用	作用	zuòyòng
座	座	zuò
座位	座位	zuòwei
做到	做到	zuò dào
做法	做法	zuòfa
作業	作业	zuòyè
做飯	做饭	zuò fàn
