阿姨	阿姨	āyí
啊	啊	a
愛國	爱国	àiguó
矮	矮	ǎi
愛護	爱护	àihù
矮小	矮小	ǎixiǎo
按時	按时	ànshí
安置	安置	ānzhì
暗示	暗示	ànshì
安	安	ān
百貨	百货	bǎihuò
暗	暗	àn
擺	摆	bǎi
擺動	摆动	bǎidòng
巴士	巴士	bāshì
擺脫	摆脱	bǎi tuō
辦事	办事	bàn shì
包裹	包裹	bāoguǒ
敗	败	bài
包括	包括	bāokuò
寶	宝	bǎo
包含	包含	bāohán
寶寶	宝宝	bǎobao
寶貝	宝贝	bǎobèi
寶貴	宝贵	bǎoguì
寶石	宝石	bǎoshí
保守	保守	bǎoshǒu
抱	抱	bào
背景	背景	bèijǐng
倍	倍	bèi
保密	保密	bǎo mì
本科	本科	běnkē
薄	薄	báo
比分	比分	bǐfēn
畢業	毕业	bì yè
笨	笨	bèn
畢業生	毕业生	bìyèshēng
避	避	bì
避免	避免	bìmiǎn
被迫	被迫	bèipò
辯論	辩论	biànlùn
標志	标志	biāozhì
編	编	biān
表情	表情	biǎoqíng
表揚	表扬	biǎoyáng
別	别	bié
冰	冰	bīng
冰箱	冰箱	bīngxiāng
冰雪	冰雪	bīngxuě
兵	兵	bīng
并	并	bìng
不要緊	不要紧	bù yàojǐn
不管	不管	bùguǎn
不在乎	不在乎	bù zàihu
布置	布置	bùzhì
不然	不然	bùrán
步行	步行	bùxíng
才	才	cái
擦	擦	cā
材料	材料	cáiliào
財富	财富	cáifù
財產	财产	cáichǎn
參考	参考	cānkǎo
參與	参与	cānyù
採訪	采访	cǎifǎng
操場	操场	cāochǎng
操作	操作	cāozuò
測量	测量	cèliáng
測	测	cè
測試	测试	cèshì
茶葉	茶叶	cháyè
產品	产品	chǎnpǐn
曾	曾	céng
長途	长途	chángtú
唱片	唱片	chàngpiàn
常識	常识	chángshí
抄寫	抄写	chāoxiě
潮流	潮流	cháoliú
抄	抄	chāo
潮	潮	cháo
徹底	彻底	chèdǐ
潮濕	潮湿	cháoshī
沉	沉	chén
沉默	沉默	chénmò
沉重	沉重	chénzhòng
成人	成人	chéngrén
誠實	诚实	chéngshi
稱贊	称赞	chēngzàn
承擔	承担	chéngdān
承認	承认	chéngrèn
誠信	诚信	chéngxìn
程序	程序	chéngxù
吃驚	吃惊	chī jīng
承受	承受	chéngshòu
尺	尺	chǐ
遲到	迟到	chí dào
沖	冲	chōng
尺子	尺子	chǐzi
充電	充电	chōng diàn
充電器	充电器	chōngdiànqì
尺寸	尺寸	chǐcun
蟲子	虫子	chóngzi
充分	充分	chōngfèn
抽	抽	chōu
抽獎	抽奖	chōu jiǎng
出口	出口	chū kǒu
抽煙	抽烟	chōu yān
出色	出色	chūsè
出席	出席	chū xí
處於	处于	chǔyú
出售	出售	chūshòu
處	处	chù
穿上	穿上	chuānshang
窗戶	窗户	chuānghu
窗臺	窗台	chuāngtái
傳統	传统	chuántǒng
純	纯	chún
純淨水	纯净水	chúnjìngshuǐ
窗子	窗子	chuāngzi
春季	春季	chūnjì
詞匯	词汇	cíhuì
此	此	cǐ
此外	此外	cǐwài
次	次	cì
刺激	刺激	cìjī
刺	刺	cì
從此	从此	cóngcǐ
粗	粗	cū
粗心	粗心	cūxīn
促銷	促销	cùxiāo
措施	措施	cuòshī
促使	促使	cùshǐ
打	打	dǎ
促進	促进	cùjìn
答案	答案	dáàn
打雷	打雷	dǎ léi
打敗	打败	dǎ bài
打掃	打扫	dǎsǎo
打折	打折	dǎ zhé
打針	打针	dǎ zhēn
大多	大多	dàduō
大巴	大巴	dàbā
大方	大方	dàfang
大哥	大哥	dàgē
大規模	大规模	dàguīmó
大會	大会	dàhuì
大姐	大姐	dàjiě
大樓	大楼	dàlóu
大媽	大妈	dàmā
大型	大型	dàxíng
大陸	大陆	dàlù
大眾	大众	dàzhòng
大爺	大爷	dàye
代替	代替	dàitì
袋	袋	dài
待遇	待遇	dàiyù
戴	戴	dài
擔任	担任	dānrèn
擔保	担保	dānbǎo
擔心	担心	dān xīn
單純	单纯	dānchún
單	单	dān
單調	单调	dāndiào
單獨	单独	dāndú
導遊	导游	dǎoyóu
倒閉	倒闭	dǎobì
淡	淡	dàn
倒車	倒车	dǎo chē
得意	得意	déyì
得	得	de
導致	导致	dǎozhì
燈光	灯光	dēngguāng
登	登	dēng
登記	登记	dēng jì
登錄	登录	dēnglù
登山	登山	dēng shān
的確	的确	díquè
敵人	敌人	dírén
地方	地方	dìfang
底	底	dǐ
地面	地面	dìmiàn
地位	地位	dìwèi
地下	地下	dìxia
地址	地址	dìzhǐ
典型	典型	diǎnxíng
點名	点名	diǎn míng
電燈	电灯	diàndēng
電動車	电动车	diàndòngchē
電梯	电梯	diàntī
電源	电源	diànyuán
定	定	dìng
頂	顶	dǐng
冬季	冬季	dōngjì
動畫片	动画片	dònghuàpiàn
豆腐	豆腐	dòufu
獨立	独立	dúlì
動搖	动摇	dòngyáo
獨自	独自	dúzì
獨特	独特	dútè
堵	堵	dǔ
肚子	肚子	dǔzi
堵車	堵车	dǔ chē
度過	度过	dùguò
對比	对比	duìbǐ
鍛煉	锻炼	duànliàn
多次	多次	duōcì
對於	对于	duìyú
對付	对付	duìfu
多年	多年	duōnián
多種	多种	duōzhǒng
而	而	ér
惡心	恶心	ěxin
兒童	儿童	értóng
多樣	多样	duōyàng
而是	而是	érshì
二手	二手	èrshǒu
耳機	耳机	ěrjī
發揮	发挥	fāhuī
發票	发票	fāpiào
發燒	发烧	fāshāo
法	法	fǎ
法官	法官	fǎguān
法律	法律	fǎlǜ
法院	法院	fǎyuàn
翻譯	翻译	fānyì
煩	烦	fán
翻	翻	fān
反而	反而	fǎnér
反映	反映	fǎnyìng
反	反	fǎn
方案	方案	fāngàn
方	方	fāng
方針	方针	fāngzhēn
非	非	fēi
放鬆	放松	fàngsōng
肥	肥	féi
分布	分布	fēnbù
分手	分手	fēn shǒu
分為	分为	fēnwéi
…分之…	…分之…	… fēn zhī …
奮鬥	奋斗	fèndòu
風格	风格	fēnggé
分散	分散	fēnsàn
風景	风景	fēngjǐng
紛紛	纷纷	fēnfēn
封閉	封闭	fēngbì
否則	否则	fǒuzé
風俗	风俗	fēngsú
夫妻	夫妻	fūqī
夫人	夫人	fūren
夫婦	夫妇	fūfù
符合	符合	fúhé
付出	付出	fùchū
符號	符号	fúhào
附近	附近	fùjìn
負擔	负担	fùdān
複製	复制	fùzhì
改善	改善	gǎishàn
改正	改正	gǎizhèng
概括	概括	gàikuò
感興趣	感兴趣	gǎn xìngqù
高潮	高潮	gāocháo
蓋	盖	gài
高價	高价	gāojià
格外	格外	géwài
高鐵	高铁	gāotiě
高尚	高尚	gāoshàng
隔	隔	gé
隔開	隔开	gékāi
個別	个别	gèbié
各個	各个	gègè
個體	个体	gètǐ
根	根	gēn
根據	根据	gēnjù
工程	工程	gōngchéng
供應	供应	gōngyìng
共	共	gòng
構成	构成	gòu chéng
公元	公元	gōngyuán
構造	构造	gòuzào
購物	购物	gòuwù
購買	购买	gòumǎi
骨頭	骨头	gǔtou
固定	固定	gùdìng
怪	怪	guài
關	关	guān
關閉	关闭	guānbì
官方	官方	guānfāng
官	官	guān
光臨	光临	guānglín
關於	关于	guānyú
歸	归	guī
逛	逛	guàng
光盤	光盘	guāngpán
瓜	瓜	guā
規律	规律	guīlǜ
規則	规则	guīzé
果實	果实	guǒshí
海水	海水	hǎishuǐ
過分	过分	guòfèn
海鮮	海鲜	hǎixiān
含	含	hán
規模	规模	guīmó
含量	含量	hánliàng
含有	含有	hányǒu
含義	含义	hányì
寒假	寒假	hánjià
寒冷	寒冷	hánlěng
航班	航班	hángbān
航空	航空	hángkōng
毫米	毫米	háomǐ
行業	行业	hángyè
好友	好友	hǎoyǒu
毫升	毫升	háoshēng
好	好	hǎo
號碼	号码	hàomǎ
黑暗	黑暗	hēiàn
合同	合同	hétong
紅包	红包	hóngbāo
厚	厚	hòu
後頭	后头	hòutou
忽視	忽视	hūshì
戶	户	hù
呼吸	呼吸	hūxī
花	花	huā
護士	护士	hùshi
懷念	怀念	huáiniàn
劃	划	huà
懷疑	怀疑	huáiyí
黃瓜	黄瓜	huánggua
緩解	缓解	huǎnjiě
黃金	黄金	huángjīn
回復	回复	huífù
匯	汇	huì
彙報	汇报	huìbào
婚禮	婚礼	hūnlǐ
匯率	汇率	huìlǜ
伙	伙	huǒ
火	火	huǒ
或許	或许	huòxǔ
伙伴	伙伴	huǒbàn
獲	获	huò
獲得	获得	huòdé
獲獎	获奖	huò jiǎng
獲取	获取	huòqǔ
機構	机构	jīgòu
貨	货	huò
幾乎	几乎	jīhū
積累	积累	jīlěi
激動	激动	jīdòng
激烈	激烈	jīliè
及格	及格	jí gé
極	极	jí
機遇	机遇	jīyù
即將	即将	jíjiāng
急忙	急忙	jímáng
記載	记载	jìzǎi
極其	极其	jíqí
技巧	技巧	jìqiǎo
集合	集合	jíhé
紀律	纪律	jìlǜ
系	系	xì
季	季	jì
季度	季度	jìdù
既	既	jì
既然	既然	jìrán
加班	加班	jiā bān
季節	季节	jìjié
寄	寄	jì
加入	加入	jiārù
家務	家务	jiāwù
加油站	加油站	jiāyóuzhàn
假如	假如	jiǎrú
檢測	检测	jiǎncè
減肥	减肥	jiǎn féi
減少	减少	jiǎnshǎo
堅固	坚固	jiāngù
減	减	jiǎn
簡歷	简历	jiǎnlì
健身	健身	jiàn shēn
講究	讲究	jiǎngjiu
漸漸	渐渐	jiànjiàn
江	江	jiāng
講座	讲座	jiǎngzuò
獎	奖	jiǎng
獎金	奖金	jiǎngjīn
獎學金	奖学金	jiǎngxuéjīn
降價	降价	jiàng jià
降	降	jiàng
降低	降低	jiàngdī
降落	降落	jiàngluò
交換	交换	jiāohuàn
交際	交际	jiāojì
教授	教授	jiàoshòu
教訓	教训	jiàoxun
階段	阶段	jiēduàn
街道	街道	jiēdào
節省	节省	jiéshěng
結構	结构	jiégòu
結	结	jié
降溫	降温	jiàng wēn
姐妹	姐妹	jiěmèi
結論	结论	jiélùn
解釋	解释	jiěshì
儘快	尽快	jǐnkuài
盡力	尽力	jìn lì
進口	进口	jìn kǒu
禁止	禁止	jìnzhǐ
緊密	紧密	jǐnmì
近代	近代	jìndài
經典	经典	jīngdiǎn
竟然	竟然	jìngrán
鏡頭	镜头	jìngtóu
精力	精力	jīnglì
鏡子	镜子	jìngzi
酒吧	酒吧	jiǔbā
究竟	究竟	jiūjìng
居民	居民	jūmín
局	局	jú
居住	居住	jūzhù
距離	距离	jùlí
巨大	巨大	jùdà
聚會	聚会	jùhuì
聚	聚	jù
具備	具备	jùbèi
角色	角色	juésè
開花	开花	kāi huā
捲	卷	juǎn
開水	开水	kāishuǐ
看來	看来	kànlai
看不起	看不起	kànbuqǐ
看望	看望	kànwang
考察	考察	kǎochá
考慮	考虑	kǎolǜ
可見	可见	kějiàn
空間	空间	kōngjiān
空	空	kōng
棵	棵	kē
口袋	口袋	kǒudai
苦	苦	kǔ
口語	口语	kǒuyǔ
快遞	快递	kuàidì
寬廣	宽广	kuānguǎng
礦泉水	矿泉水	kuàngquánshuǐ
會計	会计	kuàiji
擴大	扩大	kuòdà
擴展	扩展	kuòzhǎn
寬	宽	kuān
垃圾	垃圾	lājī
括號	括号	kuòhào
拉開	拉开	lā kai
來不及	来不及	láibují
辣	辣	là
來得及	来得及	láidejí
來源	来源	láiyuán
老家	老家	lǎojiā
老婆	老婆	lǎopo
老公	老公	lǎogong
老實	老实	lǎoshi
淚	泪	lèi
淚水	泪水	lèishuǐ
樂趣	乐趣	lèqù
類型	类型	lèixíng
釐米	厘米	límǐ
冷靜	冷静	lěngjìng
離不開	离不开	lí bukāi
力氣	力气	lìqi
歷史	历史	lìshǐ
立即	立即	lìjí
利益	利益	lìyì
利息	利息	lìxī
量	量	liàng
良好	良好	liánghǎo
兩邊	两边	liǎngbiān
糧食	粮食	liángshi
了不起	了不起	liǎobuqǐ
療養	疗养	liáoyǎng
了解	了解	liǎojiě
列	列	liè
列車	列车	lièchē
列入	列入	lièrù
列為	列为	lièwéi
倆	俩	liǎ
臨時	临时	línshí
零食	零食	língshí
流傳	流传	liúchuán
樓梯	楼梯	lóutī
陸續	陆续	lùxù
陸地	陆地	lùdì
律師	律师	lǜshī
錄取	录取	lùqǔ
輪	轮	lún
輪椅	轮椅	lúnyǐ
論文	论文	lùnwén
輪船	轮船	lúnchuán
落	落	luò
輪子	轮子	lúnzi
毛巾	毛巾	máojīn
毛衣	毛衣	máoyī
帽子	帽子	màozi
沒法兒	没法儿	méifǎr5
沒錯	没错	méicuò
沒想到	没想到	méixiǎngdào
美金	美金	měijīn
美女	美女	měinǚ
夢見	梦见	mèngjiàn
夢想	梦想	mèngxiǎng
夢	梦	mèng
祕密	秘密	mìmì
祕書	秘书	mìshū
密碼	密码	mìmǎ
密	密	mì
密切	密切	mìqiē
面臨	面临	miànlín
免費	免费	miǎn fèi
面試	面试	miànshì
描寫	描写	miáoxiě
描述	描述	miáoshù
名牌兒	名牌儿	míngpáir5
名人	名人	míngrén
名片	名片	míngpiàn
摸	摸	mō
模特兒	模特儿	mótèr5
模型	模型	móxíng
末	末	mò
默默	默默	mòmò
哪	哪	nǎ
男女	男女	nánnǚ
男士	男士	nánshì
難免	难免	nánmiǎn
哪怕	哪怕	nǎpà
腦袋	脑袋	nǎodai
鬧	闹	nào
鬧鐘	闹钟	nàozhōng
內部	内部	nèibù
內科	内科	nèikē
能幹	能干	nénggàn
寧靜	宁静	níngjìng
濃	浓	nóng
女士	女士	nǚshì
暖氣	暖气	nuǎnqì
拍照	拍照	pāi zhào
排列	排列	páiliè
牌	牌	pái
盤	盘	pán
盤子	盘子	pánzi
胖子	胖子	pàngzi
培訓	培训	péixùn
培訓班	培训班	péixùnbān
培養	培养	péiyǎng
批	批	pī
培育	培育	péiyù
品質	品质	pǐnzhì
片面	片面	piànmiàn
平方	平方	píngfāng
平均	平均	píngjūn
平靜	平静	píngjìng
迫切	迫切	pòqiè
平穩	平稳	píngwěn
妻子	妻子	qīzi
破產	破产	pòchǎn
期末	期末	qīmò
期待	期待	qīdài
期間	期间	qījiān
期中	期中	qīzhōng
期限	期限	qīxiàn
企業	企业	qǐyè
氣球	气球	qìqiú
其餘	其余	qíyú
汽水	汽水	qìshuǐ
器官	器官	qìguān
前途	前途	qiántú
汽油	汽油	qìyóu
淺	浅	qiǎn
前頭	前头	qiántou
巧克力	巧克力	qiǎokèlì
親密	亲密	qīnmì
親愛	亲爱	qīnài
切	切	qiè
青春	青春	qīngchūn
輕鬆	轻松	qīngsōng
輕易	轻易	qīngyi
清醒	清醒	qīngxǐng
情景	情景	qíngjǐng
窮	穷	qióng
窮人	穷人	qióngrén
趨勢	趋势	qūshì
秋季	秋季	qiūjì
圈	圈	quān
權利	权利	quánlì
卻	却	què
確認	确认	quèrèn
燃料	燃料	ránliào
然而	然而	ránér
燃燒	燃烧	ránshāo
熱心	热心	rèxīn
熱鬧	热闹	rènao
人家	人家	rénjia
日曆	日历	rìlì
如今	如今	rújīn
日記	日记	rìjì
弱	弱	ruò
散	散	sàn
掃	扫	sǎo
色	色	sè
傘	伞	sǎn
色彩	色彩	sècǎi
森林	森林	sēnlín
閃	闪	shǎn
閃電	闪电	shǎndiàn
曬	晒	shài
傷害	伤害	shānghài
善於	善于	shànyú
善良	善良	shànliáng
商務	商务	shāngwù
上個月	上个月	shànggèyuè
賞	赏	shǎng
上門	上门	shàng mén
上樓	上楼	shànglóu
燒	烧	shāo
設置	设置	shèzhì
申請	申请	shēnqǐng
身材	身材	shēncái
設施	设施	shèshī
深厚	深厚	shēnhòu
身份	身份	shēnfen
身高	身高	shēngāo
神祕	神秘	shénmì
失敗	失败	shībài
甚至	甚至	shènzhì
神話	神话	shénhuà
失業	失业	shī yè
詩	诗	shī
詩人	诗人	shīrén
失望	失望	shīwàng
實用	实用	shíyòng
濕	湿	shī
食堂	食堂	shítáng
實施	实施	shíshī
使勁	使劲	shǐ jìn
士兵	士兵	shìbīng
市區	市区	shìqū
似的	似的	shìde
事物	事物	shìwù
事先	事先	shìxiān
是否	是否	shìfǒu
試卷	试卷	shìjuàn
收回	收回	shōu huí
收益	收益	shōuyì
收穫	收获	shōuhuò
手裡	手里	shǒuli
守	守	shǒu
手術	手术	shǒushù
手工	手工	shǒugōng
受不了	受不了	shòubuliǎo
手套	手套	shǒutào
首	首	shǒu
售貨員	售货员	shòuhuòyuán
舒適	舒适	shūshì
叔叔	叔叔	shūshu
熟練	熟练	shúliàn
暑假	暑假	shǔjià
樹林	树林	shùlín
數據	数据	shùjù
樹葉	树叶	shùyè
數碼	数码	shùmǎ
刷	刷	shuā
刷牙	刷牙	shuā yá
刷子	刷子	shuāzi
帥	帅	shuài
帥哥	帅哥	shuàigē
睡著	睡着	shuìzháo
率先	率先	shuàixiān
說不定	说不定	shuōbudìng
說服	说服	shuō fú
似乎	似乎	sìhū
順序	顺序	shùnxù
松樹	松树	sōngshù
思考	思考	sīkǎo
松	松	sōng
塑料袋	塑料袋	sùliàodài
酸	酸	suān
塑料	塑料	sùliào
酸奶	酸奶	suānnǎi
隨手	随手	suíshǒu
孫子	孙子	sūnzi
孫女	孙女	sūnnü
縮短	缩短	suō duǎn
臺階	台阶	táijiē
縮小	缩小	suō xiǎo
臺上	台上	táishàng
套餐	套餐	tàocān
躺	躺	tǎng
特殊	特殊	tèshū
特徵	特征	tèzhēng
提醒	提醒	tí xǐng
特價	特价	tèjià
提供	提供	tígōng
體重	体重	tǐzhòng
體操	体操	tǐcāo
體檢	体检	tǐjiǎn
替代	替代	tìdài
替	替	tì
天真	天真	tiānzhēn
填空	填空	tián kòng
填	填	tián
挑	挑	tiāo
挑選	挑选	tiāoxuǎn
調皮	调皮	tiáopí
貼	贴	tiē
挑戰	挑战	tiǎo zhàn
停下	停下	tíngxià
挺	挺	tǐng
通知書	通知书	tōngzhīshū
童話	童话	tónghuà
同情	同情	tóngqíng
統計	统计	tǒngjì
童年	童年	tóngnián
統一	统一	tǒngyī
投	投	tóu
痛快	痛快	tòngkuai
投訴	投诉	tóusù
投入	投入	tóurù
透	透	tòu
投資	投资	tóuzī
途中	途中	túzhōng
圖案	图案	túàn
推遲	推迟	tuīchí
土地	土地	tǔdi
透明	透明	tòumíng
推銷	推销	tuīxiāo
襪子	袜子	wàzi
脫	脱	tuō
外匯	外汇	wàihuì
外交官	外交官	wàijiāoguān
外套	外套	wàitào
晚點	晚点	wǎn diǎn
彎	弯	wān
萬一	万一	wànyī
王	王	wáng
網絡	网络	wǎngluò
微笑	微笑	wēixiào
網址	网址	wǎngzhǐ
圍巾	围巾	wéijīn
微信	微信	Wēixìn
維持	维持	wéichí
維護	维护	wéihù
維修	维修	wéixiū
尾巴	尾巴	wěiba
未必	未必	wèibì
未來	未来	wèilái
位於	位于	wèiyú
位置	位置	wèizhi
喂	喂	wèi
味兒	味儿	wèir5
穩	稳	wěn
穩定	稳定	wěndìng
無	无	wú
無法	无法	wúfǎ
無聊	无聊	wúliáo
無論	无论	wúlùn
問候	问候	wènhòu
無所謂	无所谓	wúsuǒwèi
無數	无数	wúshù
無限	无限	wúxiàn
五顏六色	五颜六色	wǔyán-liùsè
西瓜	西瓜	xīgua
誤會	误会	wùhuì
吸	吸	xī
吸管	吸管	xīguǎn
吸收	吸收	xīshōu
吸煙	吸烟	xī yān
吸引	吸引	xīyǐn
喜愛	喜爱	xǐài
系統	系统	xìtǒng
系列	系列	xìliè
細	细	xì
細節	细节	xìjié
細緻	细致	xìzhì
下降	下降	xiàjiàng
下個月	下个月	xiàgèyuè
下樓	下楼	xiàlóu
夏季	夏季	xiàjì
下載	下载	xiàzài
鮮	鲜	xiān
鮮花	鲜花	xiānhuā
鮮明	鲜明	xiānmíng
鹹	咸	xián
顯著	显著	xiǎnzhù
縣	县	xiàn
限制	限制	xiànzhì
相處	相处	xiāngchǔ
相反	相反	xiāngfǎn
箱	箱	xiāng
箱子	箱子	xiāngzi
想念	想念	xiǎngniàn
想象	想象	xiǎngxiàng
項目	项目	xiàngmù
項	项	xiàng
相片	相片	xiàngpiàn
銷售	销售	xiāoshòu
消化	消化	xiāohuà
小吃	小吃	xiǎochī
小伙子	小伙子	xiǎohuǒzi
小型	小型	xiǎoxíng
效率	效率	xiàolǜ
些	些	xiē
心理	心理	xīnlǐ
新郎	新郎	xīnláng
新娘	新娘	xīnniáng
新鮮	新鲜	xīnxian
新型	新型	xīnxíng
興奮	兴奋	xīngfèn
形容	形容	xíngróng
形勢	形势	xíngshì
型	型	xíng
型號	型号	xínghào
醒	醒	xǐng
興趣	兴趣	xìngqù
性質	性质	xìngzhì
胸部	胸部	xiōngbù
兄弟	兄弟	xiōngdi
修理	修理	xiūlǐ
選擇	选择	xuǎnzé
學年	学年	xuénián
學分	学分	xuéfēn
學時	学时	xuéshí
學問	学问	xuéwen
學術	学术	xuéshù
尋找	寻找	xúnzhǎo
牙	牙	yá
迅速	迅速	xùnsù
亞運會	亚运会	Yàyùnhuì
牙刷	牙刷	yáshuā
呀	呀	ya
延長	延长	yáncháng
延期	延期	yán qī
嚴格	严格	yángé
嚴	严	yán
延續	延续	yánxù
嚴重	严重	yánzhòng
研究	研究	yánjiū
研究生	研究生	yánjiūshēng
研製	研制	yánzhì
鹽	盐	yán
眼鏡	眼镜	yǎnjìng
眼淚	眼泪	yǎnlèi
演講	演讲	yǎnjiǎng
陽臺	阳台	yángtái
腰	腰	yāo
眼裡	眼里	yǎnli
養成	养成	yǎngchéng
藥物	药物	yàowù
搖	摇	yáo
要	要	yào
業餘	业余	yèyú
醫療	医疗	yīliáo
醫學	医学	yīxué
依靠	依靠	yīkào
一律	一律	yīlǜ
一致	一致	yīzhì
葉子	叶子	yèzi
依然	依然	yīrán
一再	一再	yīzài
移動	移动	yídòng
移	移	yí
遺產	遗产	yíchǎn
移民	移民	yímín
遺傳	遗传	yíchuán
疑問	疑问	yíwèn
以及	以及	yǐjí
以內	以内	yǐnèi
一般來說	一般来说	yībānláishuō
義務	义务	yìwù
議論	议论	yìlùn
引	引	yǐn
引導	引导	yǐndǎo
引起	引起	yǐnqǐ
引進	引进	yǐnjìn
應	应	yīng
英勇	英勇	yīngyǒng
營業	营业	yíngyè
影子	影子	yǐngzi
勇敢	勇敢	yǒnggǎn
贏得	赢得	yíngdé
用途	用途	yòngtú
優良	优良	yōuliáng
勇氣	勇气	yǒngqì
優美	优美	yōuměi
郵局	邮局	yóujú
優秀	优秀	yōuxiù
有勁兒	有劲儿	yǒujìnr5
有限	有限	yǒuxiàn
有趣	有趣	yǒuqù
幼兒園	幼儿园	yòuéryuán
於是	于是	yúshì
語法	语法	yǔfǎ
玉	玉	yù
語音	语音	yǔyīn
預訂	预订	yùdìng
玉米	玉米	yùmǐ
預測	预测	yùcè
遇	遇	yù
遇見	遇见	yù jian
遇到	遇到	yù dào
原料	原料	yuánliào
圓	圆	yuán
原則	原则	yuánzé
圓滿	圆满	yuánmǎn
約會	约会	yuēhui
月底	月底	yuèdǐ
運動會	运动会	yùndònghuì
閱讀	阅读	yuèdú
運動員	运动员	yùndòngyuán
運氣	运气	yùnqi
運用	运用	yùnyòng
在乎	在乎	zàihu
再三	再三	zàisān
贊成	赞成	zànchéng
在於	在于	zàiyú
贊賞	赞赏	zànshǎng
贊助	赞助	zànzhù
造型	造型	zàoxíng
戰鬥	战斗	zhàndòu
戰士	战士	zhànshì
戰勝	战胜	zhànshèng
戰爭	战争	zhànzhēng
丈夫	丈夫	zhàngfu
著	着	zhe
招呼	招呼	zhāohu
著火	着火	zháo huǒ
著急	着急	zháo jí
召開	召开	zhàokāi
折	折	zhé
針	针	zhēn
針對	针对	zhēnduì
陣	阵	zhèn
爭論	争论	zhēnglùn
征服	征服	zhēngfú
政府	政府	zhèngfǔ
徵求	征求	zhēngqiú
政治	政治	zhèngzhì
之前	之前	zhīqián
之後	之后	zhīhòu
之一	之一	zhīyī
支	支	zhī
之間	之间	zhījiān
植物	植物	zhíwù
制訂	制订	zhìdìng
指揮	指挥	zhǐhuī
質量	质量	zhìliàng
治	治	zhì
治療	治疗	zhìliáo
智力	智力	zhìlì
智能	智能	zhìnéng
中介	中介	zhōngjiè
種類	种类	zhǒnglèi
中獎	中奖	zhòng jiǎng
種植	种植	zhòngzhí
種	种	zhǒng
逐漸	逐渐	zhújiàn
逐步	逐步	zhúbù
重量	重量	zhòngliàng
主席	主席	zhǔxí
祝福	祝福	zhùfú
主題	主题	zhǔtí
著名	著名	zhùmíng
抓緊	抓紧	zhuā jǐn
專心	专心	zhuānxīn
轉動	转动	zhuǎn dòng
著作	著作	zhùzuò
轉告	转告	zhuǎngào
轉身	转身	zhuǎn shēn
轉彎	转弯	zhuǎn wān
裝修	装修	zhuāngxiū
裝置	装置	zhuāngzhì
轉移	转移	zhuǎnyí
準時	准时	zhǔnshí
追求	追求	zhuīqiú
資料	资料	zīliào
自	自	zì
資源	资源	zīyuán
字母	字母	zìmǔ
綜合	综合	zōnghé
自信	自信	zìxìn
總共	总共	zǒnggòng
總理	总理	zǒnglǐ
總統	总统	zǒngtǒng
總之	总之	zǒngzhī
阻止	阻止	zǔzhǐ
嘴巴	嘴巴	zuǐba
作出	作出	zuòchū
作為	作为	zuòwéi
最初	最初	zuìchū
做夢	做梦	zuò mèng
