安慰	安慰	ānwèi
岸	岸	àn
岸上	岸上	ànshàng
拔	拔	bá
按摩	按摩	ànmó
白酒	白酒	báijiǔ
扮演	扮演	bànyǎn
拜訪	拜访	bàifǎng
包圍	包围	bāowéi
包裝	包装	bāozhuāng
版	版	bǎn
棒	棒	bàng
保衛	保卫	bǎowèi
報答	报答	bàodá
報警	报警	bào jǐng
背包	背包	bēibāo
保養	保养	bǎoyǎng
悲傷	悲伤	bēishāng
悲劇	悲剧	bēijù
抱怨	抱怨	bàoyuan
被動	被动	bèidòng
輩	辈	bèi
本人	本人	běnrén
鼻子	鼻子	bízi
比方	比方	bǐfang
比重	比重	bǐzhòng
北極	北极	běijí
必需	必需	bìxū
畢竟	毕竟	bìjìng
閉幕	闭幕	bì mù
彼此	彼此	bǐcǐ
閉幕式	闭幕式	bìmùshì
編輯	编辑	biānjí
必	必	bì
便利	便利	biànlì
變動	变动	biàndòng
便條	便条	biàntiáo
邊境	边境	biānjìng
便於	便于	biànyú
賓館	宾馆	bīnguǎn
病毒	病毒	bìngdú
餅乾	饼干	bǐnggān
博客	博客	bókè
餅	饼	bǐng
玻璃	玻璃	bōli
博士	博士	bóshì
博覽會	博览会	bólǎnhuì
博物館	博物馆	bówùguǎn
不利	不利	bùlì
薄弱	薄弱	bóruò
不耐煩	不耐烦	bù nàifán
不顧	不顾	bùgù
補償	补偿	bǔcháng
不幸	不幸	bùxìng
不易	不易	bùyì
不曾	不曾	bùcéng
不得了	不得了	bù déliǎo
補貼	补贴	bǔtiē
不敢當	不敢当	bù gǎndāng
不免	不免	bùmiǎn
不時	不时	bùshí
不能不	不能不	bùnéngbù
不停	不停	bùtíng
不許	不许	bùxǔ
不良	不良	bùliáng
部位	部位	bùwèi
不止	不止	bùzhǐ
猜測	猜测	cāicè
不足	不足	bùzú
採購	采购	cǎigòu
裁判	裁判	cáipàn
猜	猜	cāi
餐館	餐馆	cānguǎn
餐廳	餐厅	cāntīng
彩票	彩票	cǎipiào
草原	草原	cǎoyuán
層次	层次	céngcì
冊	册	cè
餐飲	餐饮	cānyǐn
叉子	叉子	chāzi
差別	差别	chābié
差距	差距	chājù
查詢	查询	cháxún
插	插	chā
叉	叉	chā
差點兒	差点儿	chàdiǎnr5
拆除	拆除	chāichú
拆	拆	chāi
長度	长度	chángdù
長壽	长寿	chángshòu
產業	产业	chǎnyè
腸	肠	cháng
嘗	尝	cháng
嘗試	尝试	chángshì
廠長	厂长	chǎngzhǎng
場面	场面	chǎngmiàn
超越	超越	chāoyuè
倡導	倡导	chàngdǎo
稱	称	chēng
車主	车主	chēzhǔ
稱號	称号	chēnghào
成交	成交	chéng jiāo
成效	成效	chéngxiào
成本	成本	chéngběn
成語	成语	chéngyǔ
承辦	承办	chéngbàn
城裡	城里	chénglǐ
乘	乘	chéng
乘車	乘车	chéngchē
乘坐	乘坐	chéngzuò
吃力	吃力	chīlì
池子	池子	chízi
乘客	乘客	chéngkè
衝動	冲动	chōngdòng
遲	迟	chí
充足	充足	chōngzú
衝突	冲突	chōngtū
愁	愁	chóu
臭	臭	chòu
醜	丑	chǒu
出差	出差	chū chāi
出版	出版	chūbǎn
出汗	出汗	chū hàn
初期	初期	chūqī
出於	出于	chūyú
除非	除非	chúfēi
廚房	厨房	chúfáng
處罰	处罚	chǔfá
除夕	除夕	chúxī
處分	处分	chǔfèn
傳達	传达	chuándá
傳遞	传递	chuándì
傳真	传真	chuánzhēn
窗簾	窗帘	chuānglián
處在	处在	chǔzài
闖	闯	chuǎng
創立	创立	chuànglì
辭典	辞典	cídiǎn
此後	此后	cǐhòu
辭職	辞职	cí zhí
聰明	聪明	cōngming
此刻	此刻	cǐkè
此時	此时	cǐshí
從而	从而	cóngér
從中	从中	cóngzhōng
脆	脆	cuì
寸	寸	cùn
存款	存款	cúnkuǎn
達成	达成	dá chéng
答復	答复	dáfu
答	答	dá
打	打	dǎ
打扮	打扮	dǎban
打擊	打击	dǎjī
打包	打包	dǎ bāo
打擾	打扰	dǎrǎo
打架	打架	dǎ jià
大膽	大胆	dàdǎn
大綱	大纲	dàgāng
大都	大都	Dàdū
大伙兒	大伙儿	dàhuǒr5
大獎賽	大奖赛	dàjiǎngsài
大腦	大脑	dànǎo
大事	大事	dàshì
大廳	大厅	dàtīng
大象	大象	dàxiàng
大熊貓	大熊猫	dàxióngmāo
大於	大于	dàyú
呆	呆	dāi
大致	大致	dàzhì
代價	代价	dàijià
待	待	dài
代理	代理	dàilǐ
帶有	带有	dàiyǒu
貸款	贷款	dàikuǎn
單一	单一	dānyī
膽小	胆小	dǎnxiǎo
膽	胆	dǎn
當場	当场	dāngchǎng
蛋糕	蛋糕	dàngāo
當代	当代	dāngdài
當年	当年	dāngnián
當前	当前	dāngqián
當選	当选	dāngxuǎn
擋	挡	dǎng
到來	到来	dàolái
道德	道德	dàodé
倒是	倒是	dàoshì
得了	得了	déle
得以	得以	déyǐ
等級	等级	děngjí
等候	等候	děnghòu
地帶	地带	dìdài
低于	低于	dīyú
地形	地形	dìxíng
遞	递	dì
地震	地震	dìzhèn
遞給	递给	dìgěi
典禮	典礼	diǎnlǐ
點燃	点燃	diǎnrán
電池	电池	diànchí
電子版	电子版	diànzǐbǎn
電飯鍋	电饭锅	diànfànguō
丟	丢	diū
調動	调动	diàodòng
動手	动手	dòng shǒu
動機	动机	dòngjī
動態	动态	dòngtài
動員	动员	dòngyuán
洞	洞	dòng
凍	冻	dòng
豆製品	豆制品	dòuzhìpǐn
毒	毒	dú
堆	堆	duī
對立	对立	duìlì
對應	对应	duìyìng
朵	朵	duǒ
噸	吨	dūn
躲	躲	duǒ
耳朵	耳朵	ěrduo
兒女	儿女	érnǚ
二維碼	二维码	èrwéimǎ
發覺	发觉	fājué
發射	发射	fāshè
發行	发行	fāháng
罰	罚	fá
發布	发布	fābù
罰款	罚款	fákuǎn
法制	法制	fǎzhì
法規	法规	fǎguī
返回	返回	fǎnhuí
繁榮	繁荣	fánróng
放大	放大	fàng dà
防治	防治	fángzhì
放棄	放弃	fàngqì
分成	分成	fēn chéng
分類	分类	fēn lèi
分離	分离	fēnlí
分解	分解	fēnjiě
豐收	丰收	fēngshōu
分享	分享	fēnxiǎng
分析	分析	fēnxī
風度	风度	fēngdù
風光	风光	fēngguang
封	封	fēng
瘋狂	疯狂	fēngkuáng
扶	扶	fú
瘋	疯	fēng
服從	服从	fúcóng
幅度	幅度	fúdù
福利	福利	fúlì
幅	幅	fú
輔助	辅助	fǔzhù
負責人	负责人	fùzérén
附件	附件	fùjiàn
改革	改革	gǎigé
乾脆	干脆	gāncuì
感想	感想	gǎnxiǎng
干擾	干扰	gānrǎo
干預	干预	gānyù
鋼琴	钢琴	gāngqín
鋼筆	钢笔	gāngbǐ
高度	高度	gāodù
高跟鞋	高跟鞋	gāogēnxié
高大	高大	gāodà
高溫	高温	gāowēn
高原	高原	gāoyuán
高於	高于	gāoyú
搞好	搞好	gǎo hǎo
搞	搞	gǎo
歌曲	歌曲	gēqǔ
個兒	个儿	gèr5
隔壁	隔壁	gébì
跟前	跟前	gēnqian
更換	更换	gēnghuàn
跟隨	跟随	gēnsuí
工藝	工艺	gōngyì
工作日	工作日	gōngzuòrì
更新	更新	gēngxīn
公認	公认	gōngrèn
公式	公式	gōngshì
公告	公告	gōnggào
公正	公正	gōngzhèng
共計	共计	gòngjì
共享	共享	gòngxiǎng
溝通	沟通	gōutōng
溝	沟	gōu
鼓	鼓	gǔ
估計	估计	gūjì
古老	古老	gǔlǎo
鼓掌	鼓掌	gǔ zhǎng
鼓勵	鼓励	gǔlì
顧問	顾问	gùwèn
關懷	关怀	guānhuái
關鍵	关键	guānjiàn
冠軍	冠军	guànjūn
怪	怪	guài
光榮	光荣	guāngróng
光線	光线	guāngxiàn
廣	广	guǎng
廣泛	广泛	guǎngfàn
鬼	鬼	guǐ
規劃	规划	guīhuà
櫃子	柜子	guìzi
滾	滚	gǔn
國籍	国籍	guójí
鍋	锅	guō
國民	国民	guómín
過於	过于	guòyú
過敏	过敏	guòmǐn
害	害	hài
過度	过度	guòdù
好運	好运	hǎoyùn
號召	号召	hàozhào
汗	汗	hàn
合併	合并	hébìng
合成	合成	héchéng
盒飯	盒饭	héfàn
盒	盒	hé
賀卡	贺卡	hèkǎ
恨	恨	hèn
盒子	盒子	hézi
後悔	后悔	hòuhuǐ
胡同兒	胡同儿	hútòngr5
鬍子	胡子	húzi
猴	猴	hóu
華語	华语	Huáyǔ
虎	虎	hǔ
滑	滑	huá
化石	化石	huàshí
畫面	画面	huàmiàn
劃分	划分	huàfēn
環節	环节	huánjié
慌忙	慌忙	huāngmáng
慌	慌	huāng
灰色	灰色	huīsè
回報	回报	huíbào
回顧	回顾	huígù
回收	回收	huíshōu
迴避	回避	huíbì
回頭	回头	huítóu
恢復	恢复	huīfù
回信	回信	huíxìn
匯款	汇款	huìkuǎn
活力	活力	huólì
會談	会谈	huìtán
活潑	活泼	huópo
迴憶	回忆	huíyì
火柴	火柴	huǒchái
火腿	火腿	huǒtuǐ
或是	或是	huòshì
機器人	机器人	jīqìrén
火災	火灾	huǒzāi
肌肉	肌肉	jīròu
機製	机制	jīzhì
基金	基金	jījīn
即使	即使	jíshǐ
基地	基地	jīdì
擠	挤	jǐ
記憶	记忆	jìyì
集團	集团	jítuán
加熱	加热	jiā rè
繼承	继承	jìchéng
技能	技能	jìnéng
加上	加上	jiāshang
加速	加速	jiāsù
夾	夹	jiā
加以	加以	jiāyǐ
駕駛	驾驶	jiàshǐ
價	价	jià
駕照	驾照	jiàzhào
堅定	坚定	jiāndìng
艱苦	艰苦	jiānkǔ
艱難	艰难	jiānnán
檢驗	检验	jiǎnyàn
減輕	减轻	jiǎnqīng
肩	肩	jiān
剪	剪	jiǎn
剪刀	剪刀	jiǎndāo
剪子	剪子	jiǎnzi
間接	间接	jiànjiē
建造	建造	jiànzào
健全	健全	jiànquán
甲	甲	jiǎ
建築	建筑	jiànzhù
鍵盤	键盘	jiànpán
鍵	键	jiàn
將	将	jiāng
獎勵	奖励	jiǎnglì
將要	将要	jiāngyào
交代	交代	jiāodài
膠帶	胶带	jiāodài
膠水	胶水	jiāoshuǐ
郊區	郊区	jiāoqū
腳步	脚步	jiǎobù
接連	接连	jiēlián
解除	解除	jiěchú
接觸	接触	jiēchù
解放	解放	jiěfàng
屆	届	jiè
今日	今日	jīnrì
戒	戒	jiè
緊緊	紧紧	jǐnjǐn
儘可能	尽可能	jǐnkěnéng
儘管	尽管	jǐnguǎn
進化	进化	jìnhuà
近來	近来	jìnlái
經費	经费	jīngfèi
景象	景象	jǐngxiàng
警告	警告	jǐnggào
競賽	竞赛	jìngsài
競爭	竞争	jìngzhēng
救災	救灾	jiù zāi
酒鬼	酒鬼	jiǔguǐ
居然	居然	jūrán
局面	局面	júmiàn
局長	局长	júzhǎng
拒絕	拒绝	jùjué
俱樂部	俱乐部	jùlèbù
劇本	剧本	jùběn
舉動	举动	jǔdòng
絕望	绝望	jué wàng
軍人	军人	jūnrén
決不	决不	juébù
開幕	开幕	kāi mù
開幕式	开幕式	kāimùshì
看成	看成	kànchéng
看待	看待	kàndài
看出	看出	kàn chū
烤肉	烤肉	kǎoròu
考核	考核	kǎohé
靠近	靠近	kàojìn
烤鴨	烤鸭	kǎoyā
咳	咳	hāi
顆	颗	kē
可憐	可怜	kělián
可	可	kě
可惜	可惜	kěxī
渴望	渴望	kěwàng
客戶	客户	kèhù
刻	刻	kè
客氣	客气	kèqi
課題	课题	kètí
客廳	客厅	kètīng
空中	空中	kōngzhōng
口號	口号	kǒuhào
控制	控制	kòngzhì
肯定	肯定	kěndìng
庫	库	kù
快活	快活	kuàihuo
狂	狂	kuáng
寬度	宽度	kuāndù
落	落	luò
困擾	困扰	kùnrǎo
虧	亏	kuī
來信	来信	láixìn
爛	烂	làn
朗讀	朗读	lǎngdú
浪漫	浪漫	làngmàn
梨	梨	lí
勞動	劳动	láodong
禮拜	礼拜	lǐbài
禮貌	礼貌	lǐmào
禮	礼	lǐ
厲害	厉害	lìhai
立場	立场	lìchǎng
利潤	利润	lìrùn
例外	例外	lìwài
連接	连接	liánjiē
聯想	联想	liánxiǎng
聯絡	联络	liánluò
立	立	lì
臉盆	脸盆	liǎnpén
戀愛	恋爱	liànài
兩岸	两岸	liǎngàn
臉色	脸色	liǎnsè
鈴聲	铃声	língshēng
鄰居	邻居	línjū
領帶	领带	lǐngdài
令	令	lìng
流動	流动	liúdòng
鈴	铃	líng
流通	流通	liútōng
漏洞	漏洞	lòudòng
漏	漏	lòu
邏輯	逻辑	luóji
落實	落实	luòshí
碼頭	码头	mǎtou
買賣	买卖	mǎimai
漫長	漫长	màncháng
毛筆	毛笔	máobǐ
漫畫	漫画	mànhuà
冒	冒	mào
矛盾	矛盾	máodùn
罵	骂	mà
貿易	贸易	màoyì
煤	煤	méi
煤氣	煤气	méiqì
門診	门诊	ménzhěn
迷信	迷信	míxìn
面貌	面貌	miànmào
迷人	迷人	mírén
秒	秒	miǎo
敏感	敏感	mǐngǎn
明亮	明亮	míngliàng
面子	面子	miànzi
明明	明明	míngmíng
命令	命令	mìnglìng
模仿	模仿	mófǎng
模範	模范	mófàn
模糊	模糊	móhu
模式	模式	móshì
摩擦	摩擦	mócā
摩託	摩托	mótuō
模樣	模样	múyàng
目光	目光	mùguāng
男性	男性	nánxìng
南北	南北	nánběi
耐心	耐心	nàixīn
南極	南极	nánjí
難得	难得	nándé
難以	难以	nányǐ
能量	能量	néngliàng
內在	内在	nèizài
年齡	年龄	niánlíng
年度	年度	niándù
年前	年前	niánqián
腦子	脑子	nǎozi
牛仔褲	牛仔裤	niúzǎikù
牛	牛	niú
農產品	农产品	nóngchǎnpǐn
暖	暖	nuǎn
女性	女性	nǚxìng
偶然	偶然	ǒurán
偶像	偶像	ǒuxiàng
偶爾	偶尔	ǒuěr
排除	排除	páichú
拍攝	拍摄	pāishè
陪	陪	péi
賠	赔	péi
賠償	赔偿	péicháng
配備	配备	pèibèi
旁	旁	páng
配套	配套	pèi tào
噴	喷	pēn
盆	盆	pén
披	披	pī
皮膚	皮肤	pífū
脾氣	脾气	píqi
皮鞋	皮鞋	píxié
騙	骗	piàn
騙子	骗子	piànzi
頻道	频道	píndào
拼	拼	pīn
頻繁	频繁	pínfán
品	品	pǐn
品種	品种	pǐnzhǒng
匹	匹	pǐ
平坦	平坦	píngtǎn
平原	平原	píngyuán
評論	评论	pínglùn
評估	评估	pínggū
憑	凭	píng
葡萄	葡萄	pútao
潑	泼	pō
葡萄酒	葡萄酒	pútaojiǔ
其	其	qí
啟動	启动	qǐdòng
齊全	齐全	qíquán
啟發	启发	qǐfā
啟事	启事	qǐshì
起到	起到	qǐdào
期望	期望	qīwàng
氣象	气象	qìxiàng
簽訂	签订	qiāndìng
簽	签	qiān
起碼	起码	qǐmǎ
簽名	签名	qiānmíng
簽證	签证	qiānzhèng
簽約	签约	qiān yuē
簽字	签字	qiān zì
前景	前景	qiánjǐng
氣體	气体	qìtǐ
欠	欠	qiàn
槍	枪	qiāng
前提	前提	qiántí
強度	强度	qiángdù
牆壁	墙壁	qiángbì
搶救	抢救	qiǎngjiù
強迫	强迫	qiǎngpò
悄悄	悄悄	qiāoqiāo
搶	抢	qiǎng
瞧	瞧	qiáo
敲	敲	qiāo
勤奮	勤奋	qínfèn
琴	琴	qín
青	青	qīng
敲門	敲门	qiāo mén
清理	清理	qīnglǐ
清晨	清晨	qīngchén
區域	区域	qūyù
晴朗	晴朗	qínglǎng
全都	全都	quándōu
情節	情节	qíngjié
全世界	全世界	quánshìjiè
情形	情形	qíngxing
勸	劝	quàn
泉	泉	quán
缺乏	缺乏	quēfá
確立	确立	quèlì
群眾	群众	qúnzhòng
群體	群体	qúntǐ
熱量	热量	rèliàng
染	染	rǎn
熱門	热门	rèmén
人間	人间	rénjiān
人士	人士	rénshì
人物	人物	rénwù
忍	忍	rěn
人力	人力	rénlì
忍不住	忍不住	rěnbuzhù
繞	绕	rào
認	认	rèn
認定	认定	rèndìng
忍受	忍受	rěnshòu
扔	扔	rēng
如此	如此	rúcǐ
仍舊	仍旧	réngjiù
入門	入门	rùmén
如同	如同	rútóng
軟件	软件	ruǎnjiàn
如下	如下	rúxià
軟	软	ruǎn
散	散	sàn
灑	洒	sǎ
殺毒	杀毒	shā dú
殺	杀	shā
沙漠	沙漠	shāmò
散文	散文	sǎnwén
山區	山区	shānqū
傻	傻	shǎ
扇	扇	shàn
扇子	扇子	shànzi
商標	商标	shāngbiāo
上級	上级	shàngjí
上下	上下	shàngxià
上漲	上涨	shàngzhǎng
稍微	稍微	shāowēi
蛇	蛇	shé
稍	稍	shāo
捨不得	舍不得	shěbude
捨得	舍得	shě de
設想	设想	shèxiǎng
社	社	shè
社區	社区	shèqū
射	射	shè
射擊	射击	shèjī
攝像	摄像	shèxiàng
攝像機	摄像机	shèxiàngjī
攝影師	摄影师	shèyǐngshī
伸	伸	shēn
攝影	摄影	shèyǐng
深度	深度	shēndù
神	神	shén
神經	神经	shénjīng
深處	深处	shēnchù
神情	神情	shénqíng
生成	生成	shēngchéng
昇高	升高	shēnggāo
聲	声	shēng
神奇	神奇	shénqí
勝負	胜负	shèng-fù
剩	剩	shèng
剩下	剩下	shèng xia
失誤	失误	shīwù
師傅	师傅	shīfu
詩歌	诗歌	shīgē
時常	时常	shícháng
十足	十足	shízú
時光	时光	shíguāng
時機	时机	shíjī
時事	时事	shíshì
實惠	实惠	shíhuì
拾	拾	shè
使得	使得	shǐde
示範	示范	shìfàn
式	式	shì
勢力	势力	shìli
試圖	试图	shìtú
視頻	视频	shìpín
收購	收购	shōugòu
收集	收集	shōují
收拾	收拾	shōushi
手段	手段	shǒuduàn
壽司	寿司	shòusī
手法	手法	shǒufǎ
受災	受灾	shòu zāi
視為	视为	shìwéi
瘦	瘦	shòu
書法	书法	shūfǎ
書桌	书桌	shūzhuō
輸出	输出	shūchū
書櫃	书柜	shūguì
鼠	鼠	shǔ
蔬菜	蔬菜	shūcài
鼠標	鼠标	shǔbiāo
熟悉	熟悉	shúxi
摔倒	摔倒	shuāidǎo
摔	摔	shuāi
數目	数目	shùmù
雙手	双手	shuāngshǒu
水產品	水产品	shuǐchǎnpǐn
率領	率领	shuàilǐng
水分	水分	shuǐfèn
水庫	水库	shuǐkù
水災	水灾	shuǐzāi
說法	说法	shuōfa
碩士	硕士	shuòshì
私人	私人	sīrén
睡眠	睡眠	shuìmián
搜	搜	sōu
四周	四周	sìzhōu
搜索	搜索	sōusuǒ
宿舍	宿舍	sùshè
酸甜苦辣	酸甜苦辣	suān-tián-kǔ-là
隨意	随意	suí yì
隨後	随后	suíhòu
歲月	岁月	suìyuè
思維	思维	sīwéi
碎	碎	suì
隨著	随着	suízhe
損害	损害	sǔnhài
所在	所在	suǒzài
鎖	锁	suǒ
損失	损失	sǔnshī
颱風	台风	táifēng
抬頭	抬头	tái tóu
太空	太空	tàikōng
抬	抬	tái
彈	弹	dàn
逃跑	逃跑	táopǎo
逃走	逃走	táo zǒu
逃	逃	táo
桃	桃	táo
桃樹	桃树	táoshù
討厭	讨厌	tǎo yàn
桃花	桃花	táohuā
特性	特性	tèxìng
特有	特有	tèyǒu
特定	特定	tèdìng
提倡	提倡	tíchàng
提起	提起	tíqǐ
提示	提示	tíshì
體積	体积	tǐjī
題材	题材	tícái
天才	天才	tiāncái
天然氣	天然气	tiānránqì
體力	体力	tǐlì
天文	天文	tiānwén
廳	厅	tīng
調解	调解	tiáojiě
通用	通用	tōngyòng
偷	偷	tōu
調節	调节	tiáojié
停留	停留	tíngliú
偷偷	偷偷	tōutōu
土豆	土豆	tǔdòu
突破	突破	tū pò
吐	吐	tǔ
兔	兔	tù
團長	团长	tuánzhǎng
推行	推行	tuīxíng
脫離	脱离	tuōlí
外界	外界	wàijiè
完了	完了	wánliǎo
為難	为难	wéinán
微博	微博	wēibó
為期	为期	wéiqī
為止	为止	wéizhǐ
違法	违法	wéi fǎ
違反	违反	wéifǎn
圍繞	围绕	wéirào
違規	违规	wéi guī
委託	委托	wěituō
唯一	唯一	wéiyī
為主	为主	wéizhǔ
衛星	卫星	wèixīng
溫和	温和	wēnhé
胃	胃	wèi
慰問	慰问	wèiwèn
握	握	wò
文藝	文艺	wényì
污水	污水	wūshuǐ
臥室	卧室	wòshì
無奈	无奈	wúnài
污染	污染	wūrǎn
舞	舞	wǔ
無疑	无疑	wúyí
物價	物价	wùjià
屋	屋	wū
物業	物业	wùyè
物質	物质	wùzhì
誤解	误解	wùjiě
西紅柿	西红柿	xīhóngshì
喜劇	喜剧	xǐjù
西裝	西装	xīzhuāng
戲	戏	xì
戲劇	戏剧	xìjù
嚇	吓	xià
先前	先前	xiānqián
鮮艷	鲜艳	xiānyàn
顯	显	xiǎn
先後	先后	xiānhòu
現有	现有	xiànyǒu
現狀	现状	xiànzhuàng
獻	献	xiàn
閑	闲	xián
線索	线索	xiànsuǒ
鄉村	乡村	xiāngcūn
相等	相等	xiāngděng
香腸	香肠	xiāngcháng
詳細	详细	xiángxì
相應	相应	xiāngying
鄉	乡	xiāng
嚮導	向导	xiàngdǎo
享受	享受	xiǎngshòu
向上	向上	xiàngshàng
象徵	象征	xiàngzhēng
相聲	相声	xiàngsheng
消毒	消毒	xiāodú
消除	消除	xiāochú
向前	向前	xiàngqián
消防	消防	xiāofáng
消費者	消费者	xiāofèizhě
小偷兒	小偷儿	xiǎotōur5
消極	消极	xiāojí
歇	歇	xiē
協議書	协议书	xiéyìshū
斜	斜	xié
心態	心态	xīntài
心疼	心疼	xīnténg
辛苦	辛苦	xīnkǔ
協議	协议	xiéyì
欣賞	欣赏	xīnshǎng
信箱	信箱	xìnxiāng
行駛	行驶	xíngshǐ
信念	信念	xìnniàn
形態	形态	xíngtài
性能	性能	xìngnéng
雄偉	雄伟	xióngwěi
熊	熊	xióng
休閒	休闲	xiūxián
修復	修复	xiūfù
修養	修养	xiūyǎng
修建	修建	xiūjiàn
虛心	虚心	xūxīn
選修	选修	xuǎnxiū
學科	学科	xuékē
學位	学位	xuéwèi
尋求	寻求	xúnqiú
學者	学者	xuézhě
許可	许可	xǔkě
押金	押金	yājīn
詢問	询问	xúnwèn
延伸	延伸	yánshēn
亞軍	亚军	yàjūn
鴨子	鸭子	yāzi
嚴厲	严厉	yánlì
嚴肅	严肃	yánsù
言語	言语	yányu
研究所	研究所	yánjiūsuǒ
邀請	邀请	yāoqǐng
眼光	眼光	yǎnguāng
搖頭	摇头	yáo tóu
也好	也好	yěhǎo
咬	咬	yǎo
業務	业务	yèwù
夜間	夜间	yèjian
依法	依法	yīfǎ
一流	一流	yīliú
依據	依据	yījù
依舊	依旧	yījiù
一輩子	一辈子	yībèizi
一帶	一带	yīdài
依照	依照	yīzhào
一旦	一旦	yīdàn
一句話	一句话	yījùhuà
一下兒	一下儿	yīxiàr5
一下子	一下子	yīxiàzi
一路	一路	yīlù
一向	一向	yīxiàng
乙	乙	yǐ
以便	以便	yǐbiàn
以往	以往	yǐwǎng
一口氣	一口气	yīkǒuqì
一身	一身	yīshēn
意識	意识	yìshi
意味著	意味着	yìwèizhe
意志	意志	yìzhì
因而	因而	yīnér
飲料	饮料	yǐnliào
印刷	印刷	yìnshuā
飲食	饮食	yǐnshí
硬	硬	yìng
硬件	硬件	yìngjiàn
擁抱	拥抱	yōngbào
擁有	拥有	yōngyǒu
用不著	用不着	yòngbuzháo
用戶	用户	yònghù
應	应	yīng
用來	用来	yònglái
優惠	优惠	yōuhuì
優先	优先	yōuxiān
用于	用于	yòngyú
幽默	幽默	yōumò
由此	由此	yóucǐ
尤其	尤其	yóuqí
猶豫	犹豫	yóuyù
游泳池	游泳池	yóuyǒngchí
有毒	有毒	yǒudú
有害	有害	yǒuhài
友誼	友谊	yǒuyì
有力	有力	yǒulì
有利於	有利于	yǒulìyú
有著	有着	yǒuzhe
羽毛球	羽毛球	yǔmáoqiú
預備	预备	yùbèi
羽絨服	羽绒服	yǔróngfú
雨水	雨水	yǔshuǐ
元旦	元旦	Yuándàn
預期	预期	yùqī
原理	原理	yuánlǐ
園林	园林	yuánlín
原先	原先	yuánxiān
原始	原始	yuánshǐ
怨	怨	yuàn
原有	原有	yuányǒu
遠處	远处	yuǎnchù
願	愿	yuàn
約束	约束	yuēshù
月餅	月饼	yuèbing
閱覽室	阅览室	yuèlǎnshì
運行	运行	yùnxíng
運	运	yùn
月球	月球	yuèqiú
災	灾	zāi
災害	灾害	zāihài
再次	再次	zàicì
災區	灾区	zāiqū
災難	灾难	zāinàn
在場	在场	zàichǎng
在內	在内	zàinèi
暫時	暂时	zànshí
暫停	暂停	zàntíng
再也	再也	zàiyě
糟	糟	zāo
糟糕	糟糕	zāogāo
早期	早期	zǎoqī
增	增	zēng
增產	增产	zēng chǎn
增大	增大	zēngdà
增多	增多	zēngduō
增強	增强	zēngqiáng
摘	摘	zhāi
贈	赠	zèng
展覽	展览	zhǎnlǎn
贈送	赠送	zèngsòng
占領	占领	zhànlǐng
展現	展现	zhǎnxiàn
展示	展示	zhǎnshì
占有	占有	zhànyǒu
漲	涨	zhǎng
漲價	涨价	zhǎng jià
掌握	掌握	zhǎngwò
招生	招生	zhāo shēng
招手	招手	zhāo shǒu
珍貴	珍贵	zhēnguì
珍珠	珍珠	zhēnzhū
珍惜	珍惜	zhēnxī
真誠	真诚	zhēnchéng
真相	真相	zhēnxiàng
診斷	诊断	zhěnduàn
真理	真理	zhēnlǐ
振動	振动	zhèndòng
震驚	震惊	zhènjīng
爭議	争议	zhēngyì
正版	正版	zhèngbǎn
正如	正如	zhèngrú
正規	正规	zhèngguī
證實	证实	zhèngshí
證書	证书	zhèngshū
正義	正义	zhèngyì
掙錢	挣钱	zhèng qián
之內	之内	zhīnèi
掙	挣	zhēng
之外	之外	zhīwài
之中	之中	zhīzhōng
之下	之下	zhīxià
執行	执行	zhíxíng
支出	支出	zhīchū
直線	直线	zhíxiàn
支配	支配	zhīpèi
值班	值班	zhí bān
職位	职位	zhíwèi
職能	职能	zhínéng
只不過	只不过	zhǐbuguò
只見	只见	zhǐjiàn
指標	指标	zhǐbiāo
職務	职务	zhíwù
指示	指示	zhǐshì
指甲	指甲	zhǐjia
指責	指责	zhǐzé
製成	制成	zhìchéng
至	至	zhì
治安	治安	zhìān
制約	制约	zhìyuē
中斷	中断	zhōngduàn
中秋節	中秋节	Zhōngqiūjié
治理	治理	zhìlǐ
中央	中央	zhōngyāng
中藥	中药	zhōngyào
終點	终点	zhōngdiǎn
終身	终身	zhōngshēn
終止	终止	zhōngzhǐ
中毒	中毒	zhòng dú
週期	周期	zhōuqī
眾多	众多	zhòngduō
竹子	竹子	zhúzi
主辦	主办	zhǔbàn
主觀	主观	zhǔguān
主體	主体	zhǔtǐ
主管	主管	zhǔguǎn
助理	助理	zhùlǐ
助手	助手	zhùshǒu
主導	主导	zhǔdǎo
注視	注视	zhùshì
注射	注射	zhùshè
註冊	注册	zhù cè
注重	注重	zhùzhòng
祝賀	祝贺	zhùhè
專輯	专辑	zhuānjí
專利	专利	zhuānlì
轉化	转化	zhuǎnhuà
轉換	转换	zhuǎnhuàn
轉讓	转让	zhuǎnràng
轉向	转向	zhuǎn xiàng
裝飾	装饰	zhuāngshì
撞	撞	zhuàng
資產	资产	zīchǎn
資本	资本	zīběn
子彈	子弹	zǐdàn
仔細	仔细	zǐxì
資助	资助	zīzhù
自殺	自杀	zìshā
紫	紫	zǐ
自豪	自豪	zìháo
總裁	总裁	zǒngcái
總數	总数	zǒngshù
總體	总体	zǒngtǐ
總算	总算	zǒngsuàn
自願	自愿	zìyuàn
阻礙	阻碍	zǔài
組織	组织	zǔzhī
醉	醉	zuì
尊敬	尊敬	zūnjìng
尊重	尊重	zūnzhòng
遵守	遵守	zūnshǒu
