阿拉伯語	阿拉伯语	Ālābóyǔ
哎	哎	āi
哀求	哀求	āiqiú
哎呀	哎呀	āiyā
挨家挨戶	挨家挨户	āijiā-āihù
艾滋病	艾滋病	àizībìng
癌	癌	ái
癌癥	癌症	áizhèng
愛不釋手	爱不释手	àibùshìshǒu
唉	唉	āi
愛理不理	爱理不理	àilǐbùlǐ
愛面子	爱面子	ài miànzi
愛惜	爱惜	àixī
礙事	碍事	ài shì
安定	安定	āndìng
安眠藥	安眠药	ānmiányào
安撫	安抚	ānfǔ
安穩	安稳	ānwěn
安寧	安宁	ānníng
按鍵	按键	ànjiàn
按理說	按理说	ànlǐshuō
安逸	安逸	ānyì
安心	安心	ānxīn
案件	案件	ànjiàn
暗地裡	暗地里	àndìli
暗中	暗中	ànzhōng
按說	按说	ànshuō
凹	凹	āo
昂貴	昂贵	ángguì
熬	熬	áo
傲	傲	ào
暗殺	暗杀	ànshā
熬夜	熬夜	áo yè
奧祕	奥秘	àomì
傲慢	傲慢	àomàn
八卦	八卦	bāguà
巴不得	巴不得	bābude
奧運會	奥运会	Àoyùnhuì
扒	扒	bā
芭蕾	芭蕾	bālěi
把柄	把柄	bǎbǐng
把關	把关	bǎ guān
把手	把手	bǎshou
罷免	罢免	bàmiǎn
靶子	靶子	bǎzi
壩	坝	bà
罷休	罢休	bàxiū
掰	掰	bāi
白白	白白	báibái
霸占	霸占	bàzhàn
百分比	百分比	bǎifēnbǐ
百科全書	百科全书	bǎikēquánshū
柏樹	柏树	bǎishù
百合	百合	bǎihé
擺放	摆放	bǎifàng
擺設	摆设	bǎishe
擺平	摆平	bǎi píng
拜會	拜会	bàihuì
拜年	拜年	bài nián
拜託	拜托	bàituō
扳	扳	bān
拜見	拜见	bàijiàn
頒發	颁发	bānfā
頒獎	颁奖	bān jiǎng
頒布	颁布	bānbù
斑點	斑点	bāndiǎn
搬遷	搬迁	bānqiān
辦不到	办不到	bànbudào
半邊天	半边天	bànbiāntiān
板塊	板块	bǎnkuài
半場	半场	bànchǎng
半島	半岛	bàndǎo
半路	半路	bànlù
半數	半数	bànshù
半途而廢	半途而废	bàntúérfèi
半信半疑	半信半疑	bànxìn-bànyí
半真半假	半真半假	bànzhēn-bànjiǎ
伴	伴	bàn
扮	扮	bàn
伴侶	伴侣	bànlǚ
伴隨	伴随	bànsuí
伴奏	伴奏	bànzòu
幫手	帮手	bāngshou
綁	绑	bǎng
拌	拌	bàn
綁架	绑架	bǎngjià
榜樣	榜样	bǎngyàng
包袱	包袱	bāofu
棒球	棒球	bàngqiú
磅	磅	bàng
包容	包容	bāoróng
包扎	包扎	bāozā
剝	剥	bō
煲	煲	bāo
飽和	饱和	bǎohé
飽滿	饱满	bǎomǎn
寶藏	宝藏	bǎozàng
保管	保管	bǎoguǎn
保姆	保姆	bǎomǔ
寶庫	宝库	bǎokù
保暖	保暖	bǎo nuǎn
保鮮	保鲜	bǎo xiān
保修	保修	bǎoxiū
保佑	保佑	bǎoyòu
保障	保障	bǎozhàng
保質期	保质期	bǎozhìqī
保重	保重	bǎozhòng
報	报	bào
堡壘	堡垒	bǎolěi
報仇	报仇	bào chóu
報酬	报酬	bàochou
報廢	报废	bào fèi
報社	报社	bàoshè
報亭	报亭	bàotíng
報復	报复	bàofu
報銷	报销	bào xiāo
抱負	抱负	bàofù
豹	豹	bào
暴風驟雨	暴风骤雨	bàofēng-zhòuyǔ
暴利	暴利	bàolì
暴躁	暴躁	bàozào
曝光	曝光	bào guāng
爆冷門	爆冷门	bàolěngmén
爆竹	爆竹	bàozhú
悲哀	悲哀	bēiāi
爆滿	爆满	bàomǎn
悲觀	悲观	bēiguān
悲歡離合	悲欢离合	bēihuān-líhé
卑鄙	卑鄙	bēibǐ
悲痛	悲痛	bēitòng
碑	碑	bēi
貝殼	贝壳	bèiké
備課	备课	bèi kè
備受	备受	bèishòu
背面	背面	bèimiàn
備用	备用	bèiyòng
背誦	背诵	bèisòng
背叛	背叛	bèipàn
被捕	被捕	bèibǔ
奔赴	奔赴	bēnfù
奔波	奔波	bēnbō
本分	本分	běnfèn
本能	本能	běnnéng
本錢	本钱	běnqián
本性	本性	běnxìng
本著	本着	běnzhe
本意	本意	běnyì
奔	奔	bēn
笨蛋	笨蛋	bèndàn
笨重	笨重	bènzhòng
崩潰	崩溃	bēngkuì
繃帶	绷带	bēngdài
繃	绷	běng
本色	本色	běnsè
逼近	逼近	bījìn
蹦	蹦	bèng
逼迫	逼迫	bīpò
比比皆是	比比皆是	bǐbǐ-jiēshì
逼真	逼真	bīzhēn
鼻涕	鼻涕	bítì
比不上	比不上	bǐbùshàng
比起	比起	bǐqǐ
比試	比试	bǐshi
比喻	比喻	bǐyù
鄙視	鄙视	bǐshì
必不可少	必不可少	bìbùkěshǎo
必定	必定	bìdìng
碧綠	碧绿	bìlǜ
弊病	弊病	bìbìng
弊端	弊端	bìduān
避難	避难	bì nàn
壁畫	壁画	bìhuà
避暑	避暑	bì shǔ
邊界	边界	biānjiè
邊疆	边疆	biānjiāng
邊遠	边远	biānyuǎn
編劇	编剧	biānjù
編號	编号	biānhào
編寫	编写	biānxiě
編造	编造	biānzào
編排	编排	biānpái
鞭策	鞭策	biāncè
鞭炮	鞭炮	biānpào
變革	变革	biàngé
貶值	贬值	biǎn zhí
變遷	变迁	biànqiān
變異	变异	biànyì
變幻莫測	变幻莫测	biànhuànmòcè
便道	便道	biàndào
變質	变质	biànzhì
便飯	便饭	biànfàn
便利店	便利店	biànlìdiàn
便捷	便捷	biànjié
辨別	辨别	biànbié
遍布	遍布	biànbù
辨認	辨认	biànrèn
辯	辩	biàn
辯護	辩护	biànhù
辮子	辫子	biànzi
辯解	辩解	biànjiě
標榜	标榜	biāobǎng
標	标	biāo
標本	标本	biāoběn
標簽	标签	biāoqiān
標示	标示	biāoshì
標語	标语	biāoyǔ
飆升	飙升	biāoshēng
標致	标致	biāozhi
表白	表白	biǎobái
表決	表决	biǎojué
表述	表述	biǎoshù
表率	表率	biǎoshuài
表彰	表彰	biǎozhāng
憋	憋	biē
別具匠心	别具匠心	biéjù-jiàngxīn
別看	别看	biékàn
表態	表态	biǎo tài
別墅	别墅	biéshù
別說	别说	biéshuō
別提了	别提了	biétíle
別扭	别扭	bièniu
別致	别致	biézhì
彬彬有禮	彬彬有礼	bīnbīn-yǒulǐ
繽紛	缤纷	bīnfēn
冰棍兒	冰棍儿	bīnggùnr5
濱海	滨海	bīnhǎi
丙	丙	bǐng
秉承	秉承	bǐngchéng
冰山	冰山	bīngshān
併購	并购	bìnggòu
並列	并列	bìngliè
並非	并非	bìngfēi
病床	病床	bìngchuáng
並行	并行	bìngxíng
撥	拨	bō
病癥	病症	bìngzhèng
撥款	拨款	bōkuǎn
波及	波及	bōjí
撥通	拨通	bōtōng
波瀾	波澜	bōlán
波折	波折	bōzhé
剝奪	剥夺	bōduó
波濤	波涛	bōtāo
伯伯	伯伯	bóbo
剝削	剥削	bōxuē
伯母	伯母	bómǔ
駁回	驳回	bóhuí
脖子	脖子	bózi
伯父	伯父	bófù
搏鬥	搏斗	bódòu
不見得	不见得	bùjiànde
不定	不定	bùdìng
不慎	不慎	bùshèn
不利於	不利于	bù lìyú
不算	不算	bùsuàn
不像話	不像话	bù xiànghuà
不屑	不屑	bùxiè
不適	不适	bùshì
不亞於	不亚于	bùyàyú
不亦樂乎	不亦乐乎	bùyìlèhū
不懈	不懈	bùxiè
不翼而飛	不翼而飞	bùyìérfēi
不正之風	不正之风	bùzhèngzhīfēng
補給	补给	bǔjǐ
不用說	不用说	bùyòngshuō
捕捉	捕捉	bǔzhuō
哺育	哺育	bǔyù
不恥下問	不耻下问	bùchǐ-xiàwèn
不辭而別	不辞而别	bùcíérbié
補救	补救	bǔjiù
不得而知	不得而知	bùdéérzhī
不妨	不妨	bùfáng
不得已	不得已	bùdéyǐ
不服氣	不服气	bùfúqì
不假思索	不假思索	bùjiǎ-sīsuǒ
不解	不解	bùjiě
不經意	不经意	bùjīngyì
不景氣	不景气	bù jǐngqì
不堪	不堪	bùkān
不服	不服	bùfú
不可思議	不可思议	bùkě-sīyì
不可避免	不可避免	bùkěbìmiǎn
不肯	不肯	bù kěn
不理	不理	bùlǐ
不了了之	不了了之	bùliǎo-liǎozhī
不難	不难	bù nán
不平	不平	bùpíng
不起眼	不起眼	bùqǐyǎn
不如說	不如说	bùrú shuō
不同尋常	不同寻常	bùtóngxúncháng
不為人知	不为人知	bùwéirénzhī
不惜	不惜	bùxī
不容	不容	bùróng
不相上下	不相上下	bùxiāngshàngxià
不已	不已	bùyǐ
不宜	不宜	bùyí
不以為然	不以为然	bùyǐwéirán
不由自主	不由自主	bùyóu-zìzhǔ
不予	不予	bùyǔ
不由得	不由得	bùyóude
不約而同	不约而同	bùyuēértóng
不知	不知	bùzhī
不知不覺	不知不觉	bùzhī-bùjué
不准	不准	bùzhǔn
布局	布局	bùjú
步入	步入	bùrù
步驟	步骤	bùzhòu
部件	部件	bùjiàn
步伐	步伐	bùfá
部署	部署	bùshǔ
猜謎	猜谜	cāi mí
猜想	猜想	cāixiǎng
財經	财经	cáijīng
財力	财力	cáilì
財務	财务	cáiwù
才華	才华	cáihuá
財政	财政	cáizhèng
裁	裁	cái
財物	财物	cáiwù
裁定	裁定	cáidìng
採	采	cǎi
裁決	裁决	cáijué
採礦	采矿	cǎi kuàng
彩虹	彩虹	cǎihóng
彩電	彩电	cǎidiàn
彩霞	彩霞	cǎixiá
菜市場	菜市场	càishìchǎng
採集	采集	cǎijí
參見	参见	cānjiàn
參謀	参谋	cānmóu
參軍	参军	cān jūn
餐桌	餐桌	cānzhuō
參照	参照	cānzhào
殘留	残留	cánliú
殘缺	残缺	cánquē
殘	残	cán
殘忍	残忍	cánrěn
慚愧	惭愧	cánkuì
慘痛	惨痛	cǎntòng
慘重	惨重	cǎnzhòng
慘白	惨白	cǎnbái
蒼蠅	苍蝇	cāngying
滄桑	沧桑	cāngsāng
艙	舱	cāng
燦爛	灿烂	cànlàn
藏品	藏品	cángpǐn
藏匿	藏匿	cángnì
藏身	藏身	cángshēn
操心	操心	cāo xīn
操勞	操劳	cāoláo
操控	操控	cāokòng
槽	槽	cáo
草案	草案	cǎoàn
草坪	草坪	cǎopíng
側面	侧面	cèmiàn
側重	侧重	cèzhòng
測算	测算	cèsuàn
測驗	测验	cèyàn
層出不窮	层出不穷	céngchū-bùqióng
蹭	蹭	cèng
差錯	差错	chācuò
差額	差额	chāé
插手	插手	chā shǒu
插圖	插图	chātú
插嘴	插嘴	chā zuǐ
茶道	茶道	chádào
茶館兒	茶馆儿	cháguǎnr5
查處	查处	cháchǔ
查明	查明	chámíng
查找	查找	cházhǎo
察覺	察觉	chájué
察看	察看	chákàn
詫異	诧异	chàyì
摻	掺	càn
攙	搀	chān
饞	馋	chán
禪杖	禅杖	chánzhàng
纏	缠	chán
產	产	chǎn
產地	产地	chǎndì
產物	产物	chǎnwù
產值	产值	chǎnzhí
铲	铲	chǎn
鏟子	铲子	chǎnzi
闡述	阐述	chǎnshù
顫抖	颤抖	chàndǒu
猖狂	猖狂	chāngkuáng
長達	长达	chángdá
長期以來	长期以来	chángqīyǐlái
長效	长效	chángxiào
長征	长征	chángzhēng
長足	长足	chángzú
常理	常理	chánglǐ
常人	常人	chángrén
常態	常态	chángtài
常溫	常温	chángwēn
償還	偿还	chánghuán
嫦娥	嫦娥	Chángé
廠家	厂家	chǎngjiā
敞開	敞开	chǎng kāi
暢談	畅谈	chàngtán
暢銷	畅销	chàngxiāo
倡議	倡议	chàngyì
抄襲	抄袭	chāoxí
鈔票	钞票	chāopiào
超標	超标	chāo biāo
超車	超车	chāo chē
超前	超前	chāoqián
超速	超速	chāosù
朝代	朝代	cháodài
朝著	朝着	cháozhe
嘲弄	嘲弄	cháonòng
嘲笑	嘲笑	cháoxiào
吵嘴	吵嘴	chǎo zuǐ
車道	车道	chēdào
車禍	车祸	chēhuò
車間	车间	chējiān
車速	车速	chēsù
車輪	车轮	chēlún
車位	车位	chēwèi
車廂	车厢	chēxiāng
車型	车型	chēxíng
車軸	车轴	chēzhóu
扯	扯	chě
徹夜	彻夜	chèyè
撤	撤	chè
撤換	撤换	chèhuàn
沉甸甸	沉甸甸	chéndiàndiàn
沉澱	沉淀	chéndiàn
沉浸	沉浸	chénjìn
沉悶	沉闷	chénmèn
沉迷	沉迷	chénmí
沉思	沉思	chénsī
沉穩	沉稳	chénwěn
沉著	沉着	chénzhuó
陳舊	陈旧	chénjiù
陳列	陈列	chénliè
陳述	陈述	chénshù
襯托	衬托	chèntuō
趁	趁	chèn
趁機	趁机	chènjī
趁早	趁早	chènzǎo
趁著	趁着	chènzhe
稱呼	称呼	chēnghu
稱作	称作	chēngzuò
成才	成才	chéng cái
成家	成家	chéng jiā
成年	成年	chéng nián
成千上萬	成千上万	chéngqiān-shàngwàn
成群結隊	成群结队	chéngqún-jiéduì
成天	成天	chéngtiān
成問題	成问题	chéng wèntí
成型	成型	chéngxíng
呈現	呈现	chéngxiàn
誠懇	诚恳	chéngkěn
誠心誠意	诚心诚意	chéngxīn-chéngyì
誠意	诚意	chéngyì
誠摯	诚挚	chéngzhì
承包	承包	chéngbāo
承載	承载	chéngzài
城牆	城墙	chéngqiáng
乘人之危	乘人之危	chéngrénzhīwēi
盛	盛	shèng
懲處	惩处	chéngchǔ
懲罰	惩罚	chéngfá
澄清	澄清	chéngqīng
橙汁	橙汁	chéngzhī
逞能	逞能	chěng néng
逞強	逞强	chěng qiáng
秤	秤	chèng
吃不上	吃不上	chībushàng
吃喝玩樂	吃喝玩乐	chīhē-wánlè
吃苦	吃苦	chī kǔ
吃虧	吃亏	chī kuī
痴呆	痴呆	chīdāi
痴迷	痴迷	chīmí
痴心	痴心	chīxīn
池塘	池塘	chítáng
馳名	驰名	chímíng
遲遲	迟迟	chíchí
遲疑	迟疑	chíyí
遲早	迟早	chízǎo
持	持	chí
持久	持久	chíjiǔ
持之以恆	持之以恒	chízhīyǐhéng
尺度	尺度	chǐdù
恥辱	耻辱	chǐrǔ
恥笑	耻笑	chǐxiào
赤字	赤字	chìzì
翅膀	翅膀	chìbǎng
衝刺	冲刺	chōngcì
衝浪	冲浪	chōnglàng
沖洗	冲洗	chōngxǐ
衝撞	冲撞	chōngzhuàng
充	充	chōng
充當	充当	chōngdāng
充沛	充沛	chōngpèi
充實	充实	chōngshí
重播	重播	chóngbō
重疊	重叠	chóngdié
重返	重返	chóngfǎn
重申	重申	chóngshēn
重現	重现	chóngxiàn
重合	重合	chónghé
崇高	崇高	chónggāo
崇尚	崇尚	chóngshàng
寵	宠	chǒng
寵愛	宠爱	chǒngài
抽簽	抽签	chōu qiān
抽屜	抽屉	chōuti
抽象	抽象	chōuxiàng
仇	仇	chóu
仇恨	仇恨	chóuhèn
仇人	仇人	chóurén
稠	稠	chóu
稠密	稠密	chóumì
愁眉苦臉	愁眉苦脸	chóuméi-kǔliǎn
籌	筹	chóu
籌辦	筹办	chóubàn
籌措	筹措	chóucuò
籌劃	筹划	chóuhuà
籌碼	筹码	chóumǎ
籌備	筹备	chóubèi
籌集	筹集	chóují
醜惡	丑恶	chǒuè
醜陋	丑陋	chǒulòu
醜聞	丑闻	chǒuwén
瞅	瞅	chǒu
出版社	出版社	chūbǎnshè
出廠	出厂	chū chǎng
出醜	出丑	chū chǒu
出道	出道	chū dào
出發點	出发点	chūfādiǎn
出風頭	出风头	chū fēngtou
出境	出境	chū jìng
出局	出局	chū jú
出具	出具	chūjù
出口成章	出口成章	chūkǒu-chéngzhāng
出賣	出卖	chūmài
出毛病	出毛病	chū máobing
出難題	出难题	chū nántí
出人意料	出人意料	chūrényìliào
出任	出任	chūrèn
出山	出山	chū shān
出身	出身	chūshēn
出示	出示	chūshì
出手	出手	chū shǒu
出頭	出头	chū tóu
出土	出土	chū tǔ
出息	出息	chūxi
出血	出血	chūxiě
出演	出演	chūyǎn
出洋相	出洋相	chū yángxiàng
出遊	出游	chūyóu
出眾	出众	chūzhòng
出主意	出主意	chū zhǔyì
出資	出资	chū zī
出自	出自	chūzì
初次	初次	chūcì
出走	出走	chūzǒu
初衷	初衷	chūzhōng
除此之外	除此之外	chúcǐzhīwài
除去	除去	chúqù
除外	除外	chúwài
處方	处方	chǔfāng
處境	处境	chǔjìng
處置	处置	chǔzhì
儲備	储备	chǔbèi
儲蓄	储蓄	chǔxù
觸動	触动	chùdòng
觸犯	触犯	chùfàn
觸覺	触觉	chùjué
觸摸	触摸	chùmō
觸目驚心	触目惊心	chùmù-jīngxīn
揣	揣	chuāi
揣測	揣测	chuǎicè
揣摩	揣摩	chuǎimó
踹	踹	chuài
川流不息	川流不息	chuānliú-bùxī
穿過	穿过	chuān guò
穿小鞋	穿小鞋	chuān xiǎoxié
穿越	穿越	chuānyuè
穿著	穿着	chuānzhuó
傳承	传承	chuánchéng
傳奇	传奇	chuánqí
傳染	传染	chuánrǎn
傳染病	传染病	chuánrǎnbìng
傳人	传人	chuánrén
傳授	传授	chuánshòu
傳聞	传闻	chuánwén
船舶	船舶	chuánbó
船槳	船桨	chuánjiǎng
喘	喘	chuǎn
喘息	喘息	chuǎnxī
串門	串门	chuàn mén
創傷	创伤	chuāngshāng
床位	床位	chuángwèi
創	创	chuàng
創始人	创始人	chuàngshǐrén
吹了	吹了	chuīle
吹牛	吹牛	chuī niú
吹捧	吹捧	chuīpěng
垂	垂	chuí
垂頭喪氣	垂头丧气	chuítóu-sàngqì
捶	捶	chuí
錘子	锤子	chuízi
純粹	纯粹	chúncuì
純潔	纯洁	chúnjié
純樸	纯朴	chúnpǔ
醇厚	醇厚	chúnhòu
蠢	蠢	chǔn
戳	戳	chuō
綽號	绰号	chuòhào
瓷	瓷	cí
瓷器	瓷器	cíqì
辭	辞	cí
辭呈	辞呈	cíchéng
辭去	辞去	cíqù
辭退	辞退	cítuì
慈善	慈善	císhàn
慈祥	慈祥	cíxiáng
磁帶	磁带	cídài
磁卡	磁卡	cíkǎ
磁盤	磁盘	cípán
此起彼伏	此起彼伏	cǐqǐ-bǐfú
次日	次日	cìrì
伺候	伺候	cìhou
刺耳	刺耳	cìěr
刺骨	刺骨	cìgǔ
刺繡	刺绣	cìxiù
賜	赐	cì
賜教	赐教	cìjiào
匆匆	匆匆	cōngcōng
匆忙	匆忙	cōngmáng
蔥	葱	cōng
從今以後	从今以后	cóngjīnyǐhòu
從來不	从来不	cóngláibù
從容	从容	cóngróng
從容不迫	从容不迫	cóngróng-bùpò
從頭	从头	cóngtóu
從未	从未	cóngwèi
從業	从业	cóngyè
從早到晚	从早到晚	cóngzǎodàowǎn
叢林	丛林	cónglín
湊	凑	còu
湊合	凑合	còuhe
湊巧	凑巧	còuqiǎo
粗暴	粗暴	cūbào
粗糙	粗糙	cūcāo
粗魯	粗鲁	cūlu
粗略	粗略	cūlüè
粗心大意	粗心大意	cūxīn-dàyì
促成	促成	cùchéng
簇擁	簇拥	cùyōng
竄	窜	cuàn
催	催	cuī
催促	催促	cuīcù
催眠	催眠	cuīmián
摧毀	摧毁	cuīhuǐ
脆弱	脆弱	cuìruò
翠綠	翠绿	cuìlǜ
存放	存放	cúnfàng
存心	存心	cúnxīn
存折	存折	cúnzhé
搓	搓	cuō
磋商	磋商	cuōshāng
挫折	挫折	cuòzhé
措手不及	措手不及	cuòshǒu-bùjí
錯覺	错觉	cuòjué
錯位	错位	cuò wèi
錯綜複雜	错综复杂	cuòzōng-fùzá
錯別字	错别字	cuòbiézì
搭乘	搭乘	dāchéng
搭建	搭建	dājiàn
達標	达标	dábiāo
答辯	答辩	dábiàn
打岔	打岔	dǎ chà
打倒	打倒	dǎ dǎo
打盹兒	打盹儿	dǎ dǔnr5
打交道	打交道	dǎ jiāodao
打攪	打搅	dǎjiǎo
打撈	打捞	dǎlāo
打量	打量	dǎliang
打獵	打猎	dǎ liè
打磨	打磨	dǎmo
打通	打通	dǎ tōng
打仗	打仗	dǎ zhàng
打招呼	打招呼	dǎ zhāohu
大包大攬	大包大揽	dàbāodàlǎn
大筆	大笔	dàbǐ
大臣	大臣	dàchén
大吃一驚	大吃一惊	dàchī-yījīng
大大咧咧	大大咧咧	dàda-liēliē
大地	大地	dàdì
大隊	大队	dàduì
大幅度	大幅度	dàfúdù
大公無私	大公无私	dàgōng-wúsī
大家庭	大家庭	dàjiātíng
大街小巷	大街小巷	dàjiē-xiǎoxiàng
大驚小怪	大惊小怪	dàjīng-xiǎoguài
大局	大局	dàjú
大款	大款	dàkuǎn
大面積	大面积	dàmiànjī
大名鼎鼎	大名鼎鼎	dàmíng-dǐngdǐng
大模大樣	大模大样	dàmú-dàyàng
大棚	大棚	dàpéng
大片	大片	dàpiàn
大氣	大气	dàqì
大廈	大厦	dàshà
大數據	大数据	dàshùjù
大肆	大肆	dàsì
大體	大体	dàtǐ
大體上	大体上	dàtǐshàng
大同小異	大同小异	dàtóng-xiǎoyì
大腕兒	大腕儿	dàwànr5
大選	大选	dàxuǎn
大雁	大雁	dàyàn
大意	大意	dàyi
大有可為	大有可为	dàyǒu-kěwéi
大宗	大宗	dàzōng
歹徒	歹徒	dǎitú
逮	逮	dǎi
代號	代号	dàihào
代理人	代理人	dàilǐrén
代言人	代言人	dàiyánrén
帶隊	带队	dài duì
帶路	带路	dài lù
帶頭	带头	dài tóu
帶頭人	带头人	dàitóurén
待	待	dài
怠工	怠工	dài gōng
怠慢	怠慢	dàimàn
逮捕	逮捕	dàibǔ
擔	担	dān
擔當	担当	dāndāng
擔負	担负	dānfù
單邊	单边	dānbiān
單薄	单薄	dānbó
單方面	单方面	dānfāngmiàn
單身	单身	dānshēn
耽擱	耽搁	dānge
耽誤	耽误	dānwu
膽怯	胆怯	dǎnqiè
膽子	胆子	dǎnzi
但願	但愿	dànyuàn
擔子	担子	dànzi
誕辰	诞辰	dànchén
淡化	淡化	dànhuà
淡季	淡季	dànjì
蛋白質	蛋白质	dànbáizhì
當即	当即	dāngjí
當今	当今	dāngjīn
當面	当面	dāng miàn
當日	当日	dāngrì
當事人	当事人	dāngshìrén
當務之急	当务之急	dāngwùzhījí
當下	当下	dāngxià
當心	当心	dāngxīn
當著	当着	dāngzhe
當之無愧	当之无愧	dāngzhī-wúkuì
當眾	当众	dāngzhòng
當晚	当晚	dàngwǎn
當真	当真	dàngzhēn
蕩漾	荡漾	dàngyàng
檔次	档次	dàngcì
導彈	导弹	dǎodàn
導航	导航	dǎoháng
導火索	导火索	dǎohuǒsuǒ
導師	导师	dǎoshī
導向	导向	dǎoxiàng
島嶼	岛屿	dǎoyǔ
搗亂	捣乱	dǎo luàn
倒賣	倒卖	dǎomài
倒霉	倒霉	dǎo méi
倒塌	倒塌	dǎotā
倒下	倒下	dǎoxià
到頭來	到头来	dàotóulái
到位	到位	dàowèi
倒計時	倒计时	dàojìshí
倒數	倒数	dàoshǔ
盜	盗	dào
盜竊	盗窃	dàoqiè
悼念	悼念	dàoniàn
道具	道具	dàojù
稻草	稻草	dàocǎo
得不償失	得不偿失	débùchángshī
得當	得当	dédàng
得力	得力	dé lì
得失	得失	déshī
得手	得手	dé shǒu
得體	得体	détǐ
得天獨厚	得天独厚	détiān-dúhòu
得益於	得益于	déyìyú
得意揚揚	得意扬扬	déyì-yángyáng
得知	得知	dézhī
得罪	得罪	dézui
德	德	dé
燈籠	灯笼	dēnglong
燈泡	灯泡	dēngpào
登機	登机	dēng jī
登陸	登陆	dēng lù
蹬	蹬	dēng
凳子	凳子	dèngzi
瞪	瞪	dèng
低調	低调	dīdiào
低估	低估	dīgū
低谷	低谷	dīgǔ
低價	低价	dījià
低迷	低迷	dīmí
低碳	低碳	dītàn
低下	低下	dīxià
堤	堤	dī
堤壩	堤坝	dībà
提防	提防	dīfang
笛子	笛子	dízi
抵觸	抵触	dǐchù
抵擋	抵挡	dǐdǎng
抵消	抵消	dǐxiāo
抵押	抵押	dǐyā
抵禦	抵御	dǐyù
抵制	抵制	dǐzhì
底層	底层	dǐcéng
底線	底线	dǐxiàn
底蘊	底蕴	dǐyùn
底子	底子	dǐzi
地步	地步	dìbù
地道	地道	dìdao
地段	地段	dìduàn
地毯	地毯	dìtǎn
地理	地理	dìlǐ
地下水	地下水	dìxiàshuǐ
地獄	地狱	dìyù
地域	地域	dìyù
地質	地质	dìzhì
弟子	弟子	dìzǐ
帝國	帝国	dìguó
帝國主義	帝国主义	dìguózhǔyì
遞交	递交	dìjiāo
第一手	第一手	dìyīshǒu
第一線	第一线	dìyīxiàn
顛倒	颠倒	diāndǎo
顛覆	颠覆	diānfù
巔峰	巅峰	diānfēng
點火	点火	diǎn huǒ
點擊率	点击率	diǎnjīlǜ
典範	典范	diǎnfàn
點評	点评	diǎnpíng
點心	点心	diǎnxin
點綴	点缀	diǎnzhuì
點子	点子	diǎnzi
電報	电报	diànbào
電線	电线	diànxiàn
電網	电网	diànwǎng
電鈴	电铃	diànlíng
電信	电信	diànxìn
電訊	电讯	diànxùn
墊	垫	diàn
墊底	垫底	diàndǐ
墊子	垫子	diànzi
澱粉	淀粉	diànfěn
惦記	惦记	diànji
奠定	奠定	diàndìng
殿堂	殿堂	diàntáng
刁難	刁难	diāonàn
叼	叼	diāo
雕	雕	diāo
雕刻	雕刻	diāokè
雕塑	雕塑	diāosù
吊銷	吊销	diàoxiāo
釣魚	钓鱼	diào yú
調度	调度	diàodù
掉隊	掉队	diào duì
掉頭	掉头	diào tóu
爹	爹	diē
迭起	迭起	diéqǐ
疊	叠	dié
丁	丁	dīng
叮囑	叮嘱	dīngzhǔ
釘子	钉子	dīngzi
盯	盯	dīng
頂多	顶多	dǐngduō
頂級	顶级	dǐngjí
頂尖	顶尖	dǐngjiān
訂單	订单	dìngdān
訂購	订购	dìnggòu
訂婚	订婚	dìng hūn
訂立	订立	dìnglì
釘	钉	dīng
定金	定金	dìngjīn
定居	定居	dìng jū
定論	定论	dìnglùn
定為	定为	dìng wèi
定向	定向	dìngxiàng
定心丸	定心丸	dìngxīnwán
定做	定做	dìngzuò
丟掉	丢掉	diūdiào
定義	定义	dìngyì
丟臉	丢脸	diū liǎn
丟棄	丢弃	diūqì
丟人	丢人	diū rén
丟失	丢失	diūshī
東奔西走	东奔西走	dōngbēnxīzǒu
東道主	东道主	dōngdàozhǔ
東張西望	东张西望	dōngzhāng-xīwàng
董事	董事	dǒngshì
董事會	董事会	dǒngshìhuì
董事長	董事长	dǒngshìzhǎng
懂事	懂事	dǒng shì
動不動	动不动	dòngbudòng
動蕩	动荡	dòngdàng
動感	动感	dònggǎn
動工	动工	dòng gōng
動靜	动静	dòngjing
動脈	动脉	dòngmài
動身	动身	dòng shēn
動彈	动弹	dòngtan
動聽	动听	dòngtīng
動向	动向	dòngxiàng
動用	动用	dòngyòng
凍結	冻结	dòngjié
棟	栋	dòng
棟梁	栋梁	dòngliáng
兜	兜	dōu
兜兒	兜儿	dōur5
兜售	兜售	dōushòu
陡	陡	dǒu
抖	抖	dǒu
鬥	斗	dòu
鬥志	斗志	dòuzhì
豆漿	豆浆	dòujiāng
豆子	豆子	dòuzi
逗	逗	dòu
都會	都会	dūhuì
督促	督促	dūcù
獨	独	dú
獨唱	独唱	dúchàng
獨家	独家	dújiā
獨立自主	独立自主	dúlì-zìzhǔ
獨身	独身	dúshēn
獨一無二	独一无二	dúyī-wúèr
堵塞	堵塞	dǔsè
杜絕	杜绝	dùjué
妒忌	妒忌	dùjì
度	度	dù
度假	度假	dù jià
渡過	渡过	dùguò
端正	端正	duānzhèng
短缺	短缺	duǎnquē
短暫	短暂	duǎnzàn
段落	段落	duànluò
斷斷續續	断断续续	duànduàn-xùxù
斷定	断定	duàndìng
斷裂	断裂	duànliè
堆砌	堆砌	duīqì
隊形	队形	duìxíng
對白	对白	duìbái
對策	对策	duìcè
對稱	对称	duìchèn
對得起	对得起	duìdeqǐ
對聯	对联	duìlián
對弈	对弈	duìyì
對照	对照	duìzhào
對峙	对峙	duìzhì
對準	对准	duì zhǔn
兌換	兑换	duìhuàn
兌現	兑现	duìxiàn
敦厚	敦厚	dūnhòu
敦促	敦促	dūncù
頓時	顿时	dùnshí
多邊	多边	duōbiān
炖	炖	dùn
多功能	多功能	duōgōngnéng
多勞多得	多劳多得	duōláo-duōdé
多年來	多年来	duōniánlái
多心	多心	duōxīn
多虧	多亏	duōkuī
多元	多元	duōyuán
哆嗦	哆嗦	duōsuo
多餘	多余	duōyú
奪魁	夺魁	duókuí
奪冠	夺冠	duó guàn
躲藏	躲藏	duǒcáng
舵手	舵手	duòshǒu
躲避	躲避	duǒbì
墮落	堕落	duòluò
俄語	俄语	Éyǔ
訛詐	讹诈	ézhà
鵝	鹅	é
額外	额外	éwài
惡	恶	è
厄運	厄运	èyùn
惡劣	恶劣	èliè
惡化	恶化	èhuà
惡性	恶性	èxìng
惡意	恶意	èyì
遏制	遏制	èzhì
鱷魚	鳄鱼	èyú
恩賜	恩赐	ēncì
恩惠	恩惠	ēnhuì
恩情	恩情	ēnqíng
而已	而已	éryǐ
耳光	耳光	ěrguāng
恩怨	恩怨	ēnyuàn
耳目一新	耳目一新	ěrmù-yīxīn
耳熟能詳	耳熟能详	ěrshú-néngxiáng
耳聞目睹	耳闻目睹	ěrwén-mùdǔ
二手車	二手车	èrshǒuchē
二氧化碳	二氧化碳	èryǎnghuàtàn
發佈會	发布会	fābùhuì
發財	发财	fācái
發愁	发愁	fā chóu
發電機	发电机	fādiànjī
發抖	发抖	fādǒu
發光	发光	fāguāng
發憤圖強	发愤图强	fāfèn-túqiáng
發酵	发酵	fājiào
發掘	发掘	fājué
發火	发火	fā huǒ
發脾氣	发脾气	fā píqi
發起人	发起人	fāqǐrén
發熱	发热	fā rè
發誓	发誓	fā shì
發愣	发愣	fālèng
發揚	发扬	fāyáng
發揚光大	发扬光大	fāyáng-guāngdà
發育	发育	fāyù
發源地	发源地	fāyuándì
發泄	发泄	fāxiè
發作	发作	fāzuò
閥門	阀门	fámén
髮型	发型	fàxíng
帆	帆	fān
帆船	帆船	fānchuán
翻番	翻番	fān fān
翻來覆去	翻来覆去	fānlái-fùqù
翻天覆地	翻天覆地	fāntiān-fùdì
凡	凡	fán
煩悶	烦闷	fánmèn
煩惱	烦恼	fánnǎo
煩躁	烦躁	fánzào
繁華	繁华	fánhuá
繁忙	繁忙	fánmáng
繁體字	繁体字	fántǐzì
繁重	繁重	fánzhòng
反駁	反驳	fǎnbó
反差	反差	fǎnchā
反常	反常	fǎncháng
反倒	反倒	fǎndào
反感	反感	fǎngǎn
反過來	反过来	fǎnguolai
反擊	反击	fǎnjī
反饋	反馈	fǎnkuì
反面	反面	fǎnmiàn
反思	反思	fǎnsī
反彈	反弹	fǎntán
反省	反省	fǎnxǐng
返還	返还	fǎnhuán
犯愁	犯愁	fàn chóu
飯碗	饭碗	fànwǎn
泛濫	泛滥	fànlàn
範疇	范畴	fànchóu
販賣	贩卖	fànmài
方方面面	方方面面	fāngfāng-miànmiàn
方向盤	方向盘	fāngxiàngpán
方言	方言	fāngyán
防盜	防盗	fángdào
防盜門	防盗门	fángdàomén
防護	防护	fánghù
防火牆	防火墙	fánghuǒqiáng
防衛	防卫	fángwèi
防汛	防汛	fángxùn
防疫	防疫	fángyì
防禦	防御	fángyù
妨礙	妨碍	fángài
房地產	房地产	fángdìchǎn
妨害	妨害	fánghài
仿	仿	fǎng
仿製	仿制	fǎngzhì
訪談	访谈	fǎngtán
紡織	纺织	fǎngzhī
放過	放过	fàngguò
放水	放水	fàng shuǐ
放肆	放肆	fàngsì
放映	放映	fàngyìng
放置	放置	fàngzhì
放縱	放纵	fàngzòng
飛速	飞速	fēisù
飛往	飞往	fēi wǎng
飛翔	飞翔	fēixiáng
飛躍	飞跃	fēiyuè
非	非	fēi
非得	非得	fēiděi
非法	非法	fēifǎ
肥料	肥料	féiliào
非凡	非凡	fēifán
肥胖	肥胖	féipàng
緋聞	绯闻	fēiwén
肥沃	肥沃	féiwò
肥皂	肥皂	féizào
誹謗	诽谤	fěibàng
廢	废	fèi
廢除	废除	fèichú
廢話	废话	fèihuà
廢品	废品	fèipǐn
廢寢忘食	废寝忘食	fèiqǐn-wàngshí
廢物	废物	fèiwu
廢墟	废墟	fèixū
沸沸揚揚	沸沸扬扬	fèifèi-yángyáng
沸騰	沸腾	fèiténg
分辨	分辨	fēnbiàn
費勁	费劲	fèi jìn
分寸	分寸	fēncun
分擔	分担	fēndān
分割	分割	fēngē
分紅	分红	fēn hóng
分化	分化	fēnhuà
分泌	分泌	fēnmì
分明	分明	fēnmíng
分歧	分歧	fēnqí
分贓	分赃	fēn zāng
分支	分支	fēnzhī
芬芳	芬芳	fēnfāng
氛圍	氛围	fēnwéi
吩咐	吩咐	fēnfu
墳	坟	fén
墳墓	坟墓	fénmù
焚燒	焚烧	fénshāo
粉	粉	fěn
粉絲	粉丝	fěnsī
粉碎	粉碎	fěnsuì
分量	分量	fènliang
分外	分外	fènwài
份額	份额	fèné
奮力	奋力	fènlì
奮勇	奋勇	fènyǒng
糞	粪	fèn
糞便	粪便	fènbiàn
豐富多彩	丰富多彩	fēngfù-duōcǎi
豐厚	丰厚	fēnghòu
豐滿	丰满	fēngmǎn
豐碩	丰硕	fēngshuò
豐盛	丰盛	fēngshèng
風波	风波	fēngbō
風采	风采	fēngcǎi
風餐露宿	风餐露宿	fēngcān-lùsù
風和日麗	风和日丽	fēnghé-rìlì
風風雨雨	风风雨雨	fēngfēng-yǔyǔ
風浪	风浪	fēnglàng
風力	风力	fēnglì
風範	风范	fēngfàn
風流	风流	fēngliú
風貌	风貌	fēngmào
風氣	风气	fēngqì
風情	风情	fēngqíng
風尚	风尚	fēngshàng
風趣	风趣	fēngqù
風沙	风沙	fēngshā
風水	风水	fēngshui
風味	风味	fēngwèi
風雨	风雨	fēngyǔ
風雲	风云	fēngyún
風箏	风筝	fēngzheng
封頂	封顶	fēng dǐng
封面	封面	fēngmiàn
封建	封建	fēngjiàn
封鎖	封锁	fēngsuǒ
峰迴路轉	峰回路转	fēnghuí-lùzhuǎn
瘋子	疯子	fēngzi
蜂蜜	蜂蜜	fēngmì
逢	逢	féng
縫	缝	fèng
縫合	缝合	fénghé
諷刺	讽刺	fěngcì
鳳凰	凤凰	fènghuáng
孵化	孵化	fūhuà
否決	否决	fǒujué
扶持	扶持	fúchí
敷	敷	fū
服飾	服饰	fúshì
服務器	服务器	fúwùqì
服用	服用	fúyòng
俘獲	俘获	fúhuò
俘虜	俘虏	fúlǔ
浮力	浮力	fúlì
浮現	浮现	fúxiàn
浮躁	浮躁	fúzào
輻射	辐射	fúshè
福氣	福气	fúqi
撫摸	抚摸	fǔmō
撫恤	抚恤	fǔxù
撫養	抚养	fǔyǎng
撫養費	抚养费	fǔyǎngfèi
斧子	斧子	fǔzi
俯首	俯首	fǔshǒu
輔導	辅导	fǔdǎo
腐敗	腐败	fǔbài
腐化	腐化	fǔhuà
腐爛	腐烂	fǔlàn
腐蝕	腐蚀	fǔshí
腐朽	腐朽	fǔxiǔ
付費	付费	fù fèi
負面	负面	fùmiàn
付款	付款	fù kuǎn
負有	负有	fùyǒu
附	附	fù
附帶	附带	fùdài
附和	附和	fùhè
附加	附加	fùjiā
附屬	附属	fùshǔ
復查	复查	fùchá
赴	赴	fù
復發	复发	fùfā
複合	复合	fùhé
復活	复活	fùhuó
復興	复兴	fùxīng
復原	复原	fù yuán
副作用	副作用	fùzuòyòng
富含	富含	fùhán
賦予	赋予	fùyǔ
富豪	富豪	fùháo
富強	富强	fùqiáng
富翁	富翁	fùwēng
富裕	富裕	fùyù
腹部	腹部	fùbù
腹瀉	腹泻	fùxiè
富足	富足	fùzú
覆蓋	覆盖	fùgài
該	该	gāi
改版	改版	gǎi bǎn
改編	改编	gǎibiān
改革開放	改革开放	gǎigé-kāifàng
改動	改动	gǎidòng
改良	改良	gǎiliáng
改名	改名	gǎimíng
改日	改日	gǎirì
改為	改为	gǎiwéi
改邪歸正	改邪归正	gǎixié-guīzhèng
鈣	钙	gài
蓋子	盖子	gàizi
概況	概况	gàikuàng
概率	概率	gàilǜ
概論	概论	gàilùn
干戈	干戈	gāngē
乾旱	干旱	gānhàn
乾燥	干燥	gānzào
甘心	甘心	gānxīn
尷尬	尴尬	gāngà
肝臟	肝脏	gānzàng
趕赴	赶赴	gǎnfù
趕往	赶往	gǎnwǎng
敢情	敢情	gǎnqing
感	感	gǎn
感觸	感触	gǎnchù
感恩	感恩	gǎn ēn
感激	感激	gǎnjī
感慨	感慨	gǎnkǎi
感染	感染	gǎnrǎn
感染力	感染力	gǎnrǎnlì
感嘆	感叹	gǎntàn
感性	感性	gǎnxìng
幹部	干部	gànbù
幹事	干事	gànshi
綱領	纲领	gānglǐng
剛毅	刚毅	gāngyì
綱要	纲要	gāngyào
鋼	钢	gāng
缸	缸	gāng
杠鈴	杠铃	gànglíng
港	港	gǎng
高昂	高昂	gāoáng
高傲	高傲	gāoào
高超	高超	gāochāo
高低	高低	gāodī
高調	高调	gāodiào
高額	高额	gāoé
高爾夫球	高尔夫球	gāoěrfūqiú
高貴	高贵	gāoguì
高峰期	高峰期	gāofēngqī
高空	高空	gāokōng
高齡	高龄	gāolíng
高明	高明	gāomíng
高山	高山	gāoshān
高效	高效	gāoxiào
高新技術	高新技术	gāoxīn jìshù
高血壓	高血压	gāoxuèyā
高壓	高压	gāoyā
高雅	高雅	gāoyǎ
高漲	高涨	gāozhàng
搞鬼	搞鬼	gǎo guǐ
搞笑	搞笑	gǎoxiào
告	告	gào
告辭	告辞	gàocí
告誡	告诫	gàojiè
告示	告示	gàoshi
告知	告知	gàozhī
告狀	告状	gào zhuàng
戈壁	戈壁	gēbì
胳膊	胳膊	gēbo
鴿子	鸽子	gēzi
擱	搁	gē
擱置	搁置	gēzhì
擱淺	搁浅	gē qiǎn
割	割	gē
歌劇	歌剧	gējù
歌頌	歌颂	gēsòng
歌舞	歌舞	gēwǔ
歌詠	歌咏	gēyǒng
革命	革命	gémìng
格	格	gé
格格不入	格格不入	gégé-bùrù
格局	格局	géjú
格式	格式	géshi
隔閡	隔阂	géhé
隔離	隔离	gélí
個頭兒	个头儿	gètóur5
個案	个案	gèàn
各奔前程	各奔前程	gèbèn-qiánchéng
各式各樣	各式各样	gèshì-gèyàng
根深蒂固	根深蒂固	gēnshēn-dìgù
根源	根源	gēnyuán
根基	根基	gēnjī
根治	根治	gēnzhì
跟上	跟上	gēn shàng
跟蹤	跟踪	gēnzōng
跟不上	跟不上	gēnbushàng
更衣室	更衣室	gēngyīshì
更改	更改	gēnggǎi
耕地	耕地	gēngdì
耿直	耿直	gěngzhí
工地	工地	gōngdì
工會	工会	gōnghuì
工商界	工商界	gōngshāngjiè
工科	工科	gōngkē
工序	工序	gōngxù
工整	工整	gōngzhěng
工作量	工作量	gōngzuòliàng
公車	公车	gōngchē
公安局	公安局	gōngānjú
公道	公道	gōngdao
公費	公费	gōngfèi
公共場所	公共场所	gōnggòng chǎngsuǒ
公關	公关	gōngguān
弓	弓	gōng
公函	公函	gōnghán
公積金	公积金	gōngjījīn
公開信	公开信	gōngkāixìn
公墓	公墓	gōngmù
公款	公款	gōngkuǎn
公僕	公仆	gōngpú
公頃	公顷	gōngqǐng
公然	公然	gōngrán
公示	公示	gōngshì
公事	公事	gōngshì
公益	公益	gōngyì
公務	公务	gōngwù
公益性	公益性	gōngyì xìng
公立	公立	gōnglì
公寓	公寓	gōngyù
公約	公约	gōngyuē
公用	公用	gōngyòng
公證	公证	gōngzhèng
功	功	gōng
功臣	功臣	gōngchén
功底	功底	gōngdǐ
公職	公职	gōngzhí
功力	功力	gōnglì
功勞	功劳	gōngláo
功效	功效	gōngxiào
攻讀	攻读	gōngdú
攻	攻	gōng
攻關	攻关	gōng guān
功率	功率	gōnglǜ
供不應求	供不应求	gōngbùyìngqiú
供	供	gōng
供暖	供暖	gōngnuǎn
宮殿	宫殿	gōngdiàn
供求	供求	gōngqiú
宮廷	宫廷	gōngtíng
恭維	恭维	gōngwei
恭喜	恭喜	gōngxǐ
拱	拱	gǒng
共鳴	共鸣	gòngmíng
共識	共识	gòngshí
共性	共性	gòngxìng
供奉	供奉	gòngfèng
共同體	共同体	gòngtóngtǐ
勾畫	勾画	gōuhuà
勾	勾	gōu
勾結	勾结	gōujié
鉤	钩	gōu
鉤子	钩子	gōuzi
構思	构思	gòusī
構想	构想	gòuxiǎng
購	购	gòu
夠嗆	够呛	gòuqiàng
估算	估算	gūsuàn
沽名釣譽	沽名钓誉	gūmíng-diàoyù
孤單	孤单	gūdān
孤立	孤立	gūlì
孤零零	孤零零	gūlínglíng
孤陋寡聞	孤陋寡闻	gūlòu-guǎwén
辜負	辜负	gūfù
古董	古董	gǔdǒng
古怪	古怪	gǔguài
古跡	古迹	gǔjì
古今中外	古今中外	gǔjīn-zhōngwài
古樸	古朴	gǔpǔ
古人	古人	gǔrén
股份	股份	gǔfèn
股民	股民	gǔmín
股市	股市	gǔshì
骨幹	骨干	gǔgàn
骨折	骨折	gǔzhé
骨氣	骨气	gǔqì
鼓舞	鼓舞	gǔwǔ
鼓動	鼓动	gǔdòng
固然	固然	gùrán
固執	固执	gùzhi
故	故	gù
顧不得	顾不得	gùbude
顧不上	顾不上	gùbushàng
顧及	顾及	gù jí
顧慮	顾虑	gùlǜ
雇	雇	gù
顧全大局	顾全大局	gùquándàjú
雇傭	雇佣	gùyōng
雇員	雇员	gùyuán
雇主	雇主	gùzhǔ
瓜分	瓜分	guāfēn
瓜子	瓜子	guāzǐ
寡婦	寡妇	guǎfu
颳風	刮风	guāfēng
掛鉤	挂钩	guàgōu
掛號	挂号	guà hào
掛念	挂念	guàniàn
掛失	挂失	guà shī
乖	乖	guāi
乖巧	乖巧	guāiqiǎo
拐彎	拐弯	guǎiwān
拐杖	拐杖	guǎizhàng
怪不得	怪不得	guàibude
怪物	怪物	guàiwu
怪異	怪异	guàiyì
關掉	关掉	guāndiào
關節	关节	guānjié
關稅	关税	guānshuì
關頭	关头	guāntóu
關照	关照	guānzhào
觀測	观测	guāncè
觀感	观感	guāngǎn
觀摩	观摩	guānmó
觀賞	观赏	guānshǎng
觀望	观望	guānwàng
官兵	官兵	guānbīng
官吏	官吏	guānlì
官僚	官僚	guānliáo
官僚主義	官僚主义	guānliáozhǔyì
官員	官员	guānyuán
棺材	棺材	guāncai
管家	管家	guǎnjiā
管教	管教	guǎnjiào
管理費	管理费	guǎnlǐfèi
管轄	管辖	guǎnxiá
管用	管用	guǎn yòng
管子	管子	guǎnzi
貫徹	贯彻	guànchè
貫穿	贯穿	guànchuān
貫通	贯通	guàntōng
慣	惯	guàn
慣例	惯例	guànlì
慣性	惯性	guànxìng
灌	灌	guàn
灌溉	灌溉	guàngài
灌輸	灌输	guànshū
罐	罐	guàn
罐頭	罐头	guàntou
光彩	光彩	guāngcǎi
光碟	光碟	guāngdié
光顧	光顾	guānggù
光滑	光滑	guānghua
光環	光环	guānghuán
光纜	光缆	guānglǎn
光芒	光芒	guāngmáng
光明磊落	光明磊落	guāngmíng-lěiluò
光澤	光泽	guāngzé
廣義	广义	guǎngyì
歸根到底	归根到底	guīgēndàodǐ
歸還	归还	guīhuán
歸結	归结	guījié
歸來	归来	guīlái
歸納	归纳	guīnà
歸屬	归属	guīshǔ
歸宿	归宿	guīsù
龜	龟	guī
規格	规格	guīgé
規矩	规矩	guīju
閨女	闺女	guīnü
瑰寶	瑰宝	guībǎo
軌跡	轨迹	guǐjì
櫃檯	柜台	guìtái
貴賓	贵宾	guìbīn
貴重	贵重	guìzhòng
貴族	贵族	guìzú
桂花	桂花	guìhuā
滾動	滚动	gǔndòng
棍	棍	gùn
棍子	棍子	gùnzi
國寶	国宝	guóbǎo
國防	国防	guófáng
國畫	国画	guóhuà
國徽	国徽	guóhuī
國情	国情	guóqíng
國土	国土	guótǔ
國學	国学	guóxué
國有	国有	guóyǒu
果斷	果断	guǒduàn
果園	果园	guǒyuán
果真	果真	guǒzhēn
裹	裹	guǒ
過半	过半	guòbàn
過不去	过不去	guòbuqù
過錯	过错	guòcuò
過關	过关	guò guān
過道	过道	guòdào
過獎	过奖	guòjiǎng
過節	过节	guò jié
過境	过境	guò jìng
過濾	过滤	guòlǜ
過期	过期	guò qī
過剩	过剩	guòshèng
過失	过失	guòshī
過日子	过日子	guò rìzi
過頭	过头	guòtóu
過往	过往	guòwǎng
過意不去	过意不去	guòyìbùqù
過癮	过瘾	guò yǐn
過硬	过硬	guòyìng
過早	过早	guòzǎo
海岸	海岸	hǎiàn
海拔	海拔	hǎibá
海濱	海滨	hǎibīn
海盜	海盗	hǎidào
海量	海量	hǎiliàng
海綿	海绵	hǎimián
海面	海面	hǎimiàn
海內外	海内外	hǎinèiwài
海灘	海滩	hǎitān
海峽	海峡	hǎixiá
海嘯	海啸	hǎixiào
海域	海域	hǎiyù
海運	海运	hǎiyùn
海藻	海藻	hǎizǎo
駭人聽聞	骇人听闻	hàirén-tīngwén
害蟲	害虫	hàichóng
害臊	害臊	hài sào
害羞	害羞	hài xiū
酣暢	酣畅	hānchàng
酣睡	酣睡	hānshuì
含糊	含糊	hánhu
含蓄	含蓄	hánxù
函授	函授	hánshòu
涵蓋	涵盖	hángài
涵義	涵义	hányì
罕見	罕见	hǎnjiàn
汗水	汗水	hànshuǐ
旱	旱	hàn
旱災	旱灾	hànzāi
焊	焊	hàn
捍衛	捍卫	hànwèi
行家	行家	hángjia
行列	行列	hángliè
行情	行情	hángqíng
航海	航海	hánghǎi
航天	航天	hángtiān
航天員	航天员	hángtiānyuán
航運	航运	hángyùn
航行	航行	hángxíng
毫不	毫不	hàobù
毫不猶豫	毫不犹豫	háobù yóuyù
毫無	毫无	háowú
豪華	豪华	háohuá
好歹	好歹	hǎodǎi
好比	好比	hǎobǐ
好感	好感	hǎogǎn
好壞	好坏	hǎo-huài
好家伙	好家伙	hǎojiāhuo
好評	好评	hǎopíng
好說	好说	hǎoshuō
好笑	好笑	hǎoxiào
好心	好心	hǎoxīn
好心人	好心人	hǎoxīnrén
好意	好意	hǎoyì
好在	好在	hǎozài
號稱	号称	hàochēng
好客	好客	hàokè
好奇心	好奇心	hàoqíxīn
耗	耗	hào
耗費	耗费	hàofèi
耗時	耗时	hàoshí
浩劫	浩劫	hàojié
呵護	呵护	hēhù
禾苗	禾苗	hémiáo
合唱	合唱	héchàng
合伙	合伙	héhuǒ
合乎	合乎	héhū
合計	合计	héji
合情合理	合情合理	héqíng-hélǐ
合影	合影	héyǐng
合資	合资	hézī
合作社	合作社	hézuòshè
何必	何必	hébì
何處	何处	héchù
何苦	何苦	hékǔ
何況	何况	hékuàng
何時	何时	héshí
和藹	和蔼	héǎi
和解	和解	héjiě
和睦	和睦	hémù
和平共處	和平共处	hépínggòngchǔ
和氣	和气	héqi
和尚	和尚	héshang
河流	河流	héliú
河畔	河畔	hépàn
荷花	荷花	héhuā
核	核	hé
核電站	核电站	hédiànzhàn
核對	核对	héduì
核能	核能	hénéng
核桃	核桃	hétao
核實	核实	héshí
核武器	核武器	héwǔqì
賀信	贺信	hèxìn
賀電	贺电	hèdiàn
喝彩	喝彩	hè cǎi
赫然	赫然	hèrán
鶴立雞群	鹤立鸡群	hèlì-jīqún
黑客	黑客	hēikè
黑馬	黑马	hēimǎ
黑白	黑白	hēibái
黑手	黑手	hēishǒu
黑心	黑心	hēixīn
嘿	嘿	hēi
痕跡	痕迹	hénjì
恨不得	恨不得	hènbude
哼	哼	hēng
橫七豎八	横七竖八	héngqī-shùbā
橫向	横向	héngxiàng
橫	横	héng
轟	轰	hōng
轟動	轰动	hōngdòng
轟炸	轰炸	hōngzhà
哄	哄	hōng
哄堂大笑	哄堂大笑	hōngtáng-dàxiào
烘乾	烘干	hōng gān
烘托	烘托	hōngtuō
弘揚	弘扬	hóngyáng
紅燈	红灯	hóngdēng
紅火	红火	hónghuo
紅撲撲	红扑扑	hóngpūpū
紅潤	红润	hóngrùn
紅薯	红薯	hóngshǔ
紅眼	红眼	hóngyǎn
宏觀	宏观	hóngguān
宏偉	宏伟	hóngwěi
洪亮	洪亮	hóngliàng
喉嚨	喉咙	hóulong
吼	吼	hǒu
後備	后备	hòubèi
後備箱	后备箱	hòubèixiāng
後代	后代	hòudài
後盾	后盾	hòudùn
後顧之憂	后顾之忧	hòugùzhīyōu
後期	后期	hòuqī
後勤	后勤	hòuqín
後人	后人	hòurén
後臺	后台	hòutái
後退	后退	hòutuì
後續	后续	hòuxù
後遺癥	后遗症	hòuyízhèng
後裔	后裔	hòuyì
後者	后者	hòuzhě
厚道	厚道	hòudao
厚度	厚度	hòudù
候選人	候选人	hòuxuǎnrén
呼風喚雨	呼风唤雨	hūfēng-huànyǔ
呼喚	呼唤	hūhuàn
呼救	呼救	hūjiù
呼聲	呼声	hūshēng
呼應	呼应	hūyìng
呼吁	呼吁	hūyù
忽高忽低	忽高忽低	hūgāohūdī
忽悠	忽悠	hūyou
胡鬧	胡闹	húnào
胡說	胡说	húshuō
胡思亂想	胡思乱想	húsī-luànxiǎng
湖泊	湖泊	húpō
糊	糊	hū
糊塗	糊涂	hútu
互補	互补	hùbǔ
互訪	互访	hùfǎng
互信	互信	hùxìn
互助	互助	hùzhù
護理	护理	hùlǐ
花瓣	花瓣	huābàn
花卉	花卉	huāhuì
花紋	花纹	huāwén
花樣	花样	huāyàng
華麗	华丽	huálì
划算	划算	huásuàn
華僑	华侨	huáqiáo
華裔	华裔	huáyì
嘩變	哗变	huábiàn
嘩然	哗然	huárán
滑冰	滑冰	huá bīng
滑稽	滑稽	huáji
滑梯	滑梯	huátī
滑雪	滑雪	huá xuě
化肥	化肥	huàféi
化身	化身	huàshēn
化纖	化纤	huàxiān
化險為夷	化险为夷	huàxiǎn-wéiyí
化驗	化验	huàyàn
化妝	化妆	huà zhuāng
劃時代	划时代	huàshídài
畫冊	画册	huàcè
畫龍點睛	画龙点睛	huàlóng-diǎnjīng
畫蛇添足	画蛇添足	huàshé-tiānzú
畫展	画展	huàzhǎn
話費	话费	huàfèi
話筒	话筒	huàtǒng
話語	话语	huàyǔ
懷抱	怀抱	huáibào
懷舊	怀旧	huáijiù
懷裡	怀里	huáilǐ
懷孕	怀孕	huái yùn
懷著	怀着	huáizhe
槐樹	槐树	huáishù
壞事	坏事	huàishì
歡呼	欢呼	huānhū
歡聚	欢聚	huānjù
歡快	欢快	huānkuài
歡聲笑語	欢声笑语	huānshēng-xiàoyǔ
還款	还款	huán kuǎn
還原	还原	huán yuán
環球	环球	huánqiú
環繞	环绕	huánrào
緩	缓	huǎn
緩和	缓和	huǎnhé
緩緩	缓缓	huǎnhuǎn
幻覺	幻觉	huànjué
幻影	幻影	huànyǐng
換成	换成	huànchéng
緩慢	缓慢	huǎnmàn
換位	换位	huàn wèi
換言之	换言之	huànyánzhī
換取	换取	huànqǔ
患	患	huàn
喚起	唤起	huànqǐ
患病	患病	huàn bìng
患有	患有	huànyǒu
煥發	焕发	huànfā
荒誕	荒诞	huāngdàn
荒	荒	huāng
荒涼	荒凉	huāngliáng
慌亂	慌乱	huāngluàn
荒謬	荒谬	huāngmiù
慌張	慌张	huāngzhang
皇宮	皇宫	huánggōng
皇室	皇室	huángshì
皇上	皇上	huángshang
皇后	皇后	huánghòu
恍然大悟	恍然大悟	huǎngrán-dàwù
晃	晃	huǎng
黃昏	黄昏	huánghūn
謊言	谎言	huǎngyán
謊話	谎话	huǎnghuà
灰	灰	huī
灰塵	灰尘	huīchén
晃蕩	晃荡	huàngdang
揮	挥	huī
灰心	灰心	huī xīn
輝煌	辉煌	huīhuáng
回扣	回扣	huíkòu
回饋	回馈	huíkuì
回落	回落	huíluò
迴首	回首	huíshǒu
回升	回升	huíshēng
回味	回味	huíwèi
回歸	回归	huíguī
回想	回想	huíxiǎng
回憶錄	回忆录	huíyìlù
悔恨	悔恨	huǐhèn
毀壞	毁坏	huǐhuài
匯合	汇合	huìhé
彙集	汇集	huìjí
毀滅	毁灭	huǐmiè
會場	会场	huìchǎng
會面	会面	huì miàn
會聚	汇聚	huìjù
會晤	会晤	huìwù
會意	会意	huìyì
會診	会诊	huì zhěn
繪聲繪色	绘声绘色	huìshēng-huìsè
賄賂	贿赂	huìlù
婚紗	婚纱	hūnshā
婚姻	婚姻	hūnyīn
渾身	浑身	húnshēn
魂	魂	hún
昏迷	昏迷	hūnmí
混凝土	混凝土	hùnníngtǔ
混淆	混淆	hùnxiáo
混濁	混浊	hùnzhuó
豁	豁	huō
豁出去	豁出去	huō chuqu
活該	活该	huógāi
活期	活期	huóqī
活兒	活儿	huór5
火暴	火暴	huǒbào
火鍋	火锅	huǒguō
火候	火候	huǒhou
火花	火花	huǒhuā
火炬	火炬	huǒjù
火辣辣	火辣辣	huǒlàlà
火熱	火热	huǒrè
火山	火山	huǒshān
火速	火速	huǒsù
火焰	火焰	huǒyàn
火藥	火药	huǒyào
伙食	伙食	huǒshi
或多或少	或多或少	huòduōhuòshǎo
貨幣	货币	huòbì
貨車	货车	huòchē
貨物	货物	huòwù
貨運	货运	huòyùn
獲勝	获胜	huò shèng
獲悉	获悉	huòxī
禍害	祸害	huòhai
霍亂	霍乱	huòluàn
豁達	豁达	huòdá
譏笑	讥笑	jīxiào
飢餓	饥饿	jīè
幾率	几率	jīlǜ
機艙	机舱	jīcāng
機動	机动	jīdòng
機密	机密	jīmì
機靈	机灵	jīling
機智	机智	jīzhì
肌膚	肌肤	jīfū
積	积	jī
積澱	积淀	jīdiàn
積蓄	积蓄	jīxù
基本功	基本功	jīběngōng
基層	基层	jīcéng
基因	基因	jīyīn
基準	基准	jīzhǔn
基於	基于	jīyú
畸形	畸形	jīxíng
激發	激发	jīfā
激光	激光	jīguāng
激化	激化	jīhuà
激活	激活	jīhuó
激勵	激励	jīlì
激起	激起	jī qǐ
及	及	jí
及其	及其	jíqí
激素	激素	jīsù
及早	及早	jízǎo
吉普	吉普	jípǔ
吉他	吉他	jítā
吉祥物	吉祥物	jíxiángwù
級別	级别	jíbié
極度	极度	jídù
極力	极力	jílì
極少數	极少数	jíshǎoshù
極為	极为	jíwéi
極限	极限	jíxiàn
即	即	jí
即便	即便	jíbiàn
即可	即可	jíkě
急劇	急剧	jíjù
急迫	急迫	jípò
急性	急性	jíxìng
急於	急于	jíyú
急診	急诊	jízhěn
急轉彎	急转弯	jízhuǎnwān
急需	急需	jíxū
棘手	棘手	jíshǒu
集結	集结	jíjié
集郵	集邮	jí yóu
集裝箱	集装箱	jízhuāngxiāng
集會	集会	jíhuì
嫉妒	嫉妒	jídù
脊梁	脊梁	jǐliang
集資	集资	jízī
計	计	jì
擠壓	挤压	jǐyā
計較	计较	jìjiào
記號	记号	jìhao
計時	计时	jìshí
記憶猶新	记忆犹新	jìyì-yóuxīn
紀錄片	纪录片	jìlùpiàn
紀念碑	纪念碑	jìniànbēi
紀念館	纪念馆	jìniànguǎn
紀念日	纪念日	jìniànrì
紀實	纪实	jìshí
計策	计策	jìcè
技藝	技艺	jìyì
忌	忌	jì
忌諱	忌讳	jìhui
忌口	忌口	jì kǒu
劑	剂	jì
跡象	迹象	jìxiàng
繼	继	jì
繼而	继而	jìér
繼父	继父	jìfù
繼母	继母	jìmǔ
祭	祭	jì
祭奠	祭奠	jìdiàn
祭祀	祭祀	jìsi
寄託	寄托	jìtuō
寂靜	寂静	jìjìng
寂寞	寂寞	jìmò
加緊	加紧	jiājǐn
加劇	加剧	jiājù
加深	加深	jiāshēn
加重	加重	jiāzhòng
佳節	佳节	jiājié
家伙	家伙	jiāhuo
家家戶戶	家家户户	jiājiā-hùhù
家教	家教	jiājiào
家境	家境	jiājìng
家用	家用	jiāyòng
家禽	家禽	jiāqín
家喻戶曉	家喻户晓	jiāyù-hùxiǎo
家政	家政	jiāzhèng
家族	家族	jiāzú
嘉年華	嘉年华	jiāniánhuá
假冒	假冒	jiǎmào
假設	假设	jiǎshè
假定	假定	jiǎdìng
價位	价位	jiàwèi
假裝	假装	jiǎzhuāng
價值觀	价值观	jiàzhíguān
假使	假使	jiǎshǐ
駕車	驾车	jiàchē
駕馭	驾驭	jiàyù
駕	驾	jià
架勢	架势	jiàshi
嫁	嫁	jià
架子	架子	jiàzi
嫁妝	嫁妆	jiàzhuang
尖端	尖端	jiānduān
尖銳	尖锐	jiānruì
奸詐	奸诈	jiānzhà
堅持不懈	坚持不懈	jiānchí-bùxiè
堅韌	坚韧	jiānrèn
殲滅	歼灭	jiānmiè
堅實	坚实	jiānshí
堅守	坚守	jiānshǒu
堅信	坚信	jiānxìn
堅硬	坚硬	jiānyìng
肩膀	肩膀	jiānbǎng
肩負	肩负	jiānfù
艱巨	艰巨	jiānjù
艱苦奮鬥	艰苦奋斗	jiānkǔ-fèndòu
艱險	艰险	jiānxiǎn
艱辛	艰辛	jiānxīn
監察	监察	jiānchá
監管	监管	jiānguǎn
監護	监护	jiānhù
監控	监控	jiānkòng
監視	监视	jiānshì
監獄	监狱	jiānyù
兼	兼	jiān
兼顧	兼顾	jiāngù
兼任	兼任	jiānrèn
兼容	兼容	jiānróng
兼職	兼职	jiānzhí
煎	煎	jiān
揀	拣	jiǎn
檢察	检察	jiǎnchá
檢討	检讨	jiǎntǎo
減免	减免	jiǎnmiǎn
減弱	减弱	jiǎnruò
減速	减速	jiǎn sù
減壓	减压	jiǎn yā
簡稱	简称	jiǎnchēng
簡短	简短	jiǎnduǎn
簡化	简化	jiǎnhuà
簡潔	简洁	jiǎnjié
簡陋	简陋	jiǎnlòu
簡體字	简体字	jiǎntǐzì
簡要	简要	jiǎnyào
簡易	简易	jiǎnyì
見錢眼開	见钱眼开	jiànqián-yǎnkāi
見解	见解	jiànjiě
見仁見智	见仁见智	jiànrén-jiànzhì
見識	见识	jiànshi
見外	见外	jiànwài
見效	见效	jiàn xiào
見義勇為	见义勇为	jiànyì-yǒngwéi
見證	见证	jiànzhèng
間諜	间谍	jiàndié
間斷	间断	jiànduàn
間隔	间隔	jiàngé
間隙	间隙	jiànxì
建交	建交	jiàn jiāo
建樹	建树	jiànshù
建築師	建筑师	jiànzhùshī
建築物	建筑物	jiànzhùwù
健美	健美	jiànměi
賤	贱	jiàn
健壯	健壮	jiànzhuàng
濺	溅	jiàn
鑒別	鉴别	jiànbié
鑒賞	鉴赏	jiànshǎng
姜	姜	jiāng
鑒於	鉴于	jiànyú
僵	僵	jiāng
僵化	僵化	jiānghuà
僵局	僵局	jiāngjú
講解	讲解	jiǎngjiě
講述	讲述	jiǎngshù
講學	讲学	jiǎng xué
獎杯	奖杯	jiǎngbēi
獎牌	奖牌	jiǎngpái
獎品	奖品	jiǎngpǐn
獎項	奖项	jiǎngxiàng
降臨	降临	jiànglín
交叉	交叉	jiāochā
交鋒	交锋	jiāo fēng
交付	交付	jiāofù
交集	交集	jiāojí
交接	交接	jiāojiē
交界	交界	jiāojiè
交情	交情	jiāoqing
交納	交纳	jiāonà
交涉	交涉	jiāoshè
交談	交谈	jiāotán
交替	交替	jiāotì
交頭接耳	交头接耳	jiāotóu-jiēěr
交響樂	交响乐	jiāoxiǎngyuè
郊遊	郊游	jiāoyóu
郊外	郊外	jiāowài
澆	浇	jiāo
嬌慣	娇惯	jiāoguàn
嬌氣	娇气	jiāoqi
膠囊	胶囊	jiāonáng
膠片	胶片	jiāopiàn
焦	焦	jiāo
焦距	焦距	jiāojù
焦急	焦急	jiāojí
焦慮	焦虑	jiāolǜ
焦躁	焦躁	jiāozào
嚼	嚼	jué
礁石	礁石	jiāoshí
絞	绞	jiǎo
狡猾	狡猾	jiǎohuá
角落	角落	jiǎoluò
矯正	矫正	jiǎozhèng
攪拌	搅拌	jiǎobàn
攪	搅	jiǎo
繳	缴	jiǎo
繳費	缴费	jiǎofèi
繳納	缴纳	jiǎonà
叫板	叫板	jiàobǎn
叫好	叫好	jiào hǎo
轎車	轿车	jiàochē
較勁	较劲	jiào jìn
較量	较量	jiàoliàng
教條	教条	jiàotiáo
教科書	教科书	jiàokēshū
教養	教养	jiàoyǎng
階層	阶层	jiēcéng
階級	阶级	jiējí
皆	皆	jiē
階梯	阶梯	jiētī
結	结	jié
結果	结果	jiē guǒ
接班人	接班人	jiēbān rén
接班	接班	jiē bān
接軌	接轨	jiē guǐ
接二連三	接二连三	jiēèr-liánsān
接濟	接济	jiējì
接見	接见	jiējiàn
接力	接力	jiēlì
接納	接纳	jiēnà
接手	接手	jiēshǒu
接送	接送	jiēsòng
接聽	接听	jiētīng
接通	接通	jiē tōng
揭發	揭发	jiēfā
接替	接替	jiētì
揭露	揭露	jiēlù
揭曉	揭晓	jiēxiǎo
揭示	揭示	jiēshì
節儉	节俭	jiéjiǎn
節水	节水	jié shuǐ
節衣縮食	节衣缩食	jiéyī-suōshí
節氣	节气	jiéqi
劫	劫	jié
劫持	劫持	jiéchí
潔淨	洁净	jiéjìng
結冰	结冰	jié bīng
結晶	结晶	jiéjīng
結局	结局	jiéjú
結識	结识	jiéshí
結尾	结尾	jiéwěi
截	截	jié
截然不同	截然不同	jiérán-bùtóng
竭盡全力	竭尽全力	jiéjìn-quánlì
竭力	竭力	jiélì
解答	解答	jiědá
解讀	解读	jiědú
解救	解救	jiějiù
解剖	解剖	jiěpōu
解雇	解雇	jiěgù
解散	解散	jiěsàn
解脫	解脱	jiětuō
解體	解体	jiě tǐ
解圍	解围	jiě wéi
解析	解析	jiěxī
介入	介入	jièrù
介意	介意	jiè yì
戒備	戒备	jièbèi
戒煙	戒烟	jiè yān
介於	介于	jièyú
界定	界定	jièdìng
戒指	戒指	jièzhi
屆時	届时	jièshí
界線	界线	jièxiàn
藉口	借口	jièkǒu
界限	界限	jièxiàn
借條	借条	jiètiáo
借助	借助	jièzhù
借用	借用	jièyòng
金字塔	金字塔	jīnzìtǎ
金屬	金属	jīnshǔ
金子	金子	jīnzi
津貼	津贴	jīntiē
津津有味	津津有味	jīnjīn-yǒuwèi
筋	筋	jīn
禁不住	禁不住	jīnbuzhù
僅次於	仅次于	jǐn cìyú
儘	尽	jǐn
盡早	尽早	jǐnzǎo
緊迫	紧迫	jǐnpò
緊接著	紧接着	jǐnjiēzhe
緊湊	紧凑	jǐncòu
緊缺	紧缺	jǐnquē
緊縮	紧缩	jǐnsuō
錦旗	锦旗	jǐnqí
盡情	尽情	jìnqíng
盡頭	尽头	jìntóu
謹慎	谨慎	jǐnshèn
進程	进程	jìnchéng
進場	进场	jìn chǎng
進出	进出	jìnchū
進度	进度	jìndù
進出口	进出口	jìnchūkǒu
進而	进而	jìnér
進修	进修	jìnxiū
近年來	近年来	jìnniánlái
勁頭	劲头	jìntóu
晉升	晋升	jìnshēng
浸泡	浸泡	jìnpào
禁忌	禁忌	jìnjì
禁區	禁区	jìnqū
莖	茎	jīng
經	经	jīng
經度	经度	jīngdù
經久不息	经久不息	jīngjiǔ-bùxī
經貿	经贸	jīngmào
經商	经商	jīng shāng
經受	经受	jīngshòu
荊棘	荆棘	jīngjí
驚	惊	jīng
驚詫	惊诧	jīngchà
驚慌	惊慌	jīnghuāng
驚慌失措	惊慌失措	jīnghuāng-shīcuò
驚奇	惊奇	jīngqí
驚嘆	惊叹	jīngtàn
驚天動地	惊天动地	jīngtiān-dòngdì
驚險	惊险	jīngxiǎn
驚心動魄	惊心动魄	jīngxīn-dòngpò
驚醒	惊醒	jīngxing
驚訝	惊讶	jīngyà
晶瑩	晶莹	jīngyíng
兢兢業業	兢兢业业	jīngjīng-yèyè
精打細算	精打细算	jīngdǎ-xìsuàn
精華	精华	jīnghuá
精簡	精简	jīngjiǎn
精練	精练	jīngliàn
精妙	精妙	jīngmiào
精明	精明	jīngmíng
精疲力竭	精疲力竭	jīngpí-lìjié
精確	精确	jīngquè
精神病	精神病	jīngshénbìng
精髓	精髓	jīngsuǐ
精細	精细	jīngxì
精通	精通	jīngtōng
精心	精心	jīngxīn
精益求精	精益求精	jīngyìqiújīng
精英	精英	jīngyīng
精緻	精致	jīngzhì
景觀	景观	jǐngguān
頸部	颈部	jǐngbù
景區	景区	jǐngqū
警車	警车	jǐngchē
警官	警官	jǐngguān
警惕	警惕	jǐngtì
警鐘	警钟	jǐngzhōng
淨化	净化	jìnghuà
競技	竞技	jìngjì
競選	竞选	jìngxuǎn
競相	竞相	jìngxiāng
竟敢	竟敢	jìng gǎn
竟	竟	jìng
敬	敬	jìng
敬愛	敬爱	jìngài
敬而遠之	敬而远之	jìngéryuǎnzhī
敬酒	敬酒	jìng jiǔ
敬禮	敬礼	jìng lǐ
敬佩	敬佩	jìngpèi
敬請	敬请	jìngqǐng
敬業	敬业	jìngyè
敬意	敬意	jìngyì
敬重	敬重	jìngzhòng
靜止	静止	jìngzhǐ
境地	境地	jìngdì
境界	境界	jìngjiè
境內	境内	jìngnèi
境外	境外	jìngwài
境遇	境遇	jìngyù
窘迫	窘迫	jiǒngpò
糾纏	纠缠	jiūchán
揪	揪	jiū
久違	久违	jiǔwéi
久仰	久仰	jiǔyǎng
酒精	酒精	jiǔjīng
酒樓	酒楼	jiǔlóu
救護車	救护车	jiùhùchē
救濟	救济	jiùjì
救治	救治	jiùzhì
就餐	就餐	jiù cān
就地	就地	jiùdì
就讀	就读	jiùdú
就近	就近	jiùjìn
就任	就任	jiùrèn
就醫	就医	jiù yī
就診	就诊	jiù zhěn
就職	就职	jiù zhí
就座	就座	jiù zuò
舅舅	舅舅	jiùjiu
拘留	拘留	jūliú
拘束	拘束	jūshù
居高臨下	居高临下	jūgāo-línxià
居民樓	居民楼	jūmínlóu
鞠躬	鞠躬	jūgōng
局部	局部	júbù
局勢	局势	júshì
局限	局限	júxiàn
菊花	菊花	júhuā
橘子	橘子	júzi
沮喪	沮丧	jǔsàng
舉報	举报	jǔbào
舉措	举措	jǔcuò
舉例	举例	jǔ lì
舉世聞名	举世闻名	jǔshì-wénmíng
舉世無雙	举世无双	jǔshì-wúshuāng
舉世矚目	举世瞩目	jǔshì-zhǔmù
舉一反三	举一反三	jǔyī-fǎnsān
舉止	举止	jǔzhǐ
舉重	举重	jǔzhòng
巨額	巨额	jùé
巨人	巨人	jùrén
巨頭	巨头	jùtóu
巨星	巨星	jùxīng
巨型	巨型	jùxíng
劇烈	剧烈	jùliè
劇目	剧目	jùmù
劇情	剧情	jùqíng
劇團	剧团	jùtuán
劇院	剧院	jùyuàn
據此	据此	jùcǐ
劇組	剧组	jùzǔ
據悉	据悉	jùxī
距	距	jù
鋸	锯	jù
聚集	聚集	jùjí
聚精會神	聚精会神	jùjīng-huìshén
捐獻	捐献	juānxiàn
捲入	卷入	juǎnrù
卷子	卷子	juǎnzi
圈	圈	quān
決議	决议	juéyì
訣別	诀别	juébié
訣竅	诀窍	juéqiào
角逐	角逐	juézhú
覺醒	觉醒	juéxǐng
絕技	绝技	juéjì
絕緣	绝缘	juéyuán
絕招	绝招	juézhāo
崛起	崛起	juéqǐ
倔強	倔强	juéjiàng
倔	倔	jué
爵士	爵士	juéshì
軍官	军官	jūnguān
均衡	均衡	jūnhéng
均勻	均匀	jūnyún
君子	君子	jūnzǐ
俊	俊	jùn
俊俏	俊俏	jùnqiào
駿馬	骏马	jùnmǎ
竣工	竣工	jùn gōng
卡車	卡车	kǎchē
卡片	卡片	kǎpiàn
卡通	卡通	kǎtōng
開辦	开办	kāibàn
開采	开采	kāicǎi
開場	开场	kāi chǎng
開場白	开场白	kāichǎngbái
開動	开动	kāi dòng
開除	开除	kāichú
開發區	开发区	kāifāqū
開發商	开发商	kāifāshāng
開工	开工	kāi gōng
開墾	开垦	kāikěn
開口	开口	kāi kǒu
開闊	开阔	kāikuò
開朗	开朗	kāilǎng
開辟	开辟	kāipì
開啟	开启	kāiqǐ
開槍	开枪	kāi qiāng
開天辟地	开天辟地	kāitiān-pìdì
開拓	开拓	kāituò
開銷	开销	kāixiao
開張	开张	kāi zhāng
開支	开支	kāizhī
凱歌	凯歌	kǎigē
楷模	楷模	kǎimó
刊登	刊登	kāndēng
刊物	刊物	kānwù
勘探	勘探	kāntàn
看護	看护	kānhù
堪稱	堪称	kānchēng
砍	砍	kǎn
侃大山	侃大山	kǎn dàshān
看得出	看得出	kàndechū
看似	看似	kànsì
看熱鬧	看热闹	kàn rènao
看臺	看台	kàntái
看樣子	看样子	kàn yàngzi
看中	看中	kàn zhòng
慷慨	慷慨	kāngkǎi
看重	看重	kàn zhòng
扛	扛	káng
抗衡	抗衡	kànghéng
抗拒	抗拒	kàngjù
抗爭	抗争	kàngzhēng
抗生素	抗生素	kàngshēngsù
考量	考量	kǎoliang
烤	烤	kǎo
靠攏	靠拢	kàolǒng
苛刻	苛刻	kēkè
科幻	科幻	kēhuàn
科目	科目	kēmù
科普	科普	kēpǔ
磕	磕	kē
殼	壳	ké
咳嗽	咳嗽	késou
可悲	可悲	kěbēi
可不是	可不是	kěbushì
可乘之機	可乘之机	kěchéngzhījī
可恥	可耻	kěchǐ
可歌可泣	可歌可泣	kěgē-kěqì
可觀	可观	kěguān
可貴	可贵	kěguì
可口	可口	kěkǒu
可謂	可谓	kěwèi
可惡	可恶	kěwù
可想而知	可想而知	kěxiǎngérzhī
可笑	可笑	kěxiào
可信	可信	kěxìn
可行	可行	kěxíng
可疑	可疑	kěyí
克隆	克隆	kèlóng
克制	克制	kèzhì
刻意	刻意	kèyì
刻苦	刻苦	kèkǔ
客房	客房	kèfáng
刻舟求劍	刻舟求剑	kèzhōu-qiújiàn
客機	客机	kèjī
客流	客流	kèliú
客運	客运	kèyùn
懇求	恳求	kěnqiú
啃	啃	kěn
坑	坑	kēng
空難	空难	kōngnàn
空蕩蕩	空荡荡	kōngdàngdàng
空前	空前	kōngqián
空想	空想	kōngxiǎng
空虛	空虚	kōngxū
恐怖	恐怖	kǒngbù
恐嚇	恐吓	kǒnghè
恐慌	恐慌	kǒnghuāng
恐懼	恐惧	kǒngjù
恐龍	恐龙	kǒnglóng
空白	空白	kòngbái
空地	空地	kōng-dì
空隙	空隙	kòngxì
控告	控告	kònggào
摳	抠	kōu
口碑	口碑	kǒubēi
口才	口才	kǒucái
口吃	口吃	kǒuchī
口感	口感	kǒugǎn
口徑	口径	kǒujìng
口令	口令	kǒulìng
口腔	口腔	kǒuqiāng
口氣	口气	kǒuqi
口哨	口哨	kǒushào
口水	口水	kǒushuǐ
口頭	口头	kǒutou
口味	口味	kǒuwèi
口香糖	口香糖	kǒuxiāngtáng
口音	口音	kǒuyīn
口罩	口罩	kǒuzhào
口子	口子	kǒuzi
扣除	扣除	kòuchú
扣人心弦	扣人心弦	kòurénxīnxián
扣留	扣留	kòuliú
扣押	扣押	kòuyā
枯燥	枯燥	kūzào
哭泣	哭泣	kūqì
哭笑不得	哭笑不得	kūxiào-bùdé
窟窿	窟窿	kūlong
苦力	苦力	kǔlì
苦練	苦练	kǔliàn
苦難	苦难	kǔnàn
苦笑	苦笑	kǔxiào
苦惱	苦恼	kǔnǎo
苦心	苦心	kǔxīn
酷似	酷似	kùsì
誇	夸	kuā
誇大	夸大	kuādà
誇獎	夸奖	kuājiǎng
誇誇其談	夸夸其谈	kuākuā-qítán
誇耀	夸耀	kuāyào
誇張	夸张	kuāzhāng
垮	垮	kuǎ
挎	挎	kuà
跨國	跨国	kuàguó
跨越	跨越	kuàyuè
快捷	快捷	kuàijié
寬敞	宽敞	kuānchang
寬泛	宽泛	kuānfàn
寬厚	宽厚	kuānhòu
寬容	宽容	kuānróng
寬鬆	宽松	kuānsong
款式	款式	kuǎnshì
寬恕	宽恕	kuānshù
款項	款项	kuǎnxiàng
筐	筐	kuāng
狂歡	狂欢	kuánghuān
狂歡節	狂欢节	Kuánghuānjié
狂熱	狂热	kuángrè
曠課	旷课	kuàng kè
況且	况且	kuàngqiě
礦藏	矿藏	kuàngcáng
框	框	kuàng
框架	框架	kuàngjià
虧本	亏本	kuī běn
虧損	亏损	kuīsǔn
昆蟲	昆虫	kūnchóng
捆	捆	kǔn
困惑	困惑	kùnhuò
困境	困境	kùnjìng
擴	扩	kuò
擴建	扩建	kuòjiàn
擴散	扩散	kuòsàn
擴張	扩张	kuòzhāng
括弧	括弧	kuòhú
闊綽	阔绰	kuòchuò
拉動	拉动	lā dòng
拉攏	拉拢	lālong
拉鎖	拉锁	lāsuǒ
啦啦隊	啦啦队	lālāduì
喇叭	喇叭	lǎba
臘月	腊月	làyuè
蠟	蜡	là
蠟燭	蜡烛	làzhú
辣椒	辣椒	làjiāo
來賓	来宾	láibīn
來電	来电	láidiàn
來訪	来访	láifǎng
來回	来回	láihuí
來歷	来历	láilì
來臨	来临	láilín
來龍去脈	来龙去脉	láilóng-qùmài
來年	来年	láinián
來源於	来源于	láiyuányú
攔	拦	lán
欄	栏	lán
欄杆	栏杆	lángān
藍圖	蓝图	lántú
攬	揽	lǎn
纜車	缆车	lǎnchē
懶得	懒得	lǎnde
懶惰	懒惰	lǎnduò
濫用	滥用	lànyòng
狼	狼	láng
狼狽	狼狈	lángbèi
朗誦	朗诵	lǎngsòng
浪	浪	làng
撈	捞	lāo
勞動力	劳动力	láodònglì
勞累	劳累	láolèi
勞務	劳务	láowù
牢固	牢固	láogù
牢牢	牢牢	láoláo
嘮叨	唠叨	láodao
牢記	牢记	láojì
老伴兒	老伴儿	lǎobànr5
老大	老大	lǎodà
老漢	老汉	lǎohàn
老化	老化	lǎohuà
老人家	老人家	lǎorenjia
老實說	老实说	lǎoshíshuō
老遠	老远	lǎoyuǎn
老字號	老字号	lǎozìhao
姥姥	姥姥	lǎolao
姥爺	姥爷	lǎoye
澇	涝	lào
樂意	乐意	lèyì
樂園	乐园	lèyuán
勒	勒	lēi
雷同	雷同	léitóng
累積	累积	lěijī
累計	累计	lěijì
類別	类别	lèibié
棱角	棱角	léngjiǎo
冷淡	冷淡	lěngdàn
冷凍	冷冻	lěngdòng
冷酷	冷酷	lěngkù
冷酷無情	冷酷无情	lěngkù-wúqíng
冷落	冷落	lěngluò
冷門	冷门	lěngmén
冷漠	冷漠	lěngmò
冷戰	冷战	lěngzhan
冷笑	冷笑	lěngxiào
離譜兒	离谱儿	lí pǔr5
愣	愣	lèng
離奇	离奇	líqí
離職	离职	lízhí
黎明	黎明	límíng
禮服	礼服	lǐfú
禮品	礼品	lǐpǐn
禮儀	礼仪	lǐyí
里程碑	里程碑	lǐchéngbēi
理睬	理睬	lǐcǎi
理會	理会	lǐhuì
理科	理科	lǐkē
理念	理念	lǐniàn
理事	理事	lǐshì
理所當然	理所当然	lǐsuǒdāngrán
理性	理性	lǐxìng
理直氣壯	理直气壮	lǐzhí-qìzhuàng
力不從心	力不从心	lìbùcóngxīn
力求	力求	lìqiú
力度	力度	lìdù
力所能及	力所能及	lìsuǒnéngjí
力爭	力争	lìzhēng
歷屆	历届	lìjiè
歷程	历程	lìchéng
歷經	历经	lìjīng
歷來	历来	lìlái
立方米	立方米	lìfāngmǐ
立方	立方	lìfāng
立功	立功	lì gōng
歷時	历时	lìshí
立交橋	立交桥	lìjiāoqiáo
立足	立足	lì zú
立體	立体	lìtǐ
利率	利率	lìlǜ
勵志	励志	lìzhì
粒	粒	lì
利害	利害	lìhai
連綿	连绵	liánmián
連滾帶爬	连滚带爬	liángǔndàipá
利索	利索	lìsuo
連鎖	连锁	liánsuǒ
連任	连任	lián rèn
連鎖店	连锁店	liánsuǒdiàn
憐惜	怜惜	liánxī
簾子	帘子	liánzi
連夜	连夜	liányè
蓮子	莲子	liánzǐ
聯邦	联邦	liánbāng
聯歡	联欢	liánhuān
聯網	联网	lián wǎng
廉價	廉价	liánjià
廉正	廉正	liánzhèng
廉潔	廉洁	liánjié
廉政	廉政	liánzhèng
煉	炼	liàn
臉頰	脸颊	liǎnjiá
戀戀不捨	恋恋不舍	liànliàn-bùshě
良	良	liáng
良心	良心	liángxīn
良性	良性	liángxìng
涼爽	凉爽	liángshuǎng
兩口子	两口子	liǎngkǒuzi
兩棲	两栖	liǎngqī
亮點	亮点	liàngdiǎn
亮麗	亮丽	liànglì
亮相	亮相	liàng xiàng
遼闊	辽阔	liáokuò
諒解	谅解	liàngjiě
療法	疗法	liáofǎ
療效	疗效	liáoxiào
潦草	潦草	liáocǎo
寥寥無幾	寥寥无几	liáoliáo-wújǐ
了卻	了却	liǎoquè
料到	料到	liào dào
了結	了结	liǎojié
咧嘴	咧嘴	liě zuǐ
料理	料理	liàolǐ
列舉	列举	lièjǔ
劣勢	劣势	lièshì
劣質	劣质	lièzhì
獵犬	猎犬	lièquǎn
獵人	猎人	lièrén
烈士	烈士	lièshì
裂縫	裂缝	lièfèng
裂痕	裂痕	lièhén
鄰國	邻国	línguó
臨	临	lín
臨街	临街	línjiē
臨近	临近	línjìn
臨床	临床	línchuáng
靈	灵	líng
拎	拎	līn
淋	淋	lín
靈感	灵感	línggǎn
靈魂	灵魂	línghún
靈機一動	灵机一动	língjī yī dòng
靈敏	灵敏	língmǐn
靈巧	灵巧	língqiǎo
凌晨	凌晨	língchén
零花錢	零花钱	línghuāqián
零件	零件	língjiàn
零錢	零钱	língqián
零售	零售	língshòu
靈通	灵通	língtōng
領會	领会	lǐnghuì
領軍	领军	lǐng jūn
領略	领略	lǐnglüè
領事	领事	lǐngshì
領事館	领事馆	lǐngshìguǎn
領隊	领队	lǐngduì
領土	领土	lǐngtǔ
領悟	领悟	lǐngwù
領養	领养	lǐngyǎng
溜達	溜达	liūda
領域	领域	lǐngyù
瀏覽器	浏览器	liúlǎnqì
留戀	留恋	liúliàn
溜	溜	liū
瀏覽	浏览	liúlǎn
留念	留念	liúniàn
留心	留心	liú xīn
留神	留神	liú shén
留意	留意	liú yì
流暢	流畅	liúchàng
流程	流程	liúchéng
流浪	流浪	liúlàng
流淚	流泪	liú lèi
流量	流量	liúliàng
流露	流露	liúlù
流氓	流氓	liúmáng
流入	流入	liúrù
流失	流失	liúshī
流水	流水	liúshuǐ
流向	流向	liúxiàng
流淌	流淌	liútǎng
流血	流血	liúxuè
流轉	流转	liúzhuǎn
柳樹	柳树	liǔshù
遛	遛	liù
流域	流域	liúyù
龍舟	龙舟	lóngzhōu
聾人	聋人	lóngrén
籠子	笼子	lóngzi
聾	聋	lóng
隆重	隆重	lóngzhòng
壟斷	垄断	lǒngduàn
籠罩	笼罩	lǒngzhào
籠統	笼统	lǒngtǒng
摟	搂	lǒu
露面	露面	lòu miàn
蘆花	芦花	lúhuā
爐灶	炉灶	lúzào
鹵味	卤味	lǔwèi
魯莽	鲁莽	lǔmǎng
爐子	炉子	lúzi
錄製	录制	lùzhì
路程	路程	lùchéng
鹿	鹿	lù
路段	路段	lùduàn
路況	路况	lùkuàng
路面	路面	lùmiàn
路人	路人	lùrén
路燈	路灯	lùdēng
路途	路途	lùtú
露天	露天	lùtiān
旅程	旅程	lǚchéng
旅途	旅途	lǚtú
路子	路子	lùzi
鋁	铝	lǚ
屢次	屡次	lǚcì
縷	缕	lǚ
屢	屡	lǚ
履行	履行	lǚxíng
率	率	lǜ
綠燈	绿灯	lǜdēng
孿生	孪生	luánshēng
綠地	绿地	lǜdì
卵	卵	luǎn
掠奪	掠夺	lüèduó
亂七八糟	乱七八糟	luànqībāzāo
略微	略微	lüèwēi
掄	抡	lūn
略	略	lüè
倫理	伦理	lúnlǐ
輪換	轮换	lúnhuàn
輪流	轮流	lúnliú
輪胎	轮胎	lúntāi
輪廓	轮廓	lúnkuò
論壇	论坛	lùntán
論證	论证	lùnzhèng
羅	罗	luó
論述	论述	lùnshù
蘿卜	萝卜	luóbo
螺絲	螺丝	luósī
絡繹不絕	络绎不绝	luòyì-bùjué
裸露	裸露	luǒlù
落差	落差	luòchā
落地	落地	luò dì
裸	裸	luǒ
落戶	落户	luò hù
落下	落下	luòxià
麻	麻	má
麻痹	麻痹	mábì
麻木	麻木	mámù
麻將	麻将	májiàng
馬後炮	马后炮	mǎhòupào
麻醉	麻醉	mázuì
馬力	马力	mǎlì
麻辣	麻辣	málà
馬桶	马桶	mǎtǒng
馬戲	马戏	mǎxì
馬虎	马虎	mǎhu
埋藏	埋藏	máicáng
碼	码	mǎ
埋伏	埋伏	máifu
埋沒	埋没	máimò
邁	迈	mài
買不起	买不起	mǎibuqǐ
邁進	迈进	màijìn
脈搏	脉搏	màibó
賣弄	卖弄	màinong
脈絡	脉络	màiluò
埋怨	埋怨	mányuàn
瞞	瞒	mán
蠻	蛮	mán
滿懷	满怀	mǎnhuái
漫	漫	màn
蔓延	蔓延	mànyán
漫遊	漫游	mànyóu
忙碌	忙碌	mánglù
慢慢來	慢慢来	mànmànlái
忙亂	忙乱	mángluàn
慢性	慢性	mànxìng
忙活	忙活	mánghuo
盲目	盲目	mángmù
茫然	茫然	mángrán
茅臺	茅台	Máotái
茂密	茂密	màomì
矛頭	矛头	máotóu
茂盛	茂盛	màoshèng
冒犯	冒犯	màofàn
冒充	冒充	màochōng
冒昧	冒昧	màomèi
冒險	冒险	mào xiǎn
沒說的	没说的	méishuōde
沒勁	没劲	méi jìn
沒轍	没辙	méizhé
沒完沒了	没完没了	méiwán-méiliǎo
玫瑰	玫瑰	méigui
沒意思	没意思	méi yìsi
沒準兒	没准儿	méizhǔnr5
眉開眼笑	眉开眼笑	méikāi-yǎnxiào
枚	枚	méi
眉毛	眉毛	méimao
煤礦	煤矿	méikuàng
每當	每当	měidāng
每逢	每逢	měiféng
煤炭	煤炭	méitàn
美觀	美观	měiguān
美德	美德	měidé
美化	美化	měihuà
美景	美景	měijǐng
美滿	美满	měimǎn
美人	美人	měirén
美妙	美妙	měimiào
美中不足	美中不足	měizhōng-bùzú
美味	美味	měiwèi
美滋滋	美滋滋	měizīzī
魅力	魅力	mèilì
門當戶對	门当户对	méndāng-hùduì
門檻	门槛	ménkǎn
門鈴	门铃	ménlíng
悶	闷	mèn
門路	门路	ménlu
萌發	萌发	méngfā
盟友	盟友	méngyǒu
萌芽	萌芽	méngyá
朦朧	朦胧	ménglóng
猛然	猛然	měngrán
夢幻	梦幻	mènghuàn
猛烈	猛烈	měngliè
彌漫	弥漫	mímàn
迷惑	迷惑	míhuo
迷惑不解	迷惑不解	míhuòbùjiě
彌補	弥补	míbǔ
迷戀	迷恋	míliàn
迷路	迷路	mí lù
迷失	迷失	míshī
謎	谜	mèi
謎底	谜底	mídǐ
謎團	谜团	mítuán
祕方	秘方	mìfāng
謎語	谜语	míyǔ
祕訣	秘诀	mìjué
密封	密封	mìfēng
密不可分	密不可分	mìbùkěfēn
密度	密度	mìdù
蜜蜂	蜜蜂	mìfēng
蜜	蜜	mì
密集	密集	mìjí
蜜月	蜜月	mìyuè
棉花	棉花	miánhua
免	免	miǎn
免不了	免不了	miǎnbuliǎo
免除	免除	miǎnchú
免疫	免疫	miǎnyì
免職	免职	miǎn zhí
勉強	勉强	miǎnqiǎng
緬懷	缅怀	miǎnhuái
麵粉	面粉	miànfěn
面部	面部	miànbù
面紅耳赤	面红耳赤	miànhóng-ěrchì
面面俱到	面面俱到	miànmiàn-jùdào
苗條	苗条	miáotiao
面目全非	面目全非	miànmù-quánfēi
苗頭	苗头	miáotou
苗	苗	miáo
描繪	描绘	miáohuì
瞄準	瞄准	miáo zhǔn
廟	庙	miào
渺小	渺小	miǎoxiǎo
廟會	庙会	miàohuì
滅亡	灭亡	mièwáng
滅絕	灭绝	mièjué
民辦	民办	mínbàn
民俗	民俗	mínsú
民用	民用	mínyòng
民眾	民众	mínzhòng
敏捷	敏捷	mǐnjié
名副其實	名副其实	míngfùqíshí
名貴	名贵	míngguì
敏銳	敏锐	mǐnruì
名利	名利	mínglì
名聲	名声	míngshēng
名言	名言	míngyán
名氣	名气	míngqi
明朗	明朗	mínglǎng
明媚	明媚	míngmèi
名著	名著	míngzhù
銘記	铭记	míngjì
明智	明智	míngzhì
命	命	mìng
命名	命名	mìng míng
命題	命题	mìng tí
摸索	摸索	mōsuo
模擬	模拟	mónǐ
磨難	磨难	mónàn
磨損	磨损	mósǔn
磨合	磨合	móhé
蘑菇	蘑菇	mógu
魔鬼	魔鬼	móguǐ
魔術	魔术	móshù
抹	抹	mǒ
沒落	没落	mòluò
末日	末日	mòrì
陌生	陌生	mòshēng
莫非	莫非	mòfēi
莫過於	莫过于	mòguòyú
莫名其妙	莫名其妙	mòmíng-qímiào
漠然	漠然	mòrán
墨	墨	mò
默讀	默读	mòdú
默默無聞	默默无闻	mòmò-wúwén
謀害	谋害	móuhài
謀求	谋求	móuqiú
默契	默契	mòqì
謀生	谋生	móushēng
畝	亩	mǔ
牡丹	牡丹	mǔdan
木板	木板	mùbǎn
木材	木材	mùcái
木匠	木匠	mùjiang
目不轉睛	目不转睛	mùbùzhuǎnjīng
木偶	木偶	mùǒu
目瞪口呆	目瞪口呆	mùdèng-kǒudāi
目睹	目睹	mùdǔ
目的地	目的地	mùdìdì
目錄	目录	mùlù
目中無人	目中无人	mùzhōng-wúrén
沐浴露	沐浴露	mùyùlù
牧場	牧场	mùchǎng
募捐	募捐	mù juān
牧民	牧民	mùmín
墓地	墓地	mùdì
墓碑	墓碑	mùbēi
穆斯林	穆斯林	Mùsīlín
拿手	拿手	náshǒu
幕後	幕后	mùhòu
幕	幕	mù
吶喊	呐喊	nàhǎn
納悶兒	纳闷儿	nàmènr5
哪知道	哪知道	nǎzhīdào
納稅	纳税	nà shuì
納入	纳入	nàrù
納稅人	纳税人	nàshuìrén
乃至	乃至	nǎizhì
耐	耐	nài
耐人尋味	耐人寻味	nàirénxúnwèi
乃	乃	nǎi
耐性	耐性	nàixìng
難處	难处	nánchu
南瓜	南瓜	nángua
難得一見	难得一见	nándéyījiàn
難怪	难怪	nánguài
難點	难点	nándiǎn
難堪	难堪	nánkān
難關	难关	nánguān
難為情	难为情	nánwéiqíng
難以想象	难以想象	nányǐxiǎngxiàng
難說	难说	nánshuō
撓	挠	náo
難以置信	难以置信	nányǐzhìxìn
惱羞成怒	恼羞成怒	nǎoxiū-chéngnù
腦海	脑海	nǎohǎi
鬧事	闹事	nào shì
腦筋	脑筋	nǎojīn
鬧著玩兒	闹着玩儿	nàozhewánr5
內閣	内阁	nèigé
內存	内存	nèicún
內行	内行	nèiháng
內涵	内涵	nèihán
內幕	内幕	nèimù
內向	内向	nèixiàng
嫩	嫩	nèn
內需	内需	nèixū
能耗	能耗	nénghào
能人	能人	néngrén
能源	能源	néngyuán
能耐	能耐	néngnai
泥潭	泥潭	nítán
尼龍	尼龙	nílóng
泥土	泥土	nítǔ
擬定	拟定	nǐdìng
擬	拟	nǐ
匿名	匿名	nìmíng
逆	逆	nì
年畫	年画	niánhuà
年限	年限	niánxiàn
年薪	年薪	niánxīn
年夜飯	年夜饭	niányèfàn
年邁	年迈	niánmài
年終	年终	niánzhōng
念念不忘	念念不忘	niànniàn-bùwàng
黏	黏	nián
念書	念书	niàn shū
念頭	念头	niàntou
釀造	酿造	niàngzào
娘	娘	niáng
鳥巢	鸟巢	niǎocháo
捏	捏	niē
尿	尿	niào
凝聚	凝聚	níngjù
凝固	凝固	nínggù
寧可	宁可	nìngkě
擰	拧	níng
寧願	宁愿	nìngyuàn
扭曲	扭曲	niǔqū
扭頭	扭头	niǔ tóu
扭轉	扭转	niǔzhuǎn
紐帶	纽带	niǔdài
紐扣	纽扣	niǔkòu
農場	农场	nóngchǎng
農曆	农历	nónglì
農民工	农民工	nóngmíngōng
濃縮	浓缩	nóngsuō
農作物	农作物	nóngzuòwù
濃郁	浓郁	nóngyù
濃厚	浓厚	nónghòu
濃重	浓重	nóngzhòng
弄虛作假	弄虚作假	nòngxū-zuòjiǎ
奴隸	奴隶	núlì
暖烘烘	暖烘烘	nuǎnhōnghōng
虐待	虐待	nüèdài
女婿	女婿	nǚxu
諾言	诺言	nuòyán
哦	哦	ó
挪	挪	nuó
毆打	殴打	ōudǎ
嘔吐	呕吐	ǒutù
拍板	拍板	pāibǎn
拍賣	拍卖	pāimài
趴	趴	pā
排放	排放	páifàng
拍戲	拍戏	pāi xì
排練	排练	páiliàn
排斥	排斥	páichì
徘徊	徘徊	páihuái
派別	派别	pàibié
牌照	牌照	páizhào
派遣	派遣	pàiqiǎn
攀	攀	pān
攀昇	攀升	pānshēng
盤算	盘算	pánsuan
盤	盘	pán
判處	判处	pànchǔ
判定	判定	pàndìng
盼	盼	pàn
判決	判决	pànjué
叛逆	叛逆	pànnì
龐大	庞大	pángdà
旁觀	旁观	pángguān
拋	抛	pāo
拋開	抛开	pāokāi
刨	刨	páo
拋棄	抛弃	pāoqì
跑車	跑车	pǎochē
跑道	跑道	pǎodào
跑龍套	跑龙套	pǎo lóngtào
泡沫	泡沫	pàomò
陪伴	陪伴	péibàn
陪葬	陪葬	péizàng
賠錢	赔钱	péi qián
胚胎	胚胎	pēitāi
佩服	佩服	pèifu
配件	配件	pèijiàn
配送	配送	pèisòng
配偶	配偶	pèiǒu
配音	配音	pèi yīn
噴泉	喷泉	pēnquán
抨擊	抨击	pēngjī
烹調	烹调	pēngtiáo
鵬程萬里	鹏程万里	péngchéng-wànlǐ
蓬勃	蓬勃	péngbó
膨脹	膨胀	péngzhàng
捧	捧	pěng
捧場	捧场	pěng chǎng
碰釘子	碰钉子	pèng dīngzi
碰巧	碰巧	pèngqiǎo
碰上	碰上	pèngshàng
碰撞	碰撞	pèngzhuàng
批發	批发	pīfā
批判	批判	pīpàn
劈	劈	pī
披露	披露	pīlù
皮帶	皮带	pídài
疲憊不堪	疲惫不堪	píbèibùkān
疲憊	疲惫	píbèi
疲倦	疲倦	píjuàn
疲勞	疲劳	píláo
脾	脾	pí
匹配	匹配	pǐpèi
譬如	譬如	pìrú
媲美	媲美	pìměi
譬如說	譬如说	pìrúshuō
僻靜	僻静	pìjìng
偏差	偏差	piānchā
偏方	偏方	piānfāng
偏見	偏见	piānjiàn
片子	片子	piānzi
偏僻	偏僻	piānpì
偏偏	偏偏	piānpiān
偏向	偏向	piānxiàng
篇幅	篇幅	piānfu
偏遠	偏远	piānyuǎn
騙人	骗人	piàn rén
片段	片段	piànduàn
漂	漂	piào
飄	飘	piāo
票房	票房	piàofáng
撇	撇	piē
拼搏	拼搏	pīnbó
貧富	贫富	pínfù
拼命	拼命	pīn mìng
貧窮	贫穷	pínqióng
頻頻	频频	pínpín
品嘗	品尝	pǐncháng
頻率	频率	pínlǜ
品德	品德	pǐndé
品行	品行	pǐnxíng
品位	品位	pǐnwèi
聘用	聘用	pìnyòng
乒乓球	乒乓球	pīngpāngqiú
聘	聘	pìn
聘任	聘任	pìnrèn
平常心	平常心	píngchángxīn
平淡	平淡	píngdàn
平和	平和	pínghé
平價	平价	píngjià
平面	平面	píngmiàn
平民	平民	píngmín
平息	平息	píngxī
評定	评定	píngdìng
評論員	评论员	pínglùnyuán
平日	平日	píngrì
評判	评判	píngpàn
評審	评审	píngshěn
憑借	凭借	píngjiè
憑著	凭着	píngzhe
評委	评委	píngwěi
憑證	凭证	píngzhèng
萍水相逢	萍水相逢	píngshuǐ-xiāngféng
瓶頸	瓶颈	píngjǐng
潑冷水	泼冷水	pō lěngshuǐ
迫不及待	迫不及待	pòbùjídài
頗	颇	pō
迫害	迫害	pòhài
破案	破案	pò àn
破除	破除	pòchú
破解	破解	pòjiě
破舊	破旧	pòjiù
迫使	迫使	pòshǐ
破裂	破裂	pòliè
破碎	破碎	pòsuì
魄力	魄力	pòlì
破滅	破灭	pòmiè
撲面而來	扑面而来	pūmiànérlái
撲克	扑克	pūkè
鋪路	铺路	pū lù
樸實	朴实	pǔshí
菩薩	菩萨	púsà
樸素	朴素	pǔsù
普通人	普通人	pǔtōngrén
譜	谱	pǔ
瀑布	瀑布	pùbù
七嘴八舌	七嘴八舌	qīzuǐ-bāshé
沏	沏	qī
凄涼	凄凉	qīliáng
期盼	期盼	qīpàn
欺騙	欺骗	qīpiàn
漆	漆	qī
欺詐	欺诈	qīzhà
齊心協力	齐心协力	qíxīn-xiélì
其間	其间	qíjiān
其後	其后	qíhòu
奇花異草	奇花异草	qíhuāyìcǎo
奇跡	奇迹	qíjì
歧視	歧视	qíshì
奇特	奇特	qítè
祈禱	祈祷	qídǎo
棋	棋	qí
棋子	棋子	qízǐ
旗袍	旗袍	qípáo
旗幟	旗帜	qízhì
乞丐	乞丐	qǐgài
乞討	乞讨	qǐtǎo
豈有此理	岂有此理	qǐyǒu-cǐlǐ
乞求	乞求	qǐqiú
啟蒙	启蒙	qǐ méng
啟迪	启迪	qǐdí
啟示	启示	qǐshì
起步	起步	qǐ bù
起草	起草	qǐ cǎo
起程	起程	qǐ chéng
起初	起初	qǐchū
起勁	起劲	qǐjìn
起跑線	起跑线	qǐpǎoxiàn
起源	起源	qǐyuán
起伏	起伏	qǐfú
氣憤	气愤	qìfèn
氣管	气管	qìguǎn
氣餒	气馁	qìněi
氣泡	气泡	qìpào
氣派	气派	qìpài
氣勢	气势	qìshì
氣味	气味	qìwèi
氣息	气息	qìxī
氣魄	气魄	qìpò
氣質	气质	qìzhì
迄今為止	迄今为止	qìjīnwéizhǐ
契約	契约	qìyuē
契機	契机	qìjī
迄今	迄今	qìjīn
器材	器材	qìcái
器械	器械	qìxiè
卡	卡	kǎ
掐	掐	qiā
洽談	洽谈	qiàtán
恰到好處	恰到好处	qiàdào-hǎochù
卡子	卡子	qiǎzi
恰恰相反	恰恰相反	qiàqiàxiāngfǎn
恰如其分	恰如其分	qiàrú-qífèn
恰巧	恰巧	qiàqiǎo
千變萬化	千变万化	qiānbiàn-wànhuà
千家萬戶	千家万户	qiānjiā-wànhù
千方百計	千方百计	qiānfāng-bǎijì
千鈞一髮	千钧一发	qiānjūn-yīfà
千軍萬馬	千军万马	qiānjūn-wànmǎ
遷就	迁就	qiānjiù
遷	迁	qiān
遷移	迁移	qiānyí
牽扯	牵扯	qiānchě
牽涉	牵涉	qiānshè
牽掛	牵挂	qiānguà
牽頭	牵头	qiān tóu
鉛	铅	qiān
牽制	牵制	qiānzhì
謙遜	谦逊	qiānxùn
簽署	签署	qiānshǔ
前輩	前辈	qiánbèi
前不久	前不久	qiánbùjiǔ
前赴後繼	前赴后继	qiánfù-hòujì
簽	签	qiān
前期	前期	qiánqī
前所未有	前所未有	qiánsuǒwèiyǒu
前任	前任	qiánrèn
前無古人	前无古人	qiánwúgǔrén
前夕	前夕	qiánxī
前臺	前台	qiántái
前線	前线	qiánxiàn
前仰後合	前仰后合	qiányǎng-hòuhé
前者	前者	qiánzhě
前沿	前沿	qiányán
虔誠	虔诚	qiánchéng
鉗子	钳子	qiánzi
錢財	钱财	qiáncái
潛能	潜能	qiánnéng
潛艇	潜艇	qiántǐng
潛移默化	潜移默化	qiányí-mòhuà
潛在	潜在	qiánzài
潛水	潜水	qiánshuǐ
譴責	谴责	qiǎnzé
欠缺	欠缺	qiànquē
欠條	欠条	qiàntiáo
嗆	呛	qiāng
歉意	歉意	qiànyì
槍斃	枪毙	qiāngbì
強加	强加	qiángjiā
強勁	强劲	qiángjìng
強項	强项	qiángxiàng
強硬	强硬	qiángyìng
強行	强行	qiángxíng
腔	腔	qiāng
強占	强占	qiángzhàn
強制	强制	qiángzhì
搶奪	抢夺	qiǎngduó
搶眼	抢眼	qiǎngyǎn
敲邊鼓	敲边鼓	qiāo biāngǔ
搶劫	抢劫	qiǎngjié
敲詐	敲诈	qiāozhà
喬裝	乔装	qiáozhuāng
瞧不起	瞧不起	qiáobuqǐ
竅門	窍门	qiàomén
巧合	巧合	qiǎohé
翹	翘	qiào
切除	切除	qiēchú
切斷	切断	qiē duàn
切割	切割	qiēgē
撬	撬	qiào
且	且	qiě
切身	切身	qièshēn
竊取	窃取	qièqǔ
欽佩	钦佩	qīnpèi
侵害	侵害	qīnhài
侵略	侵略	qīnlüè
侵占	侵占	qīnzhàn
親和力	亲和力	qīnhélì
侵權	侵权	qīnquán
親朋好友	亲朋好友	qīnpénghǎoyǒu
親近	亲近	qīnjìn
親戚	亲戚	qīnqi
親情	亲情	qīnqíng
親熱	亲热	qīnrè
親身	亲身	qīnshēn
親手	亲手	qīnshǒu
親生	亲生	qīnshēng
親友	亲友	qīnyǒu
勤工儉學	勤工俭学	qíngōng-jiǎnxué
勤勞	勤劳	qínláo
勤快	勤快	qínkuai
寢室	寝室	qǐnshì
青春期	青春期	qīngchūnqī
青蛙	青蛙	qīngwā
輕而易舉	轻而易举	qīngéryìjǔ
輕蔑	轻蔑	qīngmiè
輕型	轻型	qīngxíng
輕微	轻微	qīngwēi
傾家蕩產	倾家荡产	qīngjiā-dàngchǎn
傾聽	倾听	qīngtīng
傾銷	倾销	qīngxiāo
傾訴	倾诉	qīngsù
傾斜	倾斜	qīngxié
清單	清单	qīngdān
清除	清除	qīngchú
清脆	清脆	qīngcuì
清靜	清静	qīngjìng
清涼	清凉	qīngliáng
清淡	清淡	qīngdàn
清明	清明	qīngmíng
清晰	清晰	qīngxī
清新	清新	qīngxīn
清真寺	清真寺	qīngzhēnsì
情報	情报	qíngbào
情	情	qíng
情不自禁	情不自禁	qíngbùzìjīn
情懷	情怀	qínghuái
情調	情调	qíngdiào
情結	情结	qíngjié
情侶	情侣	qínglǚ
情人	情人	qíngrén
情誼	情谊	qíngyì
情願	情愿	qíngyuàn
請帖	请帖	qǐngtiě
請柬	请柬	qǐngjiǎn
慶典	庆典	qìngdiǎn
慶幸	庆幸	qìngxìng
慶賀	庆贺	qìnghè
丘陵	丘陵	qiūlíng
囚犯	囚犯	qiúfàn
求婚	求婚	qiú hūn
求學	求学	qiúxué
求救	求救	qiújiù
求證	求证	qiúzhèng
求醫	求医	qiúyī
曲線	曲线	qūxiàn
曲折	曲折	qūzhé
求助	求助	qiúzhù
驅動	驱动	qūdòng
屈服	屈服	qūfú
驅逐	驱逐	qūzhú
曲	曲	qū
趨於	趋于	qūyú
取代	取代	qǔdài
取而代之	取而代之	qǔérdàizhī
取經	取经	qǔ jīng
取決於	取决于	qǔjuéyú
取締	取缔	qǔdì
取暖	取暖	qǔ nuǎn
取笑	取笑	qǔxiào
取勝	取胜	qǔshèng
娶	娶	qǔ
去除	去除	qùchú
去向	去向	qùxiàng
去處	去处	qùchù
圈套	圈套	quāntào
趣味	趣味	qùwèi
權衡	权衡	quánhéng
權威	权威	quánwēi
圈子	圈子	quānzi
權益	权益	quányì
全程	全程	quánchéng
全長	全长	quáncháng
全方位	全方位	quánfāngwèi
全局	全局	quánjú
全力以赴	全力以赴	quánlìyǐfù
全能	全能	quánnéng
全心全意	全心全意	quánxīn-quányì
拳	拳	quán
全文	全文	quánwén
勸告	劝告	quàngào
勸說	劝说	quànshuō
勸阻	劝阻	quànzǔ
缺口	缺口	quēkǒu
拳頭	拳头	quántou
確切	确切	quèqiè
缺失	缺失	quēshī
確信	确信	quèxìn
缺席	缺席	quē xí
確診	确诊	quèzhěn
確鑿	确凿	quèzáo
燃放	燃放	ránfàng
燃氣	燃气	ránqì
燃油	燃油	rányóu
讓步	让步	ràng bù
嚷	嚷	rǎng
饒	饶	ráo
擾亂	扰乱	rǎoluàn
饒恕	饶恕	ráoshù
繞行	绕行	ràoxíng
惹	惹	rě
熱潮	热潮	rècháo
熱氣	热气	rèqì
熱帶	热带	rèdài
熱騰騰	热腾腾	rèténgténg
熱衷	热衷	rèzhōng
熱氣球	热气球	rèqìqiú
人道	人道	réndào
人次	人次	réncì
人格	人格	réngé
人工智能	人工智能	réngōngzhìnéng
人均	人均	rénjūn
人品	人品	rénpǐn
人情	人情	rénqíng
人氣	人气	rénqì
人身	人身	rénshēn
人事	人事	rénshì
人手	人手	rénshǒu
人體	人体	réntǐ
人為	人为	rénwéi
人文	人文	rénwén
人行道	人行道	rénxíngdào
人選	人选	rénxuǎn
人緣兒	人缘儿	rényuánr5
人造	人造	rénzào
人性	人性	rénxing
人質	人质	rénzhì
仁慈	仁慈	réncí
忍飢挨餓	忍饥挨饿	rěnjī-áiè
忍耐	忍耐	rěnnài
忍心	忍心	rěn xīn
認錯	认错	rèn cuò
認證	认证	rènzhèng
任命	任命	rènmìng
認知	认知	rènzhī
任期	任期	rènqī
任人宰割	任人宰割	rènrén-zǎigē
任意	任意	rènyì
任職	任职	rèn zhí
韌性	韧性	rènxìng
日程	日程	rìchéng
日復一日	日复一日	rìfùyīrì
日前	日前	rìqián
日後	日后	rìhòu
日趨	日趋	rìqū
日新月異	日新月异	rìxīn-yuèyì
日益	日益	rìyì
榮獲	荣获	rónghuò
榮幸	荣幸	róngxìng
榮譽	荣誉	róngyù
容光煥發	容光焕发	róngguāng-huànfā
容忍	容忍	róngrěn
容量	容量	róngliàng
容納	容纳	róngnà
容顏	容颜	róngyán
容許	容许	róngxǔ
溶解	溶解	róngjiě
融	融	róng
融化	融化	rónghuà
冗長	冗长	rǒngcháng
融洽	融洽	róngqià
柔和	柔和	róuhé
柔軟	柔软	róuruǎn
如果說	如果说	rúguǒshuō
揉	揉	róu
如實	如实	rúshí
如意	如意	rú yì
如願以償	如愿以偿	rúyuàn-yǐcháng
儒家	儒家	Rújiā
如醉如痴	如醉如痴	rúzuì-rúchī
入場	入场	rù chǎng
儒學	儒学	rúxué
入場券	入场券	rùchǎngquàn
入侵	入侵	rùqīn
入境	入境	rù jìng
入選	入选	rù xuǎn
軟弱	软弱	ruǎnruò
軟實力	软实力	ruǎnshílì
瑞雪	瑞雪	ruìxuě
潤	润	rùn
若干	若干	ruògān
弱勢	弱势	ruòshì
弱點	弱点	ruòdiǎn
撒謊	撒谎	sā huǎng
撒	撒	sā
賽車	赛车	sàichē
三番五次	三番五次	sānfān-wǔcì
賽跑	赛跑	sàipǎo
三角	三角	sānjiǎo
三維	三维	sānwéi
散布	散布	sànbù
桑拿	桑拿	sāngná
嗓子	嗓子	sǎngzi
散發	散发	sànfā
喪生	丧生	sàng shēng
騷亂	骚乱	sāoluàn
騷擾	骚扰	sāorǎo
掃除	扫除	sǎochú
掃描	扫描	sǎomiáo
掃興	扫兴	sǎo xìng
嫂子	嫂子	sǎozi
掃墓	扫墓	sǎo mù
殺害	杀害	shāhài
僧人	僧人	sēngrén
殺手	杀手	shāshǒu
沙龍	沙龙	shālóng
紗	纱	shā
沙灘	沙滩	shātān
砂糖	砂糖	shātáng
剎車	刹车	shāchē
鯊魚	鲨鱼	shāyú
傻瓜	傻瓜	shǎguā
篩	筛	shāi
曬太陽	晒太阳	shài tàiyang
山川	山川	shānchuān
篩選	筛选	shāixuǎn
山岡	山冈	shāngāng
山嶺	山岭	shānlǐng
山頂	山顶	shāndǐng
山寨	山寨	shānzhài
山路	山路	shānlù
刪除	删除	shānchú
刪	删	shān
煽動	煽动	shāndòng
閃爍	闪烁	shǎnshuò
善意	善意	shànyì
善	善	shàn
擅長	擅长	shàncháng
擅自	擅自	shànzì
膳食	膳食	shànshí
贍養	赡养	shànyǎng
傷殘	伤残	shāngcán
傷痕	伤痕	shānghén
傷腦筋	伤脑筋	shāng nǎojīn
傷勢	伤势	shāngshì
傷感	伤感	shānggǎn
商販	商贩	shāngfàn
商討	商讨	shāngtǎo
商賈	商贾	shānggǔ
上報	上报	shàng bào
上場	上场	shàng chǎng
上方	上方	shàngfāng
上崗	上岗	shàng gǎng
上火	上火	shàng huǒ
上空	上空	shàngkōng
上流	上流	shàngliú
上任	上任	shàng rèn
上期	上期	shàngqī
上述	上述	shàngshù
上司	上司	shàngsi
上訴	上诉	shàngsù
上調	上调	shàngdiào
上頭	上头	shàngtou
上限	上限	shàngxiàn
上旬	上旬	shàngxún
上癮	上瘾	shàng yǐn
上游	上游	shàngyóu
上映	上映	shàngyìng
尚	尚	shàng
尚未	尚未	shàngwèi
捎	捎	shāo
燒毀	烧毁	shāohuǐ
燒烤	烧烤	shāokǎo
稍後	稍后	shāohòu
稍稍	稍稍	shāoshāo
少見	少见	shǎojiàn
少不了	少不了	shǎobuliǎo
少量	少量	shǎoliàng
稍候	稍候	shāohòu
少林寺	少林寺	Shàolínsì
少有	少有	shǎoyǒu
奢侈	奢侈	shēchǐ
少女	少女	shàonǚ
奢望	奢望	shēwàng
設	设	shè
設定	设定	shèdìng
設法	设法	shèfǎ
社交	社交	shèjiāo
社會主義	社会主义	shèhuìzhǔyì
社論	社论	shèlùn
社團	社团	shètuán
攝氏度	摄氏度	shèshìdù
誰知道	谁知道	shuí zhīdào
涉嫌	涉嫌	shèxián
申辦	申办	shēnbàn
申領	申领	shēnlǐng
伸手	伸手	shēn shǒu
伸縮	伸缩	shēnsuō
申報	申报	shēnbào
伸張	伸张	shēnzhāng
身不由己	身不由己	shēnbùyóujǐ
身軀	身躯	shēnqū
身價	身价	shēnjià
身心	身心	shēnxīn
身影	身影	shēnyǐng
身子	身子	shēnzi
紳士	绅士	shēnshì
深切	深切	shēnqiè
深情	深情	shēnqíng
深奧	深奥	shēnào
深入人心	深入人心	shēnrù-rénxīn
深受	深受	shēnshòu
深信	深信	shēnxìn
深思	深思	shēnsī
深遠	深远	shēnyuǎn
深夜	深夜	shēnyè
神氣	神气	shénqì
神聖	神圣	shénshèng
神仙	神仙	shénxian
神態	神态	shéntài
審	审	shěn
審定	审定	shěndìng
審核	审核	shěnhé
審美	审美	shěnměi
審批	审批	shěnpī
審判	审判	shěnpàn
腎	肾	shèn
審視	审视	shěnshì
甚至於	甚至于	shènzhìyú
滲透	渗透	shèntòu
慎重	慎重	shènzhòng
滲	渗	shèn
升溫	升温	shēng wēn
生理	生理	shēnglǐ
生機	生机	shēngjī
生命線	生命线	shēngmìngxiàn
生平	生平	shēngpíng
生怕	生怕	shēngpà
生前	生前	shēngqián
生態	生态	shēngtài
生死	生死	shēng-sǐ
生效	生效	shēng xiào
生物	生物	shēngwù
生涯	生涯	shēngyá
生硬	生硬	shēngyìng
生育	生育	shēngyù
聲稱	声称	shēngchēng
聲譽	声誉	shēngyù
聲望	声望	shēngwàng
繩子	绳子	shéngzi
牲畜	牲畜	shēngchù
省略	省略	shěnglüè
省事	省事	shěngshì
勝出	胜出	shèngchū
聖賢	圣贤	shèngxián
勝任	胜任	shèngrèn
盛大	盛大	shèngdà
盛會	盛会	shènghuì
盛氣凌人	盛气凌人	shèngqì-língrén
剩餘	剩余	shèngyú
盛開	盛开	shèngkāi
失傳	失传	shīchuán
屍體	尸体	shītǐ
失控	失控	shī kòng
失利	失利	shī lì
失戀	失恋	shī liàn
失靈	失灵	shī líng
失眠	失眠	shī mián
失明	失明	shī míng
失落	失落	shīluò
失效	失效	shī xiào
失蹤	失踪	shī zōng
失業率	失业率	shīyèlǜ
師範	师范	shīfàn
師長	师长	shīzhǎng
獅子	狮子	shīzi
師資	师资	shīzī
施工	施工	shī gōng
施加	施加	shījiā
施行	施行	shīxíng
施壓	施压	shīyā
濕潤	湿润	shīrùn
濕度	湿度	shīdù
十字路口	十字路口	shízì lùkǒu
時段	时段	shíduàn
時不時	时不时	shíbùshí
時隔	时隔	shígé
時間表	时间表	shíjiānbiǎo
時好時壞	时好时坏	shíhǎoshíhuài
時髦	时髦	shímáo
時尚	时尚	shíshàng
時空	时空	shíkōng
時速	时速	shísù
識別	识别	shíbié
實話	实话	shíhuà
實地	实地	shídì
實話實說	实话实说	shíhuà-shíshuō
實事求是	实事求是	shíshì-qiúshì
實體	实体	shítǐ
實況	实况	shíkuàng
實質	实质	shízhì
實物	实物	shíwù
食宿	食宿	shí-sù
食用	食用	shíyòng
史無前例	史无前例	shǐwúqiánlì
使喚	使唤	shǐhuan
使命	使命	shǐmìng
使者	使者	shǐzhě
士氣	士气	shìqì
示威	示威	shì wēi
示意	示意	shìyì
世代	世代	shìdài
世界級	世界级	shìjièjí
世故	世故	shìgu
世襲	世袭	shìxí
市場經濟	市场经济	shìchǎng jīngjì
勢必	势必	shìbì
勢頭	势头	shìtou
勢不可當	势不可当	shìbùkědāng
事務	事务	shìwù
事態	事态	shìtài
事務所	事务所	shìwùsuǒ
事項	事项	shìxiàng
事跡	事迹	shìjì
侍候	侍候	shìhòu
試探	试探	shìtan
事宜	事宜	shìyí
試行	试行	shìxíng
試用期	试用期	shìyòngqī
試用	试用	shìyòng
視角	视角	shìjiǎo
視覺	视觉	shìjué
視察	视察	shìchá
視線	视线	shìxiàn
視野	视野	shìyě
視力	视力	shìlì
是非	是非	shìfēi
適度	适度	shìdù
柿子	柿子	shìzi
適宜	适宜	shìyí
適時	适时	shìshí
釋放	释放	shìfàng
適量	适量	shìliàng
嗜好	嗜好	shìhào
收復	收复	shōufù
收據	收据	shōujù
收斂	收敛	shōuliǎn
收買	收买	shōumǎi
逝世	逝世	shìshì
收留	收留	shōuliú
收縮	收缩	shōusuō
收視率	收视率	shōushìlǜ
收支	收支	shōuzhī
手臂	手臂	shǒubì
手冊	手册	shǒucè
手動	手动	shǒudòng
手帕	手帕	shǒupà
手腳	手脚	shǒujiǎo
手槍	手枪	shǒuqiāng
手勢	手势	shǒushì
手術室	手术室	shǒushùshì
手腕	手腕	shǒuwàn
手頭	手头	shǒutóu
手藝	手艺	shǒuyì
手掌	手掌	shǒuzhǎng
守候	守候	shǒuhòu
守株待兔	守株待兔	shǒuzhū-dàitù
首創	首创	shǒuchuàng
守護	守护	shǒuhù
首府	首府	shǒufǔ
首批	首批	shǒupī
首飾	首饰	shǒushi
首要	首要	shǒuyào
受過	受过	shòu guò
壽命	寿命	shòumìng
受害人	受害人	shòuhàirén
受害	受害	shòu hài
受賄	受贿	shòu huì
受驚	受惊	shòu jīng
受苦	受苦	shòu kǔ
受理	受理	shòulǐ
受益	受益	shòu yì
授權	授权	shòuquán
受騙	受骗	shòu piàn
售價	售价	shòujià
授予	授予	shòuyǔ
售票	售票	shòu piào
書櫥	书橱	shūchú
書籍	书籍	shūjí
書記	书记	shūji
書面	书面	shūmiàn
書寫	书写	shūxiě
抒情	抒情	shūqíng
梳	梳	shū
樞紐	枢纽	shūniǔ
梳子	梳子	shūzi
梳理	梳理	shūlǐ
舒暢	舒畅	shūchàng
疏導	疏导	shūdǎo
疏散	疏散	shūsàn
疏通	疏通	shūtōng
輸家	输家	shūjia
疏忽	疏忽	shūhu
輸送	输送	shūsòng
輸血	输血	shū xuè
贖	赎	shú
輸液	输液	shū yè
屬性	属性	shǔxìng
曙光	曙光	shǔguāng
暑期	暑期	shǔqī
束縛	束缚	shùfù
樹木	树木	shùmù
樹立	树立	shùlì
樹梢	树梢	shùshāo
樹蔭	树荫	shùyīn
竪	竖	shù
樹枝	树枝	shùzhī
數據庫	数据库	shùjùkù
刷新	刷新	shuāxīn
耍	耍	shuǎ
數額	数额	shùé
耍賴	耍赖	shuǎlài
衰減	衰减	shuāijiǎn
衰竭	衰竭	shuāijié
衰弱	衰弱	shuāiruò
衰老	衰老	shuāilǎo
衰退	衰退	shuāituì
摔跤	摔跤	shuāi jiāo
甩	甩	shuǎi
涮	涮	shuàn
雙胞胎	双胞胎	shuāngbāotāi
拴	拴	shuān
雙邊	双边	shuāngbiān
雙重	双重	shuāngchóng
雙向	双向	shuāngxiàng
霜	霜	shuāng
雙贏	双赢	shuāngyíng
爽快	爽快	shuǎngkuai
水稻	水稻	shuǐdào
水管	水管	shuǐguǎn
水壺	水壶	shuǐhú
水槽	水槽	shuǐcáo
水晶	水晶	shuǐjīng
水利	水利	shuǐlì
水貨	水货	shuǐhuò
水靈靈	水灵灵	shuǐlínglíng
水落石出	水落石出	shuǐluò-shíchū
水面	水面	shuǐmiàn
水龍頭	水龙头	shuǐlóngtóu
水手	水手	shuǐshǒu
水溫	水温	shuǐwēn
水源	水源	shuǐyuán
水漲船高	水涨船高	shuǐzhǎng-chuángāo
水域	水域	shuǐyù
水準	水准	shuǐzhǔn
稅收	税收	shuìshōu
稅務	税务	shuìwù
睡袋	睡袋	shuìdài
順便	顺便	shùnbiàn
順暢	顺畅	shùnchàng
順差	顺差	shùnchā
順從	顺从	shùncóng
順理成章	顺理成章	shùnlǐ-chéngzhāng
順其自然	顺其自然	shùnqízìrán
順路	顺路	shùnlù
順勢	顺势	shùnshì
順手	顺手	shùnshǒu
順心	顺心	shùn xīn
順著	顺着	shùnzhe
順應	顺应	shùnyìng
說白了	说白了	shuōbáile
說不上	说不上	shuōbushàng
說到底	说到底	shuōdàodǐ
說道	说道	shuōdao
瞬間	瞬间	shùnjiān
說幹就幹	说干就干	shuōgànjiùgàn
說謊	说谎	shuō huǎng
說老實話	说老实话	shuōlǎoshihuà
說起來	说起来	shuō qǐlái
說閒話	说闲话	shuō xiánhuà
說情	说情	shuō qíng
說真的	说真的	shuōzhēnde
碩果	硕果	shuòguǒ
司空見慣	司空见惯	sīkōng-jiànguàn
司令	司令	sīlìng
司法	司法	sīfǎ
絲綢	丝绸	sīchóu
絲	丝	sī
絲毫	丝毫	sīháo
私房錢	私房钱	sīfangqián
私家車	私家车	sījiāchē
私立	私立	sīlì
私下	私下	sīxià
私事	私事	sīshì
私營	私营	sīyíng
私有	私有	sīyǒu
私自	私自	sīzì
思念	思念	sīniàn
思前想後	思前想后	sīqián-xiǎnghòu
思路	思路	sīlù
思索	思索	sīsuǒ
撕	撕	sī
死心	死心	sǐ xīn
死心塌地	死心塌地	sǐxīn-tādì
四合院	四合院	sìhéyuàn
四面八方	四面八方	sìmiàn-bāfāng
寺廟	寺庙	sìmiào
似曾相識	似曾相识	sìcéngxiāngshí
四季	四季	sìjì
似是而非	似是而非	sìshìérfēi
伺機	伺机	sìjī
飼料	饲料	sìliào
飼養	饲养	sìyǎng
鬆綁	松绑	sōng bǎng
聳立	耸立	sǒnglì
鬆弛	松弛	sōngchí
送別	送别	sòng bié
搜集	搜集	sōují
搜查	搜查	sōuchá
搜救	搜救	sōujiù
艘	艘	sōu
搜尋	搜寻	sōuxún
酥	酥	sū
蘇醒	苏醒	sūxǐng
俗話	俗话	súhuà
俗話說	俗话说	súhuàshuō
俗	俗	sú
訴苦	诉苦	sù kǔ
訴說	诉说	sùshuō
俗語	俗语	súyǔ
訴訟	诉讼	sùsòng
素	素	sù
素不相識	素不相识	sùbùxiāngshí
素材	素材	sùcái
素描	素描	sùmiáo
素養	素养	sùyǎng
塑造	塑造	sùzào
蒜	蒜	suàn
素食	素食	sùshí
算計	算计	suànji
算盤	算盘	suànpan
算賬	算账	suàn zhàng
隨處可見	随处可见	suíchùkějiàn
隨大溜	随大溜	suídàliù
隨機	随机	suíjī
雖說	虽说	suīshuō
隨即	随即	suíjí
隨身	随身	suíshēn
隨時隨地	随时随地	suíshí-suídì
隨心所欲	随心所欲	suíxīnsuǒyù
遂心	遂心	suì xīn
隧道	隧道	suìdào
損壞	损坏	sǔnhuài
損人利己	损人利己	sǔnrén-lìjǐ
損傷	损伤	sǔnshāng
損	损	sǔn
縮	缩	suō
縮水	缩水	suō shuǐ
縮影	缩影	suōyǐng
所屬	所属	suǒshǔ
所謂	所谓	suǒwèi
所作所為	所作所为	suǒzuò-suǒwéi
索賠	索赔	suǒpéi
索性	索性	suǒxìng
鎖定	锁定	suǒdìng
他人	他人	tārén
索取	索取	suǒqǔ
胎	胎	tāi
踏上	踏上	tàshàng
塌	塌	tā
檯球	台球	táiqiú
太極	太极	tàijí
太極拳	太极拳	tàijíquán
胎兒	胎儿	tāiér
太平	太平	tàipíng
泰斗	泰斗	tàidǒu
貪	贪	tān
貪婪	贪婪	tānlán
貪玩兒	贪玩儿	tān wánr5
攤	摊	tān
貪污	贪污	tānwū
癱	瘫	tān
癱瘓	瘫痪	tānhuàn
談不上	谈不上	tánbushàng
罈	坛	tán
談到	谈到	tándào
談論	谈论	tánlùn
彈性	弹性	tánxìng
談起	谈起	tánqǐ
痰	痰	tán
坦誠	坦诚	tǎnchéng
坦白	坦白	tǎnbái
坦克	坦克	tǎnkè
坦然	坦然	tǎnrán
坦率	坦率	tǎnshuài
探	探	tàn
毯子	毯子	tǎnzi
炭	炭	tàn
探測	探测	tàncè
探親	探亲	tàn qīn
探求	探求	tànqiú
探望	探望	tànwàng
探險	探险	tàn xiǎn
湯圓	汤圆	tāngyuán
堂	堂	táng
碳	碳	tàn
糖尿病	糖尿病	tángniàobìng
糖果	糖果	tángguǒ
倘若	倘若	tǎngruò
淌	淌	tǎng
掏錢	掏钱	tāoqián
燙	烫	tàng
滔滔不絕	滔滔不绝	tāotāo-bùjué
逃生	逃生	táoshēng
逃避	逃避	táobì
逃亡	逃亡	táowáng
陶冶	陶冶	táoyě
陶瓷	陶瓷	táocí
陶醉	陶醉	táozuì
淘	淘	táo
淘氣	淘气	táo qì
淘汰	淘汰	táotài
討好	讨好	tǎo hǎo
討價還價	讨价还价	tǎojià-huánjià
特產	特产	tèchǎn
討人喜歡	讨人喜欢	tǎorénxǐhuan
討	讨	tǎo
特長	特长	tècháng
特例	特例	tèlì
特權	特权	tèquán
特質	特质	tèzhì
特製	特制	tèzhì
藤椅	藤椅	téngyǐ
騰	腾	téng
特邀	特邀	tèyāo
梯子	梯子	tīzi
剔除	剔除	tīchú
提拔	提拔	tíba
提名	提名	tí míng
提煉	提炼	tíliàn
提速	提速	tí sù
提心吊膽	提心吊胆	tíxīn-diàodǎn
提議	提议	tíyì
提早	提早	tízǎo
體面	体面	tǐmian
體諒	体谅	tǐliàng
體貼	体贴	tǐtiē
體能	体能	tǐnéng
體系	体系	tǐxì
體溫	体温	tǐwēn
體制	体制	tǐzhì
剃	剃	tì
替換	替换	tìhuàn
體質	体质	tǐzhì
替身	替身	tìshēn
天長地久	天长地久	tiāncháng-dìjiǔ
天地	天地	tiāndì
天鵝	天鹅	tiāné
天分	天分	tiānfèn
天經地義	天经地义	tiānjīng-dìyì
天平	天平	tiānpíng
天賦	天赋	tiānfù
天橋	天桥	tiānqiáo
天生	天生	tiānshēng
天線	天线	tiānxiàn
天使	天使	tiānshǐ
天性	天性	tiānxìng
天主教	天主教	Tiānzhǔjiào
甜美	甜美	tiánměi
甜蜜	甜蜜	tiánmì
添加	添加	tiānjiā
填補	填补	tiánbǔ
填充	填充	tiánchōng
填寫	填写	tiánxiě
舔	舔	tiǎn
甜頭	甜头	tiántou
挑剔	挑剔	tiāoti
條款	条款	tiáokuǎn
條例	条例	tiáolì
條約	条约	tiáoyuē
調侃	调侃	tiáokǎn
調控	调控	tiáokòng
調料	调料	tiáoliào
調試	调试	tiáoshì
挑起	挑起	tiǎoqǐ
挑釁	挑衅	tiǎoxìn
跳槽	跳槽	tiào cáo
跳傘	跳伞	tiàosǎn
跳動	跳动	tiàodòng
跳躍	跳跃	tiàoyuè
貼切	贴切	tiēqiè
帖子	帖子	tiězi
貼近	贴近	tiējìn
聽從	听从	tīngcóng
停泊	停泊	tíngbó
聽話	听话	tīng huà
停電	停电	tíng diàn
停車位	停车位	tíngchēwèi
停頓	停顿	tíngdùn
停放	停放	tíngfàng
通暢	通畅	tōngchàng
停業	停业	tíng yè
通車	通车	tōng chē
通告	通告	tōnggào
通風	通风	tōngfēng
通順	通顺	tōngshùn
通俗	通俗	tōngsú
通緝	通缉	tōngjī
通往	通往	tōngwǎng
通通	通通	tōngtōng
通宵	通宵	tōngxiāo
通行證	通行证	tōngxíngzhèng
同伴	同伴	tóngbàn
同等	同等	tóngděng
同感	同感	tónggǎn
同伙	同伙	tónghuǒ
同步	同步	tóngbù
同類	同类	tónglèi
同盟	同盟	tóngméng
同年	同年	tóngnián
同人	同人	tóngrén
同志	同志	tóngzhì
同舟共濟	同舟共济	tóngzhōu-gòngjì
統籌	统筹	tǒngchóu
銅	铜	tóng
統統	统统	tǒngtǒng
統治	统治	tǒngzhì
捅	捅	tǒng
桶	桶	tǒng
筒	筒	tǒng
痛心	痛心	tòngxīn
偷看	偷看	tōukàn
痛	痛	tòng
偷窺	偷窥	tōukuī
偷懶	偷懒	tōu lǎn
頭頂	头顶	tóudǐng
頭部	头部	tóubù
頭號	头号	tóuhào
頭條	头条	tóutiáo
頭頭是道	头头是道	tóutóu-shìdào
頭暈	头晕	tóu yūn
投奔	投奔	tóubèn
頭銜	头衔	tóuxián
投稿	投稿	tóu gǎo
投機	投机	tóujī
投射	投射	tóushè
投身	投身	tóushēn
投降	投降	tóuxiáng
透徹	透彻	tòuchè
透過	透过	tòuguò
透支	透支	tòuzhī
透氣	透气	tòu qì
凸	凸	tū
凸顯	凸显	tūxiǎn
突發	突发	tūfā
突破口	突破口	tūpòkǒu
禿	秃	tū
突擊	突击	tūjī
圖表	图表	túbiǎo
圖像	图像	túxiàng
突如其來	突如其来	tūrúqílái
圖形	图形	túxíng
圖紙	图纸	túzhǐ
塗	涂	tú
徒步	徒步	túbù
屠殺	屠杀	túshā
土匪	土匪	tǔfěi
土壤	土壤	tǔrǎng
土生土長	土生土长	tǔshēng-tǔzhǎng
團聚	团聚	tuánjù
團伙	团伙	tuánhuǒ
團員	团员	tuányuán
推測	推测	tuīcè
團圓	团圆	tuányuán
推斷	推断	tuīduàn
推翻	推翻	tuī fān
推辭	推辞	tuīcí
推薦	推荐	tuījiàn
推理	推理	tuīlǐ
推敲	推敲	tuīqiāo
推卸	推卸	tuīxiè
推算	推算	tuīsuàn
推選	推选	tuīxuǎn
推移	推移	tuīyí
頹廢	颓废	tuífèi
退回	退回	tuì huí
退卻	退却	tuìquè
退讓	退让	tuìràng
退學	退学	tuì xué
退休金	退休金	tuìxiūjīn
退縮	退缩	tuìsuō
退役	退役	tuì yì
屯	屯	tún
拖累	拖累	tuōlěi
拖欠	拖欠	tuōqiàn
託付	托付	tuōfù
拖延	拖延	tuōyán
脫節	脱节	tuō jié
脫口而出	脱口而出	tuōkǒuérchū
脫身	脱身	tuō shēn
脫落	脱落	tuōluò
脫穎而出	脱颖而出	tuōyǐngérchū
馱	驮	tuó
妥當	妥当	tuǒdang
妥善	妥善	tuǒshàn
妥	妥	tuǒ
妥協	妥协	tuǒxié
拓寬	拓宽	tuòkuān
唾液	唾液	tuòyè
拓展	拓展	tuòzhǎn
挖掘	挖掘	wājué
瓦	瓦	wǎ
挖苦	挖苦	wāku
歪	歪	wāi
歪曲	歪曲	wāiqū
外表	外表	wàibiǎo
外公	外公	wàigōng
外行	外行	wàiháng
外號	外号	wàihào
外籍	外籍	wàijí
外貿	外贸	wàimào
外貌	外貌	wàimào
外企	外企	wàiqǐ
外星人	外星人	wàixīngrén
外形	外形	wàixíng
外婆	外婆	wàipó
丸	丸	wán
完備	完备	wánbèi
外援	外援	wàiyuán
完蛋	完蛋	wán dàn
完畢	完毕	wánbì
完好	完好	wánhǎo
玩耍	玩耍	wánshuǎ
玩意兒	玩意儿	wányìr5
頑固	顽固	wángù
挽回	挽回	wǎn huí
挽	挽	wǎn
挽救	挽救	wǎnjiù
晚間	晚间	wǎnjiān
晚期	晚期	wǎnqī
萬分	万分	wànfēn
惋惜	惋惜	wǎnxī
萬古長青	万古长青	wàngǔ-chángqīng
萬能	万能	wànnéng
晚年	晚年	wǎnnián
萬無一失	万无一失	wànwúyīshī
萬萬	万万	wànwàn
汪洋	汪洋	wāngyáng
亡羊補牢	亡羊补牢	wángyáng-bǔláo
王國	王国	wángguó
網點	网点	wǎngdiǎn
網民	网民	wǎngmín
往常	往常	wǎngcháng
往返	往返	wǎngfǎn
王牌	王牌	wángpái
往事	往事	wǎngshì
妄想	妄想	wàngxiǎng
往日	往日	wǎngrì
忘掉	忘掉	wàng diào
忘不了	忘不了	wàngbùliǎo
旺季	旺季	wàngjì
旺盛	旺盛	wàngshèng
望	望	wàng
旺	旺	wàng
危及	危及	wēijí
望遠鏡	望远镜	wàngyuǎnjìng
危急	危急	wēijí
威風	威风	wēifēng
威懾	威慑	wēishè
威力	威力	wēilì
威信	威信	wēixìn
微不足道	微不足道	wēibùzúdào
微觀	微观	wēiguān
微妙	微妙	wēimiào
微型	微型	wēixíng
微弱	微弱	wēiruò
為人	为人	wéirén
違約	违约	wéi yuē
違章	违章	wéi zhāng
違背	违背	wéibèi
圍牆	围墙	wéiqiáng
唯	唯	wéi
唯獨	唯独	wéidú
偽造	伪造	wěizào
偽裝	伪装	wěizhuāng
尾聲	尾声	wěishēng
尾氣	尾气	wěiqì
緯度	纬度	wěidù
委婉	委婉	wěiwǎn
委屈	委屈	wěiqu
委員	委员	wěiyuán
委員會	委员会	wěiyuánhuì
萎縮	萎缩	wěisuō
未	未	wèi
衛視	卫视	wèishì
未成年人	未成年人	wèichéngniánrén
未經	未经	wèijīng
未免	未免	wèimiǎn
未知數	未知数	wèizhīshù
味精	味精	wèijīng
位子	位子	wèizi
畏懼	畏惧	wèijù
畏縮	畏缩	wèisuō
喂養	喂养	wèiyǎng
慰勞	慰劳	wèiláo
胃口	胃口	wèikou
溫度計	温度计	wēndùjì
溫柔	温柔	wēnróu
溫泉	温泉	wēnquán
溫習	温习	wēnxí
溫室	温室	wēnshì
溫馨	温馨	wēnxīn
文	文	wén
瘟疫	瘟疫	wēnyì
文具	文具	wénjù
文科	文科	wénkē
文憑	文凭	wénpíng
文盲	文盲	wénmáng
文人	文人	wénrén
文獻	文献	wénxiàn
文雅	文雅	wényǎ
聞名	闻名	wénmíng
蚊帳	蚊帐	wénzhàng
文物	文物	wénwù
蚊子	蚊子	wénzi
吻	吻	wěn
吻合	吻合	wěnhé
紊亂	紊乱	wěnluàn
穩固	稳固	wěngù
穩健	稳健	wěnjiàn
穩重	稳重	wěnzhòng
穩妥	稳妥	wěntuǒ
問卷	问卷	wènjuàn
窩	窝	wō
問世	问世	wènshì
臥	卧	wò
污穢	污秽	wūhuì
巫婆	巫婆	wūpó
嗚咽	呜咽	wūyè
無比	无比	wúbǐ
屋頂	屋顶	wūdǐng
無不	无不	wúbù
無償	无偿	wúcháng
無敵	无敌	wúdí
無惡不作	无恶不作	wúè-bùzuò
無非	无非	wúfēi
無辜	无辜	wúgū
無關緊要	无关紧要	wúguān-jǐnyào
無故	无故	wúgù
無話可說	无话可说	wúhuàkěshuō
無家可歸	无家可归	wújiā-kěguī
無濟於事	无济于事	wújì-yúshì
無精打採	无精打采	wújīng-dǎcǎi
無可奉告	无可奉告	wúkě-fènggào
無可厚非	无可厚非	wúkě-hòufēi
無理	无理	wúlǐ
無可奈何	无可奈何	wúkě-nàihé
無力	无力	wúlì
無論如何	无论如何	wúlùnrúhé
無能為力	无能为力	wúnéngwéilì
無情	无情	wúqíng
無情無義	无情无义	wúqíngwúyì
無窮	无穷	wúqióng
無私	无私	wúsī
無所事事	无所事事	wúsuǒshìshì
無所作為	无所作为	wúsuǒzuòwéi
無條件	无条件	wútiáojiàn
無微不至	无微不至	wúwēi-bùzhì
無能	无能	wúnéng
無線	无线	wúxiàn
無線電	无线电	wúxiàndiàn
無形	无形	wúxíng
無形中	无形中	wúxíngzhōng
無須	无须	wúxū
無意	无意	wúyì
無憂無慮	无忧无虑	wúyōu-wúlǜ
無緣	无缘	wúyuán
無足輕重	无足轻重	wúzúqīngzhòng
五花八門	五花八门	wǔhuā-bāmén
無知	无知	wúzhī
五星級	五星级	wǔxīngjí
武力	武力	wǔlì
武裝	武装	wǔzhuāng
捂	捂	wǔ
侮辱	侮辱	wǔrǔ
舞廳	舞厅	wǔtīng
務必	务必	wùbì
務實	务实	wùshí
勿	勿	wù
物證	物证	wùzhèng
物流	物流	wùliú
物體	物体	wùtǐ
誤差	误差	wùchā
誤導	误导	wùdǎo
物資	物资	wùzī
誤區	误区	wùqū
霧	雾	wù
吸納	吸纳	xīnà
吸取	吸取	xīqǔ
息息相關	息息相关	xīxī-xiāngguān
昔日	昔日	xīrì
稀	稀	xī
稀罕	稀罕	xīhan
稀少	稀少	xīshǎo
稀奇	稀奇	xīqí
熙熙攘攘	熙熙攘攘	xīxī-rǎngrǎng
熄火	熄火	xī huǒ
錫	锡	xī
膝蓋	膝盖	xīgài
嬉笑	嬉笑	xīxiào
習俗	习俗	xísú
席	席	xí
席位	席位	xíwèi
襲擊	袭击	xíjī
洗滌劑	洗涤剂	xǐdíjì
媳婦	媳妇	xífù
喜出望外	喜出望外	xǐchūwàngwài
洗禮	洗礼	xǐlǐ
喜好	喜好	xǐhào
喜怒哀樂	喜怒哀乐	xǐ-nù-āi-lè
喜酒	喜酒	xǐjiǔ
喜事	喜事	xǐshì
喜慶	喜庆	xǐqìng
喜洋洋	喜洋洋	xǐyángyáng
喜糖	喜糖	xǐtáng
喜悅	喜悦	xǐyuè
細微	细微	xìwēi
細心	细心	xìxīn
蝦	虾	xiā
細膩	细腻	xìnì
俠義	侠义	xiáyì
瞎	瞎	xiā
峽谷	峡谷	xiágǔ
狹隘	狭隘	xiáài
狹小	狭小	xiáxiǎo
狹窄	狭窄	xiázhǎi
下跌	下跌	xiàdiē
下場	下场	xiàchang
下崗	下岗	xià gǎng
下功夫	下功夫	xià gōngfu
下海	下海	xià hǎi
下決心	下决心	xià juéxīn
下令	下令	xià lìng
下級	下级	xiàjí
下落	下落	xiàluò
下棋	下棋	xià qí
下山	下山	xià shān
下手	下手	xià shǒu
下期	下期	xiàqī
下屬	下属	xiàshǔ
下臺	下台	xià tái
下調	下调	xiàdiào
下旬	下旬	xiàxún
下鄉	下乡	xià xiāng
下一代	下一代	xiàyīdài
下游	下游	xiàyóu
下意識	下意识	xiàyìshi
下墜	下坠	xiàzhuì
嚇唬	吓唬	xiàhu
嚇人	吓人	xià rén
夏令營	夏令营	xiàlìngyíng
仙鶴	仙鹤	xiānhè
仙女	仙女	xiānnǚ
先天	先天	xiāntiān
先例	先例	xiānlì
纖維	纤维	xiānwéi
掀	掀	xiān
掀起	掀起	xiānqǐ
鮮活	鲜活	xiānhuó
鮮美	鲜美	xiānměi
鮮血	鲜血	xiānxuè
弦	弦	xián
銜接	衔接	xiánjiē
嫌棄	嫌弃	xiánqì
顯而易見	显而易见	xiǎnéryìjiàn
嫌疑	嫌疑	xiányí
顯赫	显赫	xiǎnhè
顯示器	显示器	xiǎnshìqì
顯現	显现	xiǎnxiàn
現成	现成	xiànchéng
顯眼	显眼	xiǎnyǎn
現任	现任	xiànrèn
現行	现行	xiànxíng
限定	限定	xiàndìng
限	限	xiàn
限度	限度	xiàndù
線條	线条	xiàntiáo
憲法	宪法	xiànfǎ
陷	陷	xiàn
限於	限于	xiànyú
陷阱	陷阱	xiànjǐng
餡兒	馅儿	xiànr5
羨慕	羡慕	xiànmù
獻血	献血	xiàn xiě
腺	腺	xiàn
鄉親	乡亲	xiāngqīn
鄉下	乡下	xiāngxia
相伴	相伴	xiāngbàn
相比之下	相比之下	xiāngbǐzhīxià
相傳	相传	xiāngchuán
相差	相差	xiāngchà
相當於	相当于	xiāngdāngyú
相對而言	相对而言	xiāngduì éryán
相對	相对	xiāngduì
相輔相成	相辅相成	xiāngfǔ-xiāngchéng
相連	相连	xiānglián
相繼	相继	xiāngjì
相識	相识	xiāngshí
相提並論	相提并论	xiāngtí-bìnglùn
相依為命	相依为命	xiāngyī-wéimìng
相通	相通	xiāngtōng
相約	相约	xiāngyuē
香料	香料	xiāngliào
香水	香水	xiāngshuǐ
相遇	相遇	xiāngyù
香味	香味	xiāngwèi
香煙	香烟	xiāngyān
香油	香油	xiāngyóu
鑲	镶	xiāng
鑲嵌	镶嵌	xiāngqiàn
享	享	xiǎng
詳盡	详尽	xiángjìn
享有	享有	xiǎngyǒu
響亮	响亮	xiǎngliàng
祥和	祥和	xiánghé
響應	响应	xiǎngyìng
響起	响起	xiǎngqǐ
想方設法	想方设法	xiǎngfāng-shèfǎ
向來	向来	xiànglái
嚮往	向往	xiàngwǎng
項鏈	项链	xiàngliàn
像	像	xiàng
向著	向着	xiàngzhe
像樣	像样	xiàngyàng
橡皮	橡皮	xiàngpí
橡膠	橡胶	xiàngjiāo
消	消	xiāo
消沉	消沉	xiāochén
削	削	xuē
消遣	消遣	xiāoqiǎn
蕭條	萧条	xiāotiáo
銷	销	xiāo
銷毀	销毁	xiāohuǐ
銷量	销量	xiāoliàng
瀟灑	潇洒	xiāosǎ
小醜	小丑	xiǎochǒu
小販	小贩	xiǎofàn
小看	小看	xiǎokàn
小康	小康	xiǎokāng
小路	小路	xiǎolù
小品	小品	xiǎopǐn
小氣	小气	xiǎoqi
小區	小区	xiǎoqū
小曲	小曲	xiǎoqǔ
小人	小人	xiǎorén
小溪	小溪	xiǎoxī
小提琴	小提琴	xiǎotíqín
小心翼翼	小心翼翼	xiǎoxīn-yìyì
孝敬	孝敬	xiàojìng
小卒	小卒	xiǎozú
孝順	孝顺	xiàoshun
效仿	效仿	xiàofǎng
肖像	肖像	xiàoxiàng
效益	效益	xiàoyì
效應	效应	xiàoyìng
協定	协定	xiédìng
效力	效力	xiàolì
協同	协同	xiétóng
邪	邪	xié
協作	协作	xiézuò
邪惡	邪恶	xiéè
挾持	挟持	xiéchí
攜帶	携带	xiédài
攜手	携手	xié shǒu
寫照	写照	xiězhào
泄	泄	xiè
泄露	泄露	xièlù
泄密	泄密	xiè mì
泄氣	泄气	xièqì
泄漏	泄漏	xièlòu
瀉	泻	xiè
心愛	心爱	xīnài
心安理得	心安理得	xīnān-lǐdé
心病	心病	xīnbìng
心腸	心肠	xīncháng
卸	卸	xiè
心得	心得	xīndé
心急如焚	心急如焚	xīnjí-rúfén
心慌	心慌	xīn huāng
心裡話	心里话	xīnlihuà
心靈手巧	心灵手巧	xīnlíngshǒuqiǎo
心目	心目	xīnmù
心聲	心声	xīnshēng
心思	心思	xīnsi
心事	心事	xīnshi
心酸	心酸	xīn suān
心胸	心胸	xīnxiōng
心想事成	心想事成	xīnxiǎng-shìchéng
心眼兒	心眼儿	xīnyǎnr5
心血	心血	xīnxuè
心意	心意	xīnyì
芯片	芯片	xīnpiàn
辛酸	辛酸	xīnsuān
欣慰	欣慰	xīnwèi
辛勤	辛勤	xīnqín
欣欣向榮	欣欣向荣	xīnxīn-xiàngróng
新潮	新潮	xīncháo
欣喜	欣喜	xīnxǐ
新陳代謝	新陈代谢	xīnchén-dàixiè
新款	新款	xīnkuǎn
新房	新房	xīnfáng
新奇	新奇	xīnqí
新生	新生	xīnshēng
新手	新手	xīnshǒu
新穎	新颖	xīnyǐng
新式	新式	xīnshì
信貸	信贷	xìndài
信件	信件	xìnjiàn
信譽	信誉	xìnyù
信賴	信赖	xìnlài
興建	兴建	xīngjiàn
興奮劑	兴奋剂	xīngfènjì
興起	兴起	xīngqǐ
猩猩	猩猩	xīngxing
星座	星座	xīngzuò
腥	腥	xīng
刑法	刑法	xíngfa
行使	行使	xíngshǐ
行政	行政	xíngzhèng
行走	行走	xíngzǒu
形形色色	形形色色	xíngxíng-sèsè
形影不離	形影不离	xíngyǐng-bùlí
醒來	醒来	xǐnglái
醒悟	醒悟	xǐngwù
興高采烈	兴高采烈	xìnggāo-cǎiliè
醒目	醒目	xǐngmù
興致	兴致	xìngzhì
幸存	幸存	xìngcún
幸好	幸好	xìnghǎo
幸虧	幸亏	xìngkuī
幸免	幸免	xìngmiǎn
性價比	性价比	xìngjiàbǐ
性情	性情	xìngqíng
性命	性命	xìngmìng
姓氏	姓氏	xìngshì
凶殘	凶残	xiōngcán
凶惡	凶恶	xiōngè
凶猛	凶猛	xiōngměng
洶涌	汹涌	xiōngyǒng
胸膛	胸膛	xiōngtáng
凶狠	凶狠	xiōnghěn
胸有成竹	胸有成竹	xiōngyǒuchéngzhú
雄厚	雄厚	xiónghòu
休克	休克	xiūkè
休眠	休眠	xiūmián
休想	休想	xiūxiǎng
休養	休养	xiūyǎng
修補	修补	xiūbǔ
修長	修长	xiūcháng
修正	修正	xiūzhèng
羞愧	羞愧	xiūkuì
修訂	修订	xiūdìng
秀麗	秀丽	xiùlì
修路	修路	xiūlù
秀美	秀美	xiùměi
袖手旁觀	袖手旁观	xiùshǒu-pángguān
鏽	锈	xiù
嗅覺	嗅觉	xiùjué
繡	绣	xiù
須	须	xū
虛	虚	xū
虛構	虚构	xūgòu
虛幻	虚幻	xūhuàn
虛擬	虚拟	xūnǐ
虛假	虚假	xūjiǎ
虛弱	虚弱	xūruò
虛偽	虚伪	xūwěi
徐徐	徐徐	xúxú
許	许	xǔ
需	需	xū
許可證	许可证	xǔkězhèng
旭日	旭日	xùrì
序	序	xù
序幕	序幕	xùmù
敘述	叙述	xùshù
酗酒	酗酒	xùjiǔ
宣稱	宣称	xuānchēng
續	续	xù
絮叨	絮叨	xùdao
宣讀	宣读	xuāndú
宣告	宣告	xuāngào
宣誓	宣誓	xuān shì
宣言	宣言	xuānyán
宣泄	宣泄	xuānxiè
宣揚	宣扬	xuānyáng
喧嘩	喧哗	xuānhuá
喧鬧	喧闹	xuānnào
玄	玄	xuán
玄機	玄机	xuánjī
懸掛	悬挂	xuánguà
懸念	悬念	xuánniàn
懸殊	悬殊	xuánshū
懸崖	悬崖	xuányá
旋律	旋律	xuánlǜ
選民	选民	xuǎnmín
選項	选项	xuǎnxiàng
旋渦	旋涡	xuánwō
選用	选用	xuǎnyòng
炫耀	炫耀	xuànyào
削弱	削弱	xuēruò
靴子	靴子	xuēzi
穴位	穴位	xuéwèi
學歷	学历	xuélì
學士	学士	xuéshì
學說	学说	xuéshuō
學堂	学堂	xuétáng
學藝	学艺	xuéyì
學業	学业	xuéyè
學子	学子	xuézǐ
雪山	雪山	xuěshān
雪上加霜	雪上加霜	xuěshàng-jiāshuāng
血脈	血脉	xuèmài
血栓	血栓	xuèshuān
血壓	血压	xuèyā
血緣	血缘	xuèyuán
勛章	勋章	xūnzhāng
薰陶	熏陶	xūntáo
熏	熏	xūn
尋	寻	xún
尋覓	寻觅	xúnmì
尋常	寻常	xúncháng
巡邏	巡逻	xúnluó
循序漸進	循序渐进	xúnxù-jiànjìn
馴	驯	xùn
遜色	逊色	xùnsè
丫頭	丫头	yātou
訓	训	xùn
壓倒	压倒	yā dǎo
壓抑	压抑	yāyì
壓縮	压缩	yāsuō
壓制	压制	yāzhì
押	押	yā
鴉雀無聲	鸦雀无声	yāquè-wúshēng
牙齒	牙齿	yáchǐ
牙膏	牙膏	yágāo
啞	哑	yǎ
咽喉	咽喉	yānhóu
芽	芽	yá
煙囪	烟囱	yāncōng
煙火	烟火	yānhuo
淹	淹	yān
延	延	yán
延緩	延缓	yánhuǎn
延誤	延误	yánwù
嚴謹	严谨	yánjǐn
嚴禁	严禁	yánjìn
嚴峻	严峻	yánjùn
言辭	言辞	yáncí
嚴密	严密	yánmì
言論	言论	yánlùn
言行	言行	yánxíng
岩石	岩石	yánshí
炎癥	炎症	yánzhèng
炎熱	炎热	yánrè
沿途	沿途	yántú
沿線	沿线	yánxiàn
沿岸	沿岸	yánàn
閻王	阎王	Yánwang
研討	研讨	yántǎo
衍生	衍生	yǎnshēng
掩蓋	掩盖	yǎngài
掩護	掩护	yǎnhù
掩飾	掩饰	yǎnshì
眼紅	眼红	yǎnhóng
眼色	眼色	yǎnsè
眼界	眼界	yǎnjiè
眼神	眼神	yǎnshén
眼下	眼下	yǎnxià
演變	演变	yǎnbiàn
演播室	演播室	yǎnbōshì
演練	演练	yǎnliàn
演技	演技	yǎnjì
演示	演示	yǎnshì
演說	演说	yǎnshuō
演習	演习	yǎnxí
演戲	演戏	yǎn xì
演藝圈	演艺圈	yǎnyìquān
演繹	演绎	yǎnyì
厭煩	厌烦	yànfán
厭倦	厌倦	yànjuàn
咽	咽	yàn
艷麗	艳丽	yànlì
驗收	验收	yànshōu
驗	验	yàn
驗證	验证	yànzhèng
燕子	燕子	yànzi
焰火	焰火	yànhuǒ
秧歌	秧歌	yāngge
陽性	阳性	yángxìng
揚	扬	yáng
楊樹	杨树	yángshù
洋溢	洋溢	yángyì
養老金	养老金	yǎnglǎojīn
養老院	养老院	yǎnglǎoyuàn
養活	养活	yǎnghuo
養生	养生	yǎngshēng
氧	氧	yǎng
養殖	养殖	yǎngzhí
癢	痒	yǎng
樣本	样本	yàngběn
樣品	样品	yàngpǐn
妖怪	妖怪	yāoguài
邀	邀	yāo
謠言	谣言	yáoyán
窯	窑	yáo
搖擺	摇摆	yáobǎi
搖滾	摇滚	yáogǔn
搖晃	摇晃	yáohuang
搖搖欲墜	摇摇欲坠	yáoyáo-yùzhuì
搖籃	摇篮	yáolán
遙控	遥控	yáokòng
遙遠	遥远	yáoyuǎn
藥材	药材	yàocái
藥方	药方	yàofāng
要不是	要不是	yàobushi
要不	要不	yàobù
要點	要点	yàodiǎn
要害	要害	yàohài
要緊	要紧	yàojǐn
要領	要领	yàolǐng
要強	要强	yàoqiáng
鑰匙	钥匙	yàoshi
要命	要命	yàomìng
耀眼	耀眼	yàoyǎn
椰子	椰子	yēzi
也就是說	也就是说	yějiùshìshuō
野炊	野炊	yěchuī
野餐	野餐	yěcān
野蠻	野蛮	yěmán
野獸	野兽	yěshòu
野外	野外	yěwài
野心	野心	yěxīn
野營	野营	yěyíng
業	业	yè
夜班	夜班	yèbān
業績	业绩	yèjì
夜市	夜市	yèshì
夜校	夜校	yèxiào
夜晚	夜晚	yèwǎn
夜以繼日	夜以继日	yèyǐjìrì
夜總會	夜总会	yèzǒnghuì
液晶	液晶	yèjīng
一把手	一把手	yībǎshǒu
液體	液体	yètǐ
一線	一线	yīxiàn
一一	一一	yīyī
伊斯蘭教	伊斯兰教	Yīsīlánjiào
衣食住行	衣食住行	yī-shí-zhù-xíng
依	依	yī
醫務	医务	yīwù
依託	依托	yītuō
依依不捨	依依不舍	yīyī-bùshě
一不小心	一不小心	yībùxiǎoxīn
一剎那	一刹那	yīchànà
一動不動	一动不动	yīdòngbùdòng
一度	一度	yīdù
一大早	一大早	yīdàzǎo
一概	一概	yīgài
一概而論	一概而论	yīgàiérlùn
一個勁兒	一个劲儿	yīgejìnr5
一技之長	一技之长	yījìzhīcháng
一面	一面	yīmiàn
一晃	一晃	yīhuǎng
一目了然	一目了然	yīmù-liǎorán
一事無成	一事无成	yīshì-wúchéng
一瞬間	一瞬间	yīshùnjiān
一味	一味	yīwèi
一系列	一系列	yīxìliè
一陣	一阵	yīzhèn
儀表	仪表	yíbiǎo
怡然自得	怡然自得	yírán-zìdé
移交	移交	yíjiāo
移植	移植	yízhí
姨	姨	yí
遺留	遗留	yíliú
遺棄	遗弃	yíqì
遺忘	遗忘	yíwàng
遺物	遗物	yíwù
遺體	遗体	yítǐ
遺囑	遗嘱	yízhǔ
遺願	遗愿	yíyuàn
疑點	疑点	yídiǎn
遺址	遗址	yízhǐ
疑惑	疑惑	yíhuò
疑慮	疑虑	yílǜ
以	以	yǐ
以身作則	以身作则	yǐshēn-zuòzé
以免	以免	yǐmiǎn
以至於	以至于	yǐzhìyú
矣	矣	yǐ
以致	以致	yǐzhì
倚	倚	yǐ
一成不變	一成不变	yīchéng-bùbiàn
一長一短	一长一短	yī cháng yī duǎn
一籌莫展	一筹莫展	yīchóu-mòzhǎn
一帆風順	一帆风顺	yīfān-fēngshùn
一乾二淨	一干二净	yīgān-èrjìng
一鼓作氣	一鼓作气	yīgǔ-zuòqì
一鍋粥	一锅粥	yīguōzhōu
一回事	一回事	yīhuíshì
一家人	一家人	yījiārén
一舉	一举	yījǔ
一經	一经	yījīng
一舉一動	一举一动	yījǔ-yīdòng
一卡通	一卡通	yīkǎtōng
一攬子	一揽子	yīlǎnzi
一連	一连	yīlián
一連串	一连串	yīliánchuàn
一毛不拔	一毛不拔	yīmáo-bùbá
一年到頭	一年到头	yīnián-dàotóu
一如既往	一如既往	yīrú-jìwǎng
一旁	一旁	yīpáng
一聲不吭	一声不吭	yīshēngbùkēng
一塌糊塗	一塌糊涂	yītāhútú
一體	一体	yītǐ
一手	一手	yīshǒu
一天到晚	一天到晚	yītiān-dàowǎn
一頭	一头	yītóu
一無所有	一无所有	yīwú-suǒyǒu
一無所知	一无所知	yīwú-suǒzhī
一心	一心	yīxīn
一心一意	一心一意	yīxīn-yīyì
一言不發	一言不发	yīyán-bùfā
一言一行	一言一行	yīyán-yìxíng
一應俱全	一应俱全	yīyīng-jùquán
一早	一早	yīzǎo
一眼	一眼	yīyǎn
義工	义工	yìgōng
議程	议程	yìchéng
議會	议会	yìhuì
議	议	yì
議員	议员	yìyuán
屹立	屹立	yìlì
亦	亦	yì
異想天開	异想天开	yìxiǎng-tiānkāi
異性	异性	yìxìng
異議	异议	yìyì
異口同聲	异口同声	yìkǒu-tóngshēng
抑鬱	抑郁	yìyù
抑揚頓挫	抑扬顿挫	yìyáng-dùncuò
抑制	抑制	yìzhì
抑鬱症	抑郁症	yìyùzhèng
譯	译	yì
疫苗	疫苗	yìmiáo
易拉罐	易拉罐	yìlāguàn
意料	意料	yìliào
意料之外	意料之外	yìliàozhīwài
意圖	意图	yìtú
意向	意向	yìxiàng
益處	益处	yìchu
溢	溢	yì
毅然	毅然	yìrán
毅力	毅力	yìlì
陰暗	阴暗	yīnàn
因人而異	因人而异	yīnrénéryì
音響	音响	yīnxiǎng
陰性	阴性	yīnxìng
殷勤	殷勤	yīnqín
銀幕	银幕	yínmù
引發	引发	yǐnfā
引經據典	引经据典	yǐnjīng-jùdiǎn
引擎	引擎	yǐnqíng
引人入勝	引人入胜	yǐnrén-rùshèng
引領	引领	yǐnlǐng
引入	引入	yǐnrù
引人注目	引人注目	yǐnrén-zhùmù
引誘	引诱	yǐnyòu
引用	引用	yǐnyòng
飲水	饮水	yǐnshuǐ
飲用水	饮用水	yǐnyòngshuǐ
隱蔽	隐蔽	yǐnbì
隱患	隐患	yǐnhuàn
隱情	隐情	yǐnqíng
隱瞞	隐瞒	yǐnmán
隱身	隐身	yǐnshēn
隱形	隐形	yǐnxíng
隱性	隐性	yǐnxìng
隱約	隐约	yǐnyuē
癮	瘾	yǐn
印章	印章	yìnzhāng
印刷術	印刷术	yìnshuāshù
印證	印证	yìnzhèng
應有盡有	应有尽有	yīngyǒu-jìnyǒu
英俊	英俊	yīngjùn
英鎊	英镑	yīngbàng
嬰兒	婴儿	yīngér
鷹	鹰	yīng
迎合	迎合	yínghé
迎	迎	yíng
熒光	荧光	yíngguāng
盈利	盈利	yínglì
營救	营救	yíngjiù
贏家	赢家	yíngjia
營造	营造	yíngzào
影像	影像	yǐngxiàng
應酬	应酬	yìngchou
應付	应付	yīngfù
應聘	应聘	yìngpìn
應邀	应邀	yìngyāo
硬幣	硬币	yìngbì
映	映	yìng
硬盤	硬盘	yìngpán
擁護	拥护	yōnghù
擁擠	拥挤	yōngjǐ
庸俗	庸俗	yōngsú
硬朗	硬朗	yìnglang
永恆	永恒	yǒnghéng
永久	永久	yǒngjiǔ
永不	永不	yǒngbù
勇往直前	勇往直前	yǒngwǎng-zhíqián
勇於	勇于	yǒngyú
涌	涌	yǒng
湧入	涌入	yǒngrù
涌現	涌现	yǒngxiàn
用餐	用餐	yòng cān
踴躍	踊跃	yǒngyuè
用人	用人	yòngren
用力	用力	yòng lì
用功	用功	yònggōng
優	优	yōu
用意	用意	yòngyì
優化	优化	yōuhuà
優異	优异	yōuyì
優越	优越	yōuyuè
優雅	优雅	yōuyǎ
憂愁	忧愁	yōuchóu
憂慮	忧虑	yōulǜ
悠久	悠久	yōujiǔ
憂鬱	忧郁	yōuyù
悠閒	悠闲	yōuxián
尤為	尤为	yóuwéi
由此看來	由此看来	yóucǐkànlái
由來	由来	yóulái
由此可見	由此可见	yóucǐ-kějiàn
郵編	邮编	yóubiān
由衷	由衷	yóuzhōng
郵政	邮政	yóuzhèng
猶豫不決	犹豫不决	yóuyù-bùjué
猶如	犹如	yóurú
油畫	油画	yóuhuà
遊船	游船	yóuchuán
遊覽	游览	yóulǎn
友情	友情	yǒuqíng
友人	友人	yǒurén
友善	友善	yǒushàn
有待	有待	yǒudài
有的放矢	有的放矢	yǒudì-fàngshǐ
有機	有机	yǒujī
有口無心	有口无心	yǒukǒu-wúxīn
有聲有色	有声有色	yǒushēng-yǒusè
有兩下子	有两下子	yǒu liǎngxiàzi
有所不同	有所不同	yǒusuǒbùtóng
有所	有所	yǒusuǒ
有望	有望	yǒuwàng
有效期	有效期	yǒuxiàoqī
有幸	有幸	yǒuxìng
有序	有序	yǒuxù
有益	有益	yǒuyì
有意	有意	yǒuyì
有朝一日	有朝一日	yǒuzhāo-yīrì
幼稚	幼稚	yòuzhì
有助於	有助于	yǒuzhùyú
誘餌	诱饵	yòuěr
誘惑	诱惑	yòuhuò
誘發	诱发	yòufā
誘人	诱人	yòurén
餘地	余地	yúdì
餘額	余额	yúé
余	余	yú
漁船	渔船	yúchuán
漁民	渔民	yúmín
逾期	逾期	yú qī
愚蠢	愚蠢	yúchǔn
愚公移山	愚公移山	Yúgōng-yíshān
輿論	舆论	yúlùn
與此同時	与此同时	yǔcǐtóngshí
與其	与其	yǔqí
與否	与否	yǔfǒu
與眾不同	与众不同	yǔzhòng-bùtóng
與日俱增	与日俱增	yǔrì-jùzēng
與時俱進	与时俱进	yǔshí-jùjìn
宇宙	宇宙	yǔzhòu
予以	予以	yǔyǐ
浴室	浴室	yùshì
預定	预定	yùdìng
預感	预感	yùgǎn
語氣	语气	yǔqì
預告	预告	yùgào
預見	预见	yùjiàn
預料	预料	yùliào
預示	预示	yùshì
預賽	预赛	yùsài
預售	预售	yùshòu
預算	预算	yùsuàn
預先	预先	yùxiān
預言	预言	yùyán
慾望	欲望	yùwàng
遇難	遇难	yù nàn
遇險	遇险	yù xiǎn
寓言	寓言	yùyán
預兆	预兆	yùzhào
遇上	遇上	yùshàng
寓意	寓意	yùyì
愈來愈	愈来愈	yùláiyù
愈演愈烈	愈演愈烈	yùyǎn-yùliè
癒合	愈合	yùhé
淵源	渊源	yuānyuán
冤	冤	yuān
元老	元老	yuánlǎo
元首	元首	yuánshǒu
元宵節	元宵节	Yuánxiāojié
原本	原本	yuánběn
冤枉	冤枉	yuānwang
原材料	原材料	yuáncáiliào
原地	原地	yuándì
原創	原创	yuánchuàng
原型	原型	yuánxíng
原裝	原装	yuánzhuāng
原汁原味	原汁原味	yuánzhī-yuánwèi
圓形	圆形	yuánxíng
緣分	缘分	yuánfen
源泉	源泉	yuánquán
源於	源于	yuányú
源頭	源头	yuántóu
源源不斷	源源不断	yuányuánbùduàn
遠程	远程	yuǎnchéng
遠見	远见	yuǎnjiàn
遠近聞名	远近闻名	yuǎnjìnwénmíng
怨恨	怨恨	yuànhèn
怨言	怨言	yuànyán
怨氣	怨气	yuànqì
院士	院士	yuànshì
約定俗成	约定俗成	yuēdìng-súchéng
月初	月初	yuèchū
曰	曰	yuē
月票	月票	yuèpiào
樂器	乐器	yuèqì
岳父	岳父	yuèfù
岳母	岳母	yuèmǔ
悅耳	悦耳	yuèěr
越發	越发	yuèfā
閱歷	阅历	yuèlì
越過	越过	yuè guò
暈倒	晕倒	yūndǎo
孕婦	孕妇	yùnfù
隕石	陨石	yǔnshí
孕育	孕育	yùnyù
運送	运送	yùnsòng
運河	运河	yùnhé
運營	运营	yùnyíng
運轉	运转	yùnzhuǎn
韻味	韵味	yùnwèi
醞釀	酝酿	yùnniàng
蘊涵	蕴涵	yùnhán
蘊藏	蕴藏	yùncáng
雜亂無章	杂乱无章	záluàn-wúzhāng
雜技	杂技	zájì
雜交	杂交	zájiāo
砸	砸	zá
栽	栽	zāi
栽培	栽培	zāipéi
再度	再度	zàidù
宰	宰	zǎi
再現	再现	zàixiàn
在線	在线	zàixiàn
在意	在意	zài yì
載體	载体	zàitǐ
在職	在职	zàizhí
暫	暂	zàn
攢	攒	zǎn
贊不絕口	赞不绝口	zànbùjuékǒu
贊嘆	赞叹	zàntàn
贊嘆不已	赞叹不已	Zàntànbùyǐ
贊同	赞同	zàntóng
贊許	赞许	zànxǔ
贊美	赞美	zànměi
贊揚	赞扬	zànyáng
葬禮	葬礼	zànglǐ
遭殃	遭殃	zāo yāng
鑿	凿	záo
葬	葬	zàng
早日	早日	zǎorì
早年	早年	zǎonián
棗	枣	zǎo
造假	造假	zàojiǎ
造價	造价	zàojià
造福	造福	zàofú
造就	造就	zàojiù
噪聲	噪声	zàoshēng
造紙術	造纸术	zàozhǐshù
則	则	zé
噪音	噪音	zàoyīn
責備	责备	zébèi
責怪	责怪	zéguài
增收	增收	zēngshōu
賊	贼	zéi
扎根	扎根	zhā gēn
增添	增添	zēngtiān
閘	闸	zhá
渣子	渣子	zhāzi
眨眼	眨眼	zhǎ yǎn
炸	炸	zhà
詐騙	诈骗	zhàpiàn
榨	榨	zhà
窄	窄	zhǎi
債務	债务	zhàiwù
沾	沾	zhān
占卜	占卜	zhānbǔ
沾光	沾光	zhān guāng
瞻仰	瞻仰	zhānyǎng
粘	粘	zhān
斬	斩	zhǎn
斬草除根	斩草除根	zhǎncǎo-chúgēn
展出	展出	zhǎnchū
盞	盏	zhǎn
展覽會	展览会	zhǎnlǎnhuì
展望	展望	zhǎnwàng
占用	占用	zhànyòng
嶄新	崭新	zhǎnxīn
站立	站立	zhànlì
綻放	绽放	zhànfàng
張燈結彩	张灯结彩	zhāngdēng-jiécǎi
蘸	蘸	zhàn
張貼	张贴	zhāngtiē
張揚	张扬	zhāngyáng
長相	长相	zhǎngxiàng
掌管	掌管	zhǎngguǎn
帳篷	帐篷	zhàngpeng
長輩	长辈	zhǎngbèi
帳子	帐子	zhàngzi
賬單	账单	zhàngdān
脹	胀	zhàng
賬號	账号	zhànghào
招標	招标	zhāo biāo
招待	招待	zhāodài
招待會	招待会	zhāodàihuì
招募	招募	zhāomù
招攬	招揽	zhāolǎn
招牌	招牌	zhāopai
朝氣蓬勃	朝气蓬勃	zhāoqì-péngbó
招數	招数	zhāoshù
朝三暮四	朝三暮四	zhāosān-mùsì
朝夕相處	朝夕相处	zhāoxīxiāngchǔ
招收	招收	zhāoshōu
著迷	着迷	zháo mí
沼澤	沼泽	zhǎozé
兆頭	兆头	zhàotou
召集	召集	zhàojí
照辦	照办	zhào bàn
照常	照常	zhàocháng
照例	照例	zhàolì
照料	照料	zhàoliào
罩	罩	zhào
照明	照明	zhàomíng
肇事	肇事	zhàoshì
折騰	折腾	zhēteng
遮	遮	zhē
遮蓋	遮盖	zhēgài
折合	折合	zhéhé
折疊	折叠	zhédié
折磨	折磨	zhémo
折扣	折扣	zhékòu
折射	折射	zhéshè
這會兒	这会儿	zhèhuìr5
這樣一來	这样一来	zhèyàngyīlái
針鋒相對	针锋相对	zhēnfēng-xiāngduì
偵察	侦察	zhēnchá
針灸	针灸	zhēnjiǔ
珍藏	珍藏	zhēncáng
珍重	珍重	zhēnzhòng
珍視	珍视	zhēnshì
真空	真空	zhēnkōng
真假	真假	zhēnjiǎ
真情	真情	zhēnqíng
真心	真心	zhēnxīn
真是的	真是的	zhēnshide
診所	诊所	zhěnsuǒ
真摯	真挚	zhēnzhì
枕頭	枕头	zhěntou
陣營	阵营	zhènyíng
陣容	阵容	zhènróng
振興	振兴	zhènxīng
振作	振作	zhènzuò
振奮	振奋	zhènfèn
震動	震动	zhèndòng
震	震	zhèn
震撼	震撼	zhènhàn
鎮定	镇定	zhèndìng
爭吵	争吵	zhēngchǎo
爭端	争端	zhēngduān
爭分奪秒	争分夺秒	zhēngfēn-duómiǎo
爭光	争光	zhēng guāng
爭氣	争气	zhēng qì
爭先恐後	争先恐后	zhēngxiān-kǒnghòu
征	征	zhēng
爭執	争执	zhēngzhí
徵收	征收	zhēngshōu
徵集	征集	zhēngjí
癥結	症结	zhēngjié
睜	睁	zhēng
掙扎	挣扎	zhēngzhá
拯救	拯救	zhěngjiù
蒸	蒸	zhēng
整合	整合	zhěnghé
整潔	整洁	zhěngjié
正面	正面	zhèngmiàn
正能量	正能量	zhèngnéngliàng
正視	正视	zhèngshì
正直	正直	zhèngzhí
正宗	正宗	zhèngzōng
整數	整数	zhěngshù
鄭重	郑重	zhèngzhòng
之	之	zhī
證人	证人	zhèngren
支票	支票	zhīpiào
之所以	之所以	zhīsuǒyǐ
汁	汁	zhī
支柱	支柱	zhīzhù
芝麻	芝麻	zhīma
芝士	芝士	zhīshì
知覺	知觉	zhījué
知己	知己	zhījǐ
知識分子	知识分子	zhīshifènzǐ
知足	知足	zhīzú
脂肪	脂肪	zhīfáng
肢體	肢体	zhītǐ
執意	执意	zhíyì
執照	执照	zhízhào
執法	执法	zhífǎ
執著	执着	zhízhuó
直奔	直奔	zhíbèn
直觀	直观	zhíguān
直達	直达	zhídá
直徑	直径	zhíjìng
直視	直视	zhíshì
直覺	直觉	zhíjué
值錢	值钱	zhíqián
職權	职权	zhíquán
直至	直至	zhízhì
職業病	职业病	zhíyèbìng
止步	止步	zhǐ bù
職員	职员	zhíyuán
止血	止血	zhǐxuè
止咳	止咳	zhǐké
旨在	旨在	zhǐzài
指點	指点	zhǐdiǎn
指令	指令	zhǐlìng
指教	指教	zhǐjiào
指南針	指南针	zhǐnánzhēn
指手畫腳	指手画脚	zhǐshǒu-huàjiǎo
指望	指望	zhǐwang
指南	指南	zhǐnán
指向	指向	zhǐxiàng
指引	指引	zhǐyǐn
至此	至此	zhìcǐ
至關重要	至关重要	zhìguānzhòngyào
製	制	zhì
志氣	志气	zhìqi
制服	制服	zhìfú
制裁	制裁	zhìcái
制止	制止	zhìzhǐ
製品	制品	zhìpǐn
質地	质地	zhìdì
質問	质问	zhìwèn
質樸	质朴	zhìpǔ
質疑	质疑	zhìyí
治學	治学	zhìxué
治癒	治愈	zhìyù
致敬	致敬	zhìjìng
致	致	zhì
致辭	致辞	zhì cí
致力於	致力于	zhìlìyú
致富	致富	zhìfù
致命	致命	zhìmìng
致使	致使	zhìshǐ
窒息	窒息	zhìxī
秩序	秩序	zhìxù
智商	智商	zhìshāng
滯後	滞后	zhìhòu
滯留	滞留	zhìliú
置	置	zhì
中國畫	中国画	Zhōngguóhuà
中途	中途	zhōngtú
中立	中立	zhōnglì
中型	中型	zhōngxíng
中性	中性	zhōngxìng
中旬	中旬	zhōngxún
中庸	中庸	zhōngyōng
忠誠	忠诚	zhōngchéng
忠實	忠实	zhōngshí
中止	中止	zhōngzhǐ
忠於	忠于	zhōngyú
終結	终结	zhōngjié
忠貞	忠贞	zhōngzhēn
終生	终生	zhōngshēng
終究	终究	zhōngjiū
腫瘤	肿瘤	zhǒngliú
衷心	衷心	zhōngxīn
種族	种族	zhǒngzú
仲裁	仲裁	zhòngcái
眾所週知	众所周知	zhòngsuǒzhōuzhī
眾志成城	众志成城	zhòngzhì-chéngchéng
眾人	众人	zhòngrén
重創	重创	zhòngchuāng
重量級	重量级	zhòngliàngjí
重傷	重伤	zhòngshāng
重任	重任	zhòngrèn
重型	重型	zhòngxíng
重中之重	重中之重	zhòngzhōngzhīzhòng
周邊	周边	zhōubiān
週到	周到	zhōudào
重心	重心	zhòngxīn
周旋	周旋	zhōuxuán
周密	周密	zhōumì
晝夜	昼夜	zhòuyè
驟然	骤然	zhòurán
皺	皱	zhòu
朱紅	朱红	zhūhóng
株	株	zhū
諸多	诸多	zhūduō
諸如此類	诸如此类	zhūrúcǐlèi
逐年	逐年	zhúnián
主	主	zhǔ
竹竿	竹竿	zhúgān
主婦	主妇	zhǔfù
主編	主编	zhǔbiān
主力	主力	zhǔlì
主人公	主人公	zhǔréngōng
主食	主食	zhǔshí
主題歌	主题歌	zhǔtígē
主權	主权	zhǔquán
主頁	主页	zhǔyè
主義	主义	zhǔyì
主宰	主宰	zhǔzǎi
主演	主演	zhǔyǎn
拄	拄	zhǔ
囑咐	嘱咐	zhǔfu
矚目	瞩目	zhǔmù
助威	助威	zhù wēi
住戶	住户	zhùhù
住處	住处	zhùchu
住址	住址	zhùzhǐ
貯藏	贮藏	zhùcáng
注	注	zhù
住宿	住宿	zhùsù
註定	注定	zhùdìng
鑄造	铸造	zhùzào
築	筑	zhù
注入	注入	zhùrù
拽	拽	yè
爪子	爪子	zhuǎzi
專長	专长	zhuāncháng
專程	专程	zhuānchéng
專欄	专栏	zhuānlán
專賣店	专卖店	zhuānmàidiàn
專人	专人	zhuānrén
專制	专制	zhuānzhì
專職	专职	zhuānzhí
專注	专注	zhuānzhù
專著	专著	zhuānzhù
磚	砖	zhuān
轉播	转播	zhuǎnbō
轉達	转达	zhuǎndá
轉交	转交	zhuǎnjiāo
專櫃	专柜	zhuānguì
轉型	转型	zhuǎn xíng
轉學	转学	zhuǎn xué
轉機	转机	zhuǎnjī
轉載	转载	zhuǎnzǎi
轉折	转折	zhuǎnzhé
轉折點	转折点	zhuǎnzhédiǎn
傳	传	chuán
傳記	传记	zhuànjì
轉悠	转悠	zhuànyou
撰寫	撰写	zhuànxiě
轉眼	转眼	zhuǎnyǎn
莊稼	庄稼	zhuāngjia
莊嚴	庄严	zhuāngyán
莊園	庄园	zhuāngyuán
壯	壮	zhuàng
裝扮	装扮	zhuāngbàn
壯大	壮大	zhuàngdà
壯膽	壮胆	zhuàng dǎn
壯麗	壮丽	zhuànglì
狀元	状元	zhuàngyuan
撞擊	撞击	zhuàngjī
幢	幢	chuáng
追悼會	追悼会	zhuīdàohuì
追趕	追赶	zhuīgǎn
追溯	追溯	zhuīsù
壯實	壮实	zhuàngshi
追隨	追随	zhuīsuí
追尾	追尾	zhuī wěi
追問	追问	zhuīwèn
追蹤	追踪	zhuīzōng
墜	坠	zhuì
準許	准许	zhǔnxǔ
樁	桩	zhuāng
拙劣	拙劣	zhuōliè
灼熱	灼热	zhuórè
捉迷藏	捉迷藏	zhuō mícáng
追逐	追逐	zhuīzhú
準則	准则	zhǔnzé
酌情	酌情	zhuóqíng
著力	着力	zhuó lì
著落	着落	zhuóluò
著實	着实	zhuóshí
著手	着手	zhuóshǒu
著想	着想	zhuóxiǎng
著眼	着眼	zhuóyǎn
著眼於	着眼于	zhuóyǎn yú
著重	着重	zhuózhòng
姿態	姿态	zītài
茲	兹	cí
資本主義	资本主义	zīběnzhǔyì
資歷	资历	zīlì
姿勢	姿势	zīshì
資深	资深	zīshēn
卓越	卓越	zhuóyuè
滋潤	滋润	zīrùn
滋味	滋味	zīwèi
子弟	子弟	zǐdì
子孫	子孙	zǐsūn
自稱	自称	zìchēng
自卑	自卑	zìbēi
資訊	资讯	zīxùn
自費	自费	zìfèi
自發	自发	zìfā
自負	自负	zìfù
自理	自理	zìlǐ
自力更生	自力更生	zìlì-gēngshēng
自強不息	自强不息	zìqiáng-bùxī
自然而然	自然而然	zìránérrán
自立	自立	zìlì
自然界	自然界	zìránjiè
自始至終	自始至终	zìshǐ-zhìzhōng
自如	自如	zìrú
自衛	自卫	zìwèi
自相矛盾	自相矛盾	zìxiāng-máodùn
自私自利	自私自利	zìsī-zìlì
自信心	自信心	zìxìnxīn
自行	自行	zìxíng
自以為是	自以为是	zìyǐwéishì
自由自在	自由自在	zìyóu-zìzài
自責	自责	zìzé
自助	自助	zìzhù
自尊	自尊	zìzūn
自尊心	自尊心	zìzūnxīn
字跡	字迹	zìjì
字體	字体	zìtǐ
字眼	字眼	zìyǎn
宗	宗	zōng
宗旨	宗旨	zōngzhǐ
字幕	字幕	zìmù
綜上所述	综上所述	zōngshàngsuǒshù
自私	自私	zìsī
總額	总额	zǒngé
總的來說	总的来说	zǒngdeláishuō
總計	总计	zǒngjì
縱觀	纵观	zòngguān
縱橫交錯	纵横交错	zònghéng-jiāocuò
縱然	纵然	zòngrán
縱容	纵容	zòngróng
縱深	纵深	zòngshēn
粽子	粽子	zòngzi
走過場	走过场	zǒu guòchǎng
總而言之	总而言之	zǒngéryánzhī
走近	走近	zǒujìn
走廊	走廊	zǒuláng
走投無路	走投无路	zǒutóu-wúlù
走彎路	走弯路	zǒu wānlù
走後門	走后门	zǒu hòumén
揍	揍	zòu
租賃	租赁	zūlìn
足智多謀	足智多谋	zúzhì-duōmóu
阻擋	阻挡	zǔdǎng
阻攔	阻拦	zǔlán
奏效	奏效	zòu xiào
阻力	阻力	zǔlì
阻撓	阻挠	zǔnáo
組裝	组装	zǔzhuāng
祖傳	祖传	zǔchuán
祖籍	祖籍	zǔjí
祖先	祖先	zǔxiān
祖宗	祖宗	zǔzong
鑽空子	钻空子	zuān kòngzi
鑽研	钻研	zuānyán
組建	组建	zǔjiàn
鑽石	钻石	zuànshí
足跡	足迹	zújì
嘴唇	嘴唇	zuǐchún
罪魁禍首	罪魁祸首	zuìkuí-huòshǒu
尊嚴	尊严	zūnyán
尊貴	尊贵	zūnguì
遵循	遵循	zūnxún
遵照	遵照	zūnzhào
琢磨	琢磨	zhuómó
罪犯	罪犯	zuìfàn
左顧右盼	左顾右盼	zuǒgù-yòupàn
佐料	佐料	zuǒliào
作對	作对	zuò duì
作風	作风	zuòfēng
作物	作物	zuòwù
坐落	坐落	zuòluò
作弊	作弊	zuò bì
座右銘	座右铭	zuòyòumíng
座談	座谈	zuòtán
做生意	做生意	zuò shēngyi
做證	做证	zuò zhèng
作客	作客	zuò kè
