愛	ㄞˋ
愛好	ㄞˋ ㄏㄠˋ
爸爸	ㄅㄚˋ ㄅㄚ˙
白	ㄅㄞˊ
八	ㄅㄚ
白天	ㄅㄞˊ ㄊㄧㄢ˙
班	ㄅㄢ
百	ㄅㄞˇ
吧	ㄅㄚ˙
半	ㄅㄢˋ
半年	ㄅㄢˋ ㄋㄧㄢˊ
半天	ㄅㄢˋ ㄊㄧㄢ
幫	ㄅㄤ
幫忙	ㄅㄤ ㄇㄤˊ
包	ㄅㄠ
包子	ㄅㄠ ㄗ˙
杯	ㄅㄟ
杯子	ㄅㄟ ㄗ˙
北邊	ㄅㄟˇ ㄅㄧㄢ˙
本	ㄅㄣˇ
北京	ㄅㄟˇ ㄐㄧㄥ
北	ㄅㄟˇ
本子	ㄅㄣˇ ㄗ˙
別	ㄅㄧㄝˊ
別的	ㄅㄧㄝˊ ㄉㄜ˙
別人	ㄅㄧㄝˊ ㄖㄣ˙
病	ㄅㄧㄥˋ
病人	ㄅㄧㄥˋ ㄖㄣˊ
比	ㄅㄧˇ
不大	ㄅㄨˋ ㄉㄚˋ
不客氣	ㄅㄨˋ ㄎㄜˋ ㄑㄧˋ
不用	ㄅㄨˋ ㄩㄥˋ
菜	ㄘㄞˋ
不對	ㄅㄨˋ ㄉㄨㄟˋ
差	ㄔㄚˋ
不	ㄅㄨˋ
茶	ㄔㄚˊ
常常	ㄔㄤˊ ㄔㄤˊ
常	ㄔㄤˊ
車	ㄔㄜ
唱歌	ㄔㄤˋ ㄍㄜ
車上	ㄔㄜ ㄕㄤˋ
車票	ㄔㄜ ㄆㄧㄠˋ
唱	ㄔㄤˋ
吃	ㄔ
車站	ㄔㄜ ㄓㄢˋ
吃飯	ㄔ ㄈㄢˋ
出來	ㄔㄨ ㄌㄞ˙
齣	ㄔㄨ
出去	ㄔㄨ ㄑㄩ˙
床	ㄔㄨㄤˊ
次	ㄘˋ
穿	ㄔㄨㄢ
錯	ㄘㄨㄛˋ
從	ㄘㄨㄥˊ
打	ㄉㄚˇ
打車	ㄉㄚˇ ㄔㄜ
打電話	ㄉㄚˇ ㄉㄧㄢˋ ㄏㄨㄚˋ
打開	ㄉㄚˇ ㄎㄞ
打球	ㄉㄚˇ ㄑㄧㄡˊ
大學	ㄉㄚˋ ㄒㄩㄝˊ
大	ㄉㄚˋ
大學生	ㄉㄚˋ ㄒㄩㄝˊ ㄕㄥ
得到	ㄉㄜˊ ㄉㄠˋ
到	ㄉㄠˋ
等	ㄉㄥˇ
地點	ㄉㄧˋ ㄉㄧㄢˇ
地	ㄉㄜ˙
地方	ㄉㄧˋ ㄈㄤ˙
地上	ㄉㄧˋ ㄕㄤ˙
的	ㄉㄜ˙
地圖	ㄉㄧˋ ㄊㄨˊ
弟弟	ㄉㄧˋ ㄉㄧ˙
第	ㄉㄧˋ
點	ㄉㄧㄢˇ
電話	ㄉㄧㄢˋ ㄏㄨㄚˋ
電	ㄉㄧㄢˋ
電腦	ㄉㄧㄢˋ ㄋㄠˇ
電視機	ㄉㄧㄢˋ ㄕˋ ㄐㄧ
電影	ㄉㄧㄢˋ ㄧㄥˇ
電視	ㄉㄧㄢˋ ㄕˋ
電影院	ㄉㄧㄢˋ ㄧㄥˇ ㄩㄢˋ
東邊	ㄉㄨㄥ ㄅㄧㄢ
東	ㄉㄨㄥ
東西	ㄉㄨㄥ ㄒㄧ˙
動	ㄉㄨㄥˋ
動作	ㄉㄨㄥˋ ㄗㄨㄛˋ
讀	ㄉㄨˊ
都	ㄉㄡ
讀書	ㄉㄨˊ ㄕㄨ
對不起	ㄉㄨㄟˋ ㄅㄨ˙ ㄑㄧˇ
多	ㄉㄨㄛ
多少	ㄉㄨㄛ ㄕㄠ˙
兒子	ㄦˊ ㄗ˙
餓	ㄜˋ
對	ㄉㄨㄟˋ
二	ㄦˋ
飯	ㄈㄢˋ
飯店	ㄈㄢˋ ㄉㄧㄢˋ
房間	ㄈㄤˊ ㄐㄧㄢ
房子	ㄈㄤˊ ㄗ˙
放	ㄈㄤˋ
放假	ㄈㄤˋ ㄐㄧㄚˋ
飛	ㄈㄟ
放學	ㄈㄤˋ ㄒㄩㄝˊ
飛機	ㄈㄟ ㄐㄧ
非常	ㄈㄟ ㄔㄤˊ
分	ㄈㄣ
風	ㄈㄥ
幹	ㄍㄢˋ
乾淨	ㄍㄢ ㄐㄧㄥˋ
高興	ㄍㄠ ㄒㄧㄥˋ
高	ㄍㄠ
告訴	ㄍㄠˋ ㄙㄨ˙
哥哥	ㄍㄜ ㄍㄜ˙
歌	ㄍㄜ
幹什麼	ㄍㄢˋ ㄕㄣˊ ㄇㄜ˙
個	ㄍㄜˋ
給	ㄍㄟˇ
跟	ㄍㄣ
工人	ㄍㄨㄥ ㄖㄣ˙
工作	ㄍㄨㄥ ㄗㄨㄛˋ
關	ㄍㄨㄢ
關上	ㄍㄨㄢ ㄕㄤˋ
國	ㄍㄨㄛˊ
國家	ㄍㄨㄛˊ ㄐㄧㄚ
貴	ㄍㄨㄟˋ
國外	ㄍㄨㄛˊ ㄨㄞˋ
還是	ㄏㄞˊ ㄕ˙
孩子	ㄏㄞˊ ㄗ˙
還有	ㄏㄞˊ ㄧㄡˇ
過	ㄍㄨㄛˋ
漢語	ㄏㄢˋ ㄩˇ
還	ㄏㄞˊ
漢字	ㄏㄢˋ ㄗˋ
好	ㄏㄠˇ
好吃	ㄏㄠˇ ㄔ
好看	ㄏㄠˇ ㄎㄢˋ
好聽	ㄏㄠˇ ㄊㄧㄥ
好玩兒	ㄏㄠˇ ㄨㄢˊ ㄦ˙
號	ㄏㄠˋ
喝	ㄏㄜ
和	ㄏㄜˊ
很	ㄏㄣˇ
後	ㄏㄡˋ
後邊	ㄏㄡˋ ㄅㄧㄢ˙
話	ㄏㄨㄚˋ
後天	ㄏㄡˋ ㄊㄧㄢ
壞	ㄏㄨㄞˋ
回答	ㄏㄨㄟˊ ㄉㄚˊ
回	ㄏㄨㄟˊ
花	ㄏㄨㄚ
回到	ㄏㄨㄟˊ ㄉㄠˋ
回家	ㄏㄨㄟˊ ㄐㄧㄚ
回去	ㄏㄨㄟˊ ㄑㄩ˙
回來	ㄏㄨㄟˊ ㄌㄞ˙
會	ㄏㄨㄟˋ
火車	ㄏㄨㄛˇ ㄔㄜ
機場	ㄐㄧ ㄔㄤˇ
雞蛋	ㄐㄧ ㄉㄢˋ
機票	ㄐㄧ ㄆㄧㄠˋ
幾	ㄐㄧˇ
記得	ㄐㄧˋ ㄉㄜ˙
記住	ㄐㄧˋ ㄓㄨ˙
家	ㄐㄧㄚ
記	ㄐㄧˋ
家裡	ㄐㄧㄚ ㄌㄧˇ
見面	ㄐㄧㄢˋ ㄇㄧㄢˋ
教	ㄐㄧㄠˋ
家人	ㄐㄧㄚ ㄖㄣˊ
間	ㄐㄧㄢ
見	ㄐㄧㄢˋ
叫	ㄐㄧㄠˋ
教學樓	ㄐㄧㄠˋ ㄒㄩㄝˊ ㄌㄡˊ
介紹	ㄐㄧㄝˋ ㄕㄠˋ
今年	ㄐㄧㄣ ㄋㄧㄢˊ
姐姐	ㄐㄧㄝˇ ㄐㄧㄝ˙
今天	ㄐㄧㄣ ㄊㄧㄢ
進	ㄐㄧㄣˋ
進來	ㄐㄧㄣˋ ㄌㄞ˙
進去	ㄐㄧㄣˋ ㄑㄩ˙
就	ㄐㄧㄡˋ
覺得	ㄐㄩㄝˊ ㄉㄜ˙
九	ㄐㄧㄡˇ
開	ㄎㄞ
開車	ㄎㄞ ㄔㄜ
開會	ㄎㄞ ㄏㄨㄟˋ
開玩笑	ㄎㄞ ㄨㄢˊ ㄒㄧㄠˋ
看	ㄎㄢˋ
看病	ㄎㄢˋ ㄅㄧㄥˋ
看到	ㄎㄢˋ ㄉㄠˋ
考	ㄎㄠˇ
看見	ㄎㄢˋ ㄐㄧㄢ˙
考試	ㄎㄠˇ ㄕˋ
渴	ㄎㄜˇ
課	ㄎㄜˋ
課本	ㄎㄜˋ ㄅㄣˇ
課文	ㄎㄜˋ ㄨㄣˊ
口	ㄎㄡˇ
塊	ㄎㄨㄞˋ
快	ㄎㄨㄞˋ
來	ㄌㄞˊ
來到	ㄌㄞˊ ㄉㄠˋ
老	ㄌㄠˇ
老人	ㄌㄠˇ ㄖㄣ˙
老師	ㄌㄠˇ ㄕ
了	ㄌㄜ˙
累	ㄌㄟˋ
冷	ㄌㄥˇ
裏	ㄌㄧˇ
裡邊	ㄌㄧˇ ㄅㄧㄢ˙
兩	ㄌㄧㄤˇ
零	ㄌㄧㄥˊ
六	ㄌㄧㄡˋ
樓	ㄌㄡˊ
樓上	ㄌㄡˊ ㄕㄤˋ
樓下	ㄌㄡˊ ㄒㄧㄚˋ
路口	ㄌㄨˋ ㄎㄡˇ
路上	ㄌㄨˋ ㄕㄤ˙
媽媽	ㄇㄚ ㄇㄚ˙
馬路	ㄇㄚˇ ㄌㄨˋ
路	ㄌㄨˋ
馬上	ㄇㄚˇ ㄕㄤˋ
買	ㄇㄞˇ
嗎	ㄇㄚ˙
慢	ㄇㄢˋ
忙	ㄇㄤˊ
毛	ㄇㄠˊ
沒	ㄇㄟˊ
沒關係	ㄇㄟˊ ㄍㄨㄢ ㄒㄧ˙
沒什麼	ㄇㄟˊ ㄕㄣˊ ㄇㄜ˙
沒有	ㄇㄟˊ ㄧㄡ˙
沒事兒	ㄇㄟˊ ㄕˋ ㄦ˙
妹妹	ㄇㄟˋ ㄇㄟ˙
門	ㄇㄣˊ
門口	ㄇㄣˊ ㄎㄡˇ
門票	ㄇㄣˊ ㄆㄧㄠˋ
米飯	ㄇㄧˇ ㄈㄢˋ
們	ㄇㄣ˙
麵包	ㄇㄧㄢˋ ㄅㄠ
麵條兒	ㄇㄧㄢˋ ㄊㄧㄠˊ ㄦ˙
名字	ㄇㄧㄥˊ ㄗ˙
明白	ㄇㄧㄥˊ ㄅㄞ˙
明年	ㄇㄧㄥˊ ㄋㄧㄢˊ
明天	ㄇㄧㄥˊ ㄊㄧㄢ
哪	ㄋㄚˇ
哪裡	ㄋㄚˇ ㄌㄧ˙
哪兒	ㄋㄚˇ ㄦ˙
哪些	ㄋㄚˇ ㄒㄧㄝ
拿	ㄋㄚˊ
那邊	ㄋㄚˋ ㄅㄧㄢ˙
那	ㄋㄚˋ
那裡	ㄋㄚˋ ㄌㄧˇ
那些	ㄋㄚˋ ㄒㄧㄝ
奶	ㄋㄞˇ
那兒	ㄋㄚˋ ㄦ˙
奶奶	ㄋㄞˇ ㄋㄞ˙
男孩兒	ㄋㄢˊ ㄏㄞˊ ㄦ˙
男朋友	ㄋㄢˊ ㄆㄥˊ ㄧㄡ˙
男	ㄋㄢˊ
男生	ㄋㄢˊ ㄕㄥ
南	ㄋㄢˊ
男人	ㄋㄢˊ ㄖㄣ˙
南邊	ㄋㄢˊ ㄅㄧㄢ˙
呢	ㄋㄜ˙
難	ㄋㄢˊ
你	ㄋㄧˇ
能	ㄋㄥˊ
你們	ㄋㄧˇ ㄇㄣ˙
您	ㄋㄧㄣˊ
牛奶	ㄋㄧㄡˊ ㄋㄞˇ
女	ㄋㄩˇ
年	ㄋㄧㄢˊ
女孩兒	ㄋㄩˇ ㄏㄞˊ ㄦ˙
女兒	ㄋㄩˇ ㄦˊ
女生	ㄋㄩˇ ㄕㄥ
女朋友	ㄋㄩˇ ㄆㄥˊ ㄧㄡ˙
旁邊	ㄆㄤˊ ㄅㄧㄢ
跑	ㄆㄠˇ
女人	ㄋㄩˇ ㄖㄣ˙
朋友	ㄆㄥˊ ㄧㄡ˙
票	ㄆㄧㄠˋ
七	ㄑㄧ
起床	ㄑㄧˇ ㄔㄨㄤˊ
起來	ㄑㄧˇ ㄌㄞ˙
起	ㄑㄧˇ
汽車	ㄑㄧˋ ㄔㄜ
前	ㄑㄧㄢˊ
前邊	ㄑㄧㄢˊ ㄅㄧㄢ˙
錢	ㄑㄧㄢˊ
錢包	ㄑㄧㄢˊ ㄅㄠ
請	ㄑㄧㄥˇ
前天	ㄑㄧㄢˊ ㄊㄧㄢ
請假	ㄑㄧㄥˇ ㄐㄧㄚˋ
請問	ㄑㄧㄥˇ ㄨㄣˋ
請進	ㄑㄧㄥˇ ㄐㄧㄣˋ
請坐	ㄑㄧㄥˇ ㄗㄨㄛˋ
球	ㄑㄧㄡˊ
去年	ㄑㄩˋ ㄋㄧㄢˊ
熱	ㄖㄜˋ
人	ㄖㄣˊ
認識	ㄖㄣˋ ㄕ˙
認真	ㄖㄣˋ ㄓㄣ
去	ㄑㄩˋ
日	ㄖˋ
日期	ㄖˋ ㄑㄧ
肉	ㄖㄡˋ
山	ㄕㄢ
商場	ㄕㄤ ㄔㄤˇ
上	ㄕㄤˋ
三	ㄙㄢ
商店	ㄕㄤ ㄉㄧㄢˋ
上班	ㄕㄤˋ ㄅㄢ
上車	ㄕㄤˋ ㄔㄜ
上課	ㄕㄤˋ ㄎㄜˋ
上網	ㄕㄤˋ ㄨㄤˇ
上邊	ㄕㄤˋ ㄅㄧㄢ˙
上學	ㄕㄤˋ ㄒㄩㄝˊ
上午	ㄕㄤˋ ㄨˇ
少	ㄕㄠˇ
上次	ㄕㄤˋ ㄘˋ
身上	ㄕㄣ ㄕㄤ˙
誰	ㄕㄟˊ
身體	ㄕㄣ ㄊㄧˇ
生病	ㄕㄥ ㄅㄧㄥˋ
生氣	ㄕㄥ ㄑㄧˋ
十	ㄕˊ
時候	ㄕˊ ㄏㄡ˙
時間	ㄕˊ ㄐㄧㄢ
事	ㄕˋ
試	ㄕˋ
生日	ㄕㄥ ㄖ˙
是不是	ㄕˋ ㄅㄨˋ ㄕˋ
是	ㄕˋ
手機	ㄕㄡˇ ㄐㄧ
手	ㄕㄡˇ
書包	ㄕㄨ ㄅㄠ
書	ㄕㄨ
書店	ㄕㄨ ㄉㄧㄢˋ
樹	ㄕㄨˋ
水	ㄕㄨㄟˇ
水果	ㄕㄨㄟˇ ㄍㄨㄛˇ
睡	ㄕㄨㄟˋ
說	ㄕㄨㄛ
說話	ㄕㄨㄛ ㄏㄨㄚˋ
睡覺	ㄕㄨㄟˋ ㄐㄧㄠˋ
送	ㄙㄨㄥˋ
四	ㄙˋ
嵗	ㄙㄨㄟˋ
他們	ㄊㄚ ㄇㄣ˙
什麼	ㄕㄣˊ ㄇㄜ˙
她	ㄊㄚ
她們	ㄊㄚ ㄇㄣ˙
天	ㄊㄧㄢ
他	ㄊㄚ
太	ㄊㄞˋ
天氣	ㄊㄧㄢ ㄑㄧˋ
聽到	ㄊㄧㄥ ㄉㄠˋ
聽見	ㄊㄧㄥ ㄐㄧㄢ˙
聽寫	ㄊㄧㄥ ㄒㄧㄝˇ
聽	ㄊㄧㄥ
圖書館	ㄊㄨˊ ㄕㄨ ㄍㄨㄢˇ
外	ㄨㄞˋ
外邊	ㄨㄞˋ ㄅㄧㄢ˙
同學	ㄊㄨㄥˊ ㄒㄩㄝˊ
外國	ㄨㄞˋ ㄍㄨㄛˊ
玩兒	ㄨㄢˊ ㄦ˙
晚	ㄨㄢˇ
晚飯	ㄨㄢˇ ㄈㄢˋ
晚上	ㄨㄢˇ ㄕㄤ˙
網上	ㄨㄤˇ ㄕㄤˋ
網友	ㄨㄤˇ ㄧㄡˇ
外語	ㄨㄞˋ ㄩˇ
忘記	ㄨㄤˋ ㄐㄧˋ
忘	ㄨㄤˋ
問	ㄨㄣˋ
我們	ㄨㄛˇ ㄇㄣ˙
我	ㄨㄛˇ
五	ㄨˇ
午飯	ㄨˇ ㄈㄢˋ
西	ㄒㄧ
西邊	ㄒㄧ ㄅㄧㄢ˙
洗	ㄒㄧˇ
洗手間	ㄒㄧˇ ㄕㄡˇ ㄐㄧㄢ
喜歡	ㄒㄧˇ ㄏㄨㄢ˙
下	ㄒㄧㄚˋ
下班	ㄒㄧㄚˋ ㄅㄢ
下邊	ㄒㄧㄚˋ ㄅㄧㄢ˙
下車	ㄒㄧㄚˋ ㄔㄜ
下次	ㄒㄧㄚˋ ㄘˋ
下課	ㄒㄧㄚˋ ㄎㄜˋ
下午	ㄒㄧㄚˋ ㄨˇ
下雨	ㄒㄧㄚˋ ㄩˇ
先	ㄒㄧㄢ
先生	ㄒㄧㄢ ㄕㄥ˙
想	ㄒㄧㄤˇ
現在	ㄒㄧㄢˋ ㄗㄞˋ
小	ㄒㄧㄠˇ
小孩兒	ㄒㄧㄠˇ ㄏㄞˊ ㄦ˙
小姐	ㄒㄧㄠˇ ㄐㄧㄝˇ
小時	ㄒㄧㄠˇ ㄕˊ
小朋友	ㄒㄧㄠˇ ㄆㄥˊ ㄧㄡˇ
小學	ㄒㄧㄠˇ ㄒㄩㄝˊ
小學生	ㄒㄧㄠˇ ㄒㄩㄝˊ ㄕㄥ˙
笑	ㄒㄧㄠˋ
寫	ㄒㄧㄝˇ
謝謝	ㄒㄧㄝˋ ㄒㄧㄝ˙
新	ㄒㄧㄣ
新年	ㄒㄧㄣ ㄋㄧㄢˊ
星期	ㄒㄧㄥ ㄑㄧ
星期日	ㄒㄧㄥ ㄑㄧ ㄖˋ
星期天	ㄒㄧㄥ ㄑㄧ ㄊㄧㄢ
行	ㄒㄧㄥˊ
休息	ㄒㄧㄡ ㄒㄧ˙
學生	ㄒㄩㄝˊ ㄕㄥ˙
學	ㄒㄩㄝˊ
學習	ㄒㄩㄝˊ ㄒㄧˊ
學校	ㄒㄩㄝˊ ㄒㄧㄠˋ
學院	ㄒㄩㄝˊ ㄩㄢˋ
要	ㄧㄠˋ
爺爺	ㄧㄝˊ ㄧㄝ˙
頁	ㄧㄝˋ
衣服	ㄧ ㄈㄨ˙
也	ㄧㄝˇ
醫生	ㄧ ㄕㄥ
醫院	ㄧ ㄩㄢˋ
一	ㄧ
一會兒	ㄧ ㄏㄨㄟˋ ㄦ˙
一塊兒	ㄧ ㄎㄨㄞˋ ㄦ˙
一下兒	ㄧ ㄒㄧㄚˋ ㄦ˙
一半	ㄧ ㄅㄢˋ
一邊	ㄧ ㄅㄧㄢ
一點兒	ㄧ ㄉㄧㄢˇ ㄦ˙
一起	ㄧ ㄑㄧˇ
一些	ㄧ ㄒㄧㄝ
一樣	ㄧ ㄧㄤˋ
有的	ㄧㄡˇ ㄉㄜ˙
有	ㄧㄡˇ
有名	ㄧㄡˇ ㄇㄧㄥˊ
用	ㄩㄥˋ
有時候	ㄧㄡˇ ㄕˊ ㄏㄡ˙
有些	ㄧㄡˇ ㄒㄧㄝ
有用	ㄧㄡˇ ㄩㄥˋ
右	ㄧㄡˋ
右邊	ㄧㄡˋ ㄅㄧㄢ˙
雨	ㄩˇ
元	ㄩㄢˊ
遠	ㄩㄢˇ
月	ㄩㄝˋ
再	ㄗㄞˋ
再見	ㄗㄞˋ ㄐㄧㄢˋ
在	ㄗㄞˋ
在家	ㄗㄞˋ ㄐㄧㄚ
早	ㄗㄠˇ
早飯	ㄗㄠˇ ㄈㄢˋ
早上	ㄗㄠˇ ㄕㄤ˙
怎麼	ㄗㄣˇ ㄇㄜ˙
站	ㄓㄢˋ
找	ㄓㄠˇ
找到	ㄓㄠˇ ㄉㄠˋ
這邊	ㄓㄜˋ ㄅㄧㄢ
這	ㄓㄜˋ
這裡	ㄓㄜˋ ㄌㄧˇ
這兒	ㄓㄜˋ ㄦ˙
這些	ㄓㄜˋ ㄒㄧㄝ
著	ㄓㄜ˙
真	ㄓㄣ
真的	ㄓㄣ ㄉㄜ˙
正	ㄓㄥˋ
正在	ㄓㄥˋ ㄗㄞˋ
知道	ㄓ ㄉㄠ˙
知識	ㄓ ㄕ˙
中國	ㄓㄨㄥ ㄍㄨㄛˊ
中	ㄓㄨㄥ
中間	ㄓㄨㄥ ㄐㄧㄢ
中文	ㄓㄨㄥ ㄨㄣˊ
中午	ㄓㄨㄥ ㄨˇ
中學	ㄓㄨㄥ ㄒㄩㄝˊ
中學生	ㄓㄨㄥ ㄒㄩㄝˊ ㄕㄥ
重	ㄓㄨㄥˋ
重要	ㄓㄨㄥˋ ㄧㄠˋ
住	ㄓㄨˋ
準備	ㄓㄨㄣˇ ㄅㄟˋ
桌子	ㄓㄨㄛ ㄗ˙
字	ㄗˋ
子	ㄗ˙
走	ㄗㄡˇ
最	ㄗㄨㄟˋ
走路	ㄗㄡˇ ㄌㄨˋ
最好	ㄗㄨㄟˋ ㄏㄠˇ
最後	ㄗㄨㄟˋ ㄏㄡˋ
昨天	ㄗㄨㄛˊ ㄊㄧㄢ
左邊	ㄗㄨㄛˇ ㄅㄧㄢ˙
左	ㄗㄨㄛˇ
坐	ㄗㄨㄛˋ
坐下	ㄗㄨㄛˋ ㄒㄧㄚˋ
做	ㄗㄨㄛˋ
