啊	ㄚ˙
愛情	ㄞˋ ㄑㄧㄥˊ
安靜	ㄢ ㄐㄧㄥˋ
安全	ㄢ ㄑㄩㄢˊ
愛人	ㄞˋ ㄖㄣ˙
班長	ㄅㄢ ㄓㄤˇ
辦	ㄅㄢˋ
辦法	ㄅㄢˋ ㄈㄚˇ
辦公室	ㄅㄢˋ ㄍㄨㄥ ㄕˋ
白色	ㄅㄞˊ ㄙㄜˋ
幫助	ㄅㄤ ㄓㄨˋ
報名	ㄅㄠˋ ㄇㄧㄥˊ
飽	ㄅㄠˇ
半夜	ㄅㄢˋ ㄧㄝˋ
報紙	ㄅㄠˋ ㄓˇ
北方	ㄅㄟˇ ㄈㄤ
比如說	ㄅㄧˇ ㄖㄨˊ ㄕㄨㄛ
比如	ㄅㄧˇ ㄖㄨˊ
筆記	ㄅㄧˇ ㄐㄧˋ
筆	ㄅㄧˇ
背	ㄅㄟˋ
筆記本	ㄅㄧˇ ㄐㄧˋ ㄅㄣˇ
邊	ㄅㄧㄢ
變	ㄅㄧㄢˋ
必須	ㄅㄧˋ ㄒㄩ
遍	ㄅㄧㄢˋ
變成	ㄅㄧㄢˋ ㄔㄥˊ
不錯	ㄅㄨˋ ㄘㄨㄛˋ
不夠	ㄅㄨˋ ㄍㄡˋ
不但	ㄅㄨˋ ㄉㄢˋ
不過	ㄅㄨˋ ㄍㄨㄛˋ
不太	ㄅㄨˋ ㄊㄞˋ
錶	ㄅㄧㄠˇ
不好意思	ㄅㄨˋ ㄏㄠˇ ㄧˋ ㄙ˙
不滿	ㄅㄨˋ ㄇㄢˇ
不要	ㄅㄨˋ ㄧㄠˋ
不如	ㄅㄨˋ ㄖㄨˊ
不久	ㄅㄨˋ ㄐㄧㄡˇ
不少	ㄅㄨˋ ㄕㄠˇ
不同	ㄅㄨˋ ㄊㄨㄥˊ
不行	ㄅㄨˋ ㄒㄧㄥˊ
不一定	ㄅㄨˋ ㄧ ㄉㄧㄥˋ
不一會兒	ㄅㄨˋ ㄧ ㄏㄨㄟˇ ㄦ˙
部分	ㄅㄨˋ ㄈㄣ˙
菜單	ㄘㄞˋ ㄉㄢ
參觀	ㄘㄢ ㄍㄨㄢ
才	ㄘㄞˊ
參加	ㄘㄢ ㄐㄧㄚ
草地	ㄘㄠˇ ㄉㄧˋ
層	ㄘㄥˊ
草	ㄘㄠˇ
差不多	ㄔㄚˋ ㄅㄨ˙ ㄉㄨㄛ
長	ㄓㄤˇ
查	ㄔㄚˊ
常見	ㄔㄤˊ ㄐㄧㄢˋ
常用	ㄔㄤˊ ㄩㄥˋ
場	ㄔㄤˇ
超過	ㄔㄠ ㄍㄨㄛˋ
超市	ㄔㄠ ㄕˋ
車輛	ㄔㄜ ㄌㄧㄤˋ
成績	ㄔㄥˊ ㄐㄧˋ
稱	ㄔㄥ
重複	ㄔㄨㄥˊ ㄈㄨˋ
重新	ㄔㄨㄥˊ ㄒㄧㄣ
出發	ㄔㄨ ㄈㄚ
成為	ㄔㄥˊ ㄨㄟˊ
成	ㄔㄥˊ
出國	ㄔㄨ ㄍㄨㄛˊ
出口	ㄔㄨ ㄎㄡˇ
出門	ㄔㄨ ㄇㄣˊ
出生	ㄔㄨ ㄕㄥ
出現	ㄔㄨ ㄒㄧㄢˋ
出院	ㄔㄨ ㄩㄢˋ
出租	ㄔㄨ ㄗㄨ
出租車	ㄔㄨ ㄗㄨ ㄔㄜ
吹	ㄔㄨㄟ
春節	ㄔㄨㄣ ㄐㄧㄝˊ
船	ㄔㄨㄢˊ
春天	ㄔㄨㄣ ㄊㄧㄢ
詞典	ㄘˊ ㄉㄧㄢˇ
詞	ㄘˊ
詞語	ㄘˊ ㄩˇ
答應	ㄉㄚ ㄧㄥ˙
打工	ㄉㄚˇ ㄍㄨㄥ
從小	ㄘㄨㄥˊ ㄒㄧㄠˇ
打算	ㄉㄚˇ ㄙㄨㄢ˙
打印	ㄉㄚˇ ㄧㄣˋ
大部分	ㄉㄚˋ ㄅㄨˋ ㄈㄣ˙
大大	ㄉㄚˋ ㄉㄚ˙
大多數	ㄉㄚˋ ㄉㄨㄛ ㄕㄨˋ
大家	ㄉㄚˋ ㄐㄧㄚ
大海	ㄉㄚˇ ㄏㄞˇ
大量	ㄉㄚˋ ㄌㄧㄤˋ
大門	ㄉㄚˋ ㄇㄣˊ
大人	ㄉㄚˋ ㄖㄣ˙
大聲	ㄉㄚˋ ㄕㄥ
大衣	ㄉㄚˋ ㄧ
大自然	ㄉㄚˋ ㄗˋ ㄖㄢˊ
帶	ㄉㄞˋ
帶來	ㄉㄞˋ ㄌㄞˊ
單位	ㄉㄢ ㄨㄟˋ
大小	ㄉㄚˋ ㄒㄧㄠˇ
但	ㄉㄢˋ
但是	ㄉㄢˋ ㄕˋ
蛋	ㄉㄢˋ
當	ㄉㄤ
當時	ㄉㄤ ㄕˊ
到處	ㄉㄠˋ ㄔㄨˋ
道	ㄉㄠˋ
道路	ㄉㄠˋ ㄌㄨˋ
倒	ㄉㄠˋ
道理	ㄉㄠˋ ㄌㄧ˙
得	ㄉㄜ˙
得出	ㄉㄜˊ ㄔㄨ
的話	ㄉㄜ˙ ㄏㄨㄚˋ
等	ㄉㄥˇ
等到	ㄉㄥˇ ㄉㄠˋ
燈	ㄉㄥ
低	ㄉㄧ
等於	ㄉㄥˇ ㄩˊ
地鐵	ㄉㄧˋ ㄊㄧㄝˇ
地球	ㄉㄧˋ ㄑㄧㄡˊ
地鐵站	ㄉㄧˋ ㄊㄧㄝˇ ㄓㄢˋ
店	ㄉㄧㄢˋ
點頭	ㄉㄧㄢˇ ㄊㄡˊ
東北	ㄉㄨㄥ ㄅㄟˇ
東方	ㄉㄨㄥ ㄈㄤ
冬天	ㄉㄨㄥ ㄊㄧㄢ
掉	ㄉㄧㄠˋ
東南	ㄉㄨㄥ ㄋㄢˊ
懂得	ㄉㄨㄥˇ ㄉㄜ˙
動物	ㄉㄨㄥˋ ㄨˋ
動物園	ㄉㄨㄥˋ ㄨˋ ㄩㄢˊ
度	ㄉㄨˋ
讀音	ㄉㄨˊ ㄧㄣ
短	ㄉㄨㄢˇ
短信	ㄉㄨㄢˇ ㄒㄧㄣˋ
段	ㄉㄨㄢˋ
隊	ㄉㄨㄟˋ
隊長	ㄉㄨㄟˋ ㄓㄤˇ
懂	ㄉㄨㄥˇ
對話	ㄉㄨㄟˋ ㄏㄨㄚˋ
對面	ㄉㄨㄟˋ ㄇㄧㄢˋ
多	ㄉㄨㄛ
多久	ㄉㄨㄛ ㄐㄧㄡˇ
對	ㄉㄨㄟˋ
多麼	ㄉㄨㄛ ㄇㄜ˙
多數	ㄉㄨㄛ ㄕㄨˋ
多雲	ㄉㄨㄛ ㄩㄣˊ
而且	ㄦˊ ㄑㄧㄝˇ
發	ㄈㄚ
發現	ㄈㄚ ㄒㄧㄢˋ
飯館	ㄈㄢˋ ㄍㄨㄢˇ
方便	ㄈㄤ ㄅㄧㄢˋ
方便麵	ㄈㄤ ㄅㄧㄢˋ ㄇㄧㄢˋ
方法	ㄈㄤ ㄈㄚˇ
方面	ㄈㄤ ㄇㄧㄢˋ
放下	ㄈㄤˋ ㄒㄧㄚˋ
方向	ㄈㄤ ㄒㄧㄤ˙
分	ㄈㄣ
分開	ㄈㄣ ㄎㄞ
分數	ㄈㄣ ㄕㄨˋ
放心	ㄈㄤˋ ㄒㄧㄣ
分鐘	ㄈㄣ ㄓㄨㄥ
服務	ㄈㄨˊ ㄨˋ
複習	ㄈㄨˋ ㄒㄧˊ
份	ㄈㄣˋ
封	ㄈㄥ
改	ㄍㄞˇ
改變	ㄍㄞˇ ㄅㄧㄢˋ
該	ㄍㄞ
感到	ㄍㄢˇ ㄉㄠˋ
感動	ㄍㄢˇ ㄉㄨㄥˋ
乾杯	ㄍㄢ ㄅㄟ
感覺	ㄍㄢˇ ㄐㄩㄝˊ
幹活兒	ㄍㄢˋ ㄏㄨㄛˊ ㄦ˙
剛	ㄍㄤ
剛纔	ㄍㄤ ㄘㄞˊ
剛剛	ㄍㄤ ㄍㄤ
高級	ㄍㄠ ㄐㄧˊ
感謝	ㄍㄢˇ ㄒㄧㄝˋ
高中	ㄍㄠ ㄓㄨㄥ
個子	ㄍㄜˋ ㄗ˙
更	ㄍㄥˋ
公共汽車	ㄍㄨㄥ ㄍㄨㄥˋ ㄑㄧˋ ㄔㄜ
公交車	ㄍㄨㄥ ㄐㄧㄠ ㄔㄜ
公斤	ㄍㄨㄥ ㄐㄧㄣ
公路	ㄍㄨㄥ ㄌㄨˋ
公平	ㄍㄨㄥ ㄆㄧㄥˊ
公里	ㄍㄨㄥ ㄌㄧˇ
公園	ㄍㄨㄥ ㄩㄢˊ
公司	ㄍㄨㄥ ㄙ
故事	ㄍㄨˋ ㄕ˙
狗	ㄍㄡˇ
夠	ㄍㄡˋ
故意	ㄍㄨˋ ㄧˋ
顧客	ㄍㄨˋ ㄎㄜˋ
關機	ㄍㄨㄢ ㄐㄧ
關心	ㄍㄨㄢ ㄒㄧㄣ
觀點	ㄍㄨㄢ ㄉㄧㄢˇ
廣場	ㄍㄨㄤˇ ㄔㄤˇ
廣告	ㄍㄨㄤˇ ㄍㄠˋ
過來	ㄍㄨㄛˋ ㄌㄞ˙
過年	ㄍㄨㄛˋ ㄋㄧㄢ˙
國際	ㄍㄨㄛˊ ㄐㄧˋ
過去	ㄍㄨㄛˋ ㄑㄩ˙
海	ㄏㄞˇ
過	ㄍㄨㄛˋ
海邊	ㄏㄞˇ ㄅㄧㄢ
好	ㄏㄠˇ
喊	ㄏㄢˇ
好多	ㄏㄠˇ ㄉㄨㄛ
好處	ㄏㄠˇ ㄔㄨ˙
好久	ㄏㄠˇ ㄐㄧㄡˇ
好人	ㄏㄠˇ ㄖㄣˊ
好事	ㄏㄠˇ ㄕˋ
好像	ㄏㄠˇ ㄒㄧㄤˋ
合適	ㄏㄜˊ ㄕˋ
黑	ㄏㄟ
河	ㄏㄜˊ
黑板	ㄏㄟ ㄅㄢˇ
紅	ㄏㄨㄥˊ
黑色	ㄏㄟ ㄙㄜˋ
紅色	ㄏㄨㄥˊ ㄙㄜˋ
忽然	ㄏㄨ ㄖㄢˊ
後來	ㄏㄡˋ ㄌㄞˊ
護照	ㄏㄨˋ ㄓㄠˋ
花	ㄏㄨㄚ
花園	ㄏㄨㄚ ㄩㄢˊ
湖	ㄏㄨˊ
畫	ㄏㄨㄚˋ
畫兒	ㄏㄨㄚˋ ㄦ˙
畫家	ㄏㄨㄚˋ ㄐㄧㄚ
壞人	ㄏㄨㄞˋ ㄖㄣˊ
壞處	ㄏㄨㄞˋ ㄔㄨ˙
歡迎	ㄏㄨㄢ ㄧㄥˊ
黃	ㄏㄨㄤˊ
換	ㄏㄨㄢˋ
黃色	ㄏㄨㄤˊ ㄙㄜˋ
回	ㄏㄨㄟˊ
回國	ㄏㄨㄟˊ ㄍㄨㄛˊ
會	ㄏㄨㄟˋ
活動	ㄏㄨㄛˊ ㄉㄨㄥ˙
或	ㄏㄨㄛˋ
或者	ㄏㄨㄛˋ ㄓㄜˇ
鷄	ㄐㄧ
機會	ㄐㄧ ㄏㄨㄟ˙
級	ㄐㄧˊ
急	ㄐㄧˊ
計劃	ㄐㄧˋ ㄏㄨㄚˋ
計算機	ㄐㄧˋ ㄙㄨㄢˋ ㄐㄧ
加	ㄐㄧㄚ
加油	ㄐㄧㄚ ㄧㄡˊ
家	ㄐㄧㄚ
家庭	ㄐㄧㄚ ㄊㄧㄥˊ
家長	ㄐㄧㄚ ㄓㄤˇ
假	ㄐㄧㄚˇ
假期	ㄐㄧㄚˋ ㄑㄧ
檢查	ㄐㄧㄢˇ ㄔㄚˊ
件	ㄐㄧㄢˋ
見過	ㄐㄧㄢˋ ㄍㄨㄛˋ
講	ㄐㄧㄤˇ
見到	ㄐㄧㄢˋ ㄉㄠˋ
健康	ㄐㄧㄢˋ ㄎㄤ
講話	ㄐㄧㄤˇ ㄏㄨㄚˋ
交	ㄐㄧㄠ
交給	ㄐㄧㄠ ㄍㄟˇ
交朋友	ㄐㄧㄠ ㄆㄥˊ ㄧㄡ˙
交通	ㄐㄧㄠ ㄊㄨㄥ
角	ㄐㄧㄠˇ
角度	ㄐㄧㄠˇ ㄉㄨˋ
餃子	ㄐㄧㄠˇ ㄗ˙
叫作	ㄐㄧㄠˋ ㄗㄨㄛˋ
教師	ㄐㄧㄠˋ ㄕ
腳	ㄐㄧㄠˇ
教學	ㄐㄧㄠ ㄒㄩㄝˊ
教育	ㄐㄧㄠˋ ㄩˋ
教室	ㄐㄧㄠˋ ㄕˋ
接到	ㄐㄧㄝ ㄉㄠˋ
接受	ㄐㄧㄝ ㄕㄡˋ
接下來	ㄐㄧㄝ ㄒㄧㄚˋ ㄌㄞˊ
接著	ㄐㄧㄝ ㄓㄜ˙
街	ㄐㄧㄝ
節	ㄐㄧㄝˊ
節目	ㄐㄧㄝˊ ㄇㄨˋ
節日	ㄐㄧㄝˊ ㄖˋ
結果	ㄐㄧㄝ ㄍㄨㄛˇ
斤	ㄐㄧㄣ
接	ㄐㄧㄝ
借	ㄐㄧㄝˋ
進入	ㄐㄧㄣˋ ㄖㄨˋ
今後	ㄐㄧㄣ ㄏㄡˋ
進行	ㄐㄧㄣˋ ㄒㄧㄥˊ
經常	ㄐㄧㄥ ㄔㄤˊ
經過	ㄐㄧㄥ ㄍㄨㄛˋ
近	ㄐㄧㄣˋ
經理	ㄐㄧㄥ ㄌㄧˇ
酒店	ㄐㄧㄡˇ ㄉㄧㄢˋ
就要	ㄐㄧㄡˋ ㄧㄠˋ
酒	ㄐㄧㄡˇ
舉手	ㄐㄩˇ ㄕㄡˇ
舉行	ㄐㄩˇ ㄒㄧㄥˊ
舉	ㄐㄩˇ
句子	ㄐㄩˋ ㄗ˙
卡	ㄎㄚˇ
開機	ㄎㄞ ㄐㄧ
句	ㄐㄩˋ
看法	ㄎㄢˋ ㄈㄚ˙
開心	ㄎㄞ ㄒㄧㄣ
考生	ㄎㄠˇ ㄕㄥ
靠	ㄎㄠˋ
開學	ㄎㄞ ㄒㄩㄝˊ
科	ㄎㄜ
科學	ㄎㄜ ㄒㄩㄝˊ
可愛	ㄎㄜˇ ㄞˋ
可怕	ㄎㄜˇ ㄆㄚˋ
可是	ㄎㄜˇ ㄕˋ
可能	ㄎㄜˇ ㄋㄥˊ
克	ㄎㄜˋ
可以	ㄎㄜˇ ㄧˇ
刻	ㄎㄜˋ
課堂	ㄎㄜˋ ㄊㄤˊ
空氣	ㄎㄨㄥ ㄑㄧˋ
快餐	ㄎㄨㄞˋ ㄘㄢ
快點兒	ㄎㄨㄞˋ ㄉㄧㄢˇ ㄦ˙
客人	ㄎㄜˋ ㄖㄣ˙
快樂	ㄎㄨㄞˋ ㄌㄜˋ
快要	ㄎㄨㄞˋ ㄧㄠˋ
哭	ㄎㄨ
筷子	ㄎㄨㄞˋ ㄗ˙
來自	ㄌㄞˊ ㄗˋ
拉	ㄌㄚ
藍	ㄌㄢˊ
藍色	ㄌㄢˊ ㄙㄜˋ
籃球	ㄌㄢˊ ㄑㄧㄡˊ
老年	ㄌㄠˇ ㄋㄧㄢˊ
老朋友	ㄌㄠˇ ㄆㄥˊ ㄧㄡ˙
離	ㄌㄧˊ
老	ㄌㄠˇ
老是	ㄌㄠˇ ㄕ˙
離開	ㄌㄧˊ ㄎㄞ
裡頭	ㄌㄧˇ ㄊㄡ˙
理想	ㄌㄧˇ ㄒㄧㄤˇ
禮物	ㄌㄧˇ ㄨˋ
例如	ㄌㄧˋ ㄖㄨˊ
例子	ㄌㄧˋ ㄗ˙
臉	ㄌㄧㄢˇ
練習	ㄌㄧㄢˋ ㄒㄧˊ
練	ㄌㄧㄢˋ
涼	ㄌㄧㄤˊ
涼快	ㄌㄧㄤˊ ㄎㄨㄞ˙
輛	ㄌㄧㄤˋ
亮	ㄌㄧㄤˋ
零下	ㄌㄧㄥˊ ㄒㄧㄚˋ
兩	ㄌㄧㄤˇ
留下	ㄌㄧㄡˊ ㄒㄧㄚˋ
留	ㄌㄧㄡˊ
留學生	ㄌㄧㄡˊ ㄒㄩㄝˊ ㄕㄥ
流利	ㄌㄧㄡˊ ㄌㄧˋ
流	ㄌㄧㄡˊ
流行	ㄌㄧㄡˊ ㄒㄧㄥˊ
旅客	ㄌㄩˇ ㄎㄜˋ
旅行	ㄌㄩˇ ㄒㄧㄥˊ
綠	ㄌㄩˋ
綠色	ㄌㄩˋ ㄙㄜˋ
路邊	ㄌㄨˋ ㄅㄧㄢ
賣	ㄇㄞˋ
旅遊	ㄌㄩˇ ㄧㄡˊ
滿意	ㄇㄢˇ ㄧˋ
貓	ㄇㄠ
米	ㄇㄧˇ
面	ㄇㄧㄢˋ
面前	ㄇㄧㄢˋ ㄑㄧㄢˊ
名稱	ㄇㄧㄥˊ ㄔㄥ
名	ㄇㄧㄥˊ
名單	ㄇㄧㄥˊ ㄉㄢ
滿	ㄇㄢˇ
目的	ㄇㄨˋ ㄉㄧˋ
拿到	ㄋㄚˊ ㄉㄠˋ
拿出	ㄋㄚˊ ㄔㄨ
那	ㄋㄚˋ
那會兒	ㄋㄚˋ ㄏㄨㄟˋ ㄦ˙
那麼	ㄋㄚˋ ㄇㄜ˙
那時候	ㄋㄚˋ ㄕˊ ㄏㄡ˙
明星	ㄇㄧㄥˊ ㄒㄧㄥ
那樣	ㄋㄚˋ ㄧㄤˋ
南方	ㄋㄢˊ ㄈㄤ
難過	ㄋㄢˊ ㄍㄨㄛˋ
難看	ㄋㄢˊ ㄎㄢˋ
難受	ㄋㄢˊ ㄕㄡˋ
難聽	ㄋㄢˊ ㄊㄧㄥ
能夠	ㄋㄥˊ ㄍㄡˋ
年級	ㄋㄧㄢˊ ㄐㄧˊ
難題	ㄋㄢˊ ㄊㄧˊ
年輕	ㄋㄧㄢˊ ㄑㄧㄥ
鳥	ㄋㄧㄠˇ
弄	ㄋㄨㄥˋ
努力	ㄋㄨˇ ㄌㄧˋ
爬山	ㄆㄚˊ ㄕㄢ
排	ㄆㄞˊ
排隊	ㄆㄞˊ ㄉㄨㄟˋ
怕	ㄆㄚˋ
排球	ㄆㄞˊ ㄑㄧㄡˊ
碰	ㄆㄥˋ
爬	ㄆㄚˊ
碰到	ㄆㄥˋ ㄉㄠˋ
碰見	ㄆㄥˋ ㄐㄧㄢ˙
篇	ㄆㄧㄢ
片	ㄆㄧㄢˋ
便宜	ㄅㄧㄢˋ ㄧˊ
平安	ㄆㄧㄣˊ ㄍㄢ
平	ㄆㄧㄥˊ
漂亮	ㄆㄧㄠˋ ㄌㄧㄤ˙
平時	ㄆㄧㄥˊ ㄕˊ
平常	ㄆㄧㄥˊ ㄔㄤˊ
瓶子	ㄆㄧㄥˊ ㄗ˙
平等	ㄆㄧㄥˊ ㄉㄥˇ
瓶	ㄆㄧㄥˊ
普通話	ㄆㄨˇ ㄊㄨㄥ ㄏㄨㄚˋ
其中	ㄑㄧˊ ㄓㄨㄥ
普通	ㄆㄨˇ ㄊㄨㄥ
其他	ㄑㄧˊ ㄊㄚ
騎車	ㄑㄧˊ ㄔㄜ
起飛	ㄑㄧˇ ㄈㄟ
氣	ㄑㄧˋ
騎	ㄑㄧˊ
千	ㄑㄧㄢ
氣溫	ㄑㄧˋ ㄨㄣ
千克	ㄑㄧㄢ ㄎㄜˋ
前年	ㄑㄧㄢˊ ㄋㄧㄢˊ
墻	ㄑㄧㄤˊ
青少年	ㄑㄧㄥ ㄕㄠˋ ㄋㄧㄢˊ
輕	ㄑㄧㄥ
青年	ㄑㄧㄥ ㄋㄧㄢˊ
清楚	ㄑㄧㄥ ㄔㄨ˙
晴天	ㄑㄧㄥˊ ㄊㄧㄢ
請客	ㄑㄧㄥˇ ㄎㄜˋ
晴	ㄑㄧㄥˊ
請求	ㄑㄧㄥˇ ㄑㄧㄡˊ
球場	ㄑㄧㄡˊ ㄔㄤˇ
求	ㄑㄧㄡˊ
球隊	ㄑㄧㄡˊ ㄉㄨㄟˋ
取	ㄑㄩˇ
球鞋	ㄑㄧㄡˊ ㄒㄧㄝˊ
秋天	ㄑㄧㄡ ㄊㄧㄢ
全	ㄑㄩㄢˊ
取得	ㄑㄩˇ ㄉㄜˊ
全部	ㄑㄩㄢˊ ㄅㄨˋ
全家	ㄑㄩㄢˊ ㄐㄧㄚ
全年	ㄑㄩㄢˊ ㄋㄧㄢˊ
全身	ㄑㄩㄢˊ ㄕㄣ
全體	ㄑㄩㄢˊ ㄊㄧˇ
全國	ㄑㄩㄢˊ ㄍㄨㄛˊ
熱情	ㄖㄜˋ ㄑㄧㄥˊ
讓	ㄖㄤˋ
人們	ㄖㄣˊ ㄇㄣ˙
人口	ㄖㄣˊ ㄎㄡˇ
人數	ㄖㄣˊ ㄕㄨˋ
然後	ㄖㄢˊ ㄏㄡˋ
認為	ㄖㄣˋ ㄨㄟˊ
日子	ㄖˋ ㄗ˙
日報	ㄖˋ ㄅㄠˋ
入口	ㄖㄨˋ ㄎㄡˇ
如果	ㄖㄨˊ ㄍㄨㄛˇ
商量	ㄕㄤ ㄌㄧㄤ˙
商人	ㄕㄤ ㄖㄣˊ
上週	ㄕㄤˋ ㄓㄡ
身邊	ㄕㄣ ㄅㄧㄢ
少年	ㄕㄠˋ ㄋㄧㄢˊ
少數	ㄕㄠˇ ㄕㄨˋ
什麼樣	ㄕㄣˊ ㄇㄜ˙ ㄧㄤˋ
生	ㄕㄥ
生詞	ㄕㄥ ㄘˊ
聲音	ㄕㄥ ㄧㄣ
十分	ㄕˊ ㄈㄣ
生活	ㄕㄥ ㄏㄨㄛˊ
實習	ㄕˊ ㄒㄧˊ
實際	ㄕˊ ㄐㄧˋ
省	ㄕㄥˇ
實現	ㄕˊ ㄒㄧㄢˋ
食物	ㄕˊ ㄨˋ
實在	ㄕˊ ㄗㄞ˙
使用	ㄕˇ ㄩㄥˋ
市長	ㄕˋ ㄓㄤˇ
市	ㄕˋ
事情	ㄕˋ ㄑㄧㄥ˙
收到	ㄕㄡ ㄉㄠˋ
收入	ㄕㄡ ㄖㄨˋ
手錶	ㄕㄡˇ ㄅㄧㄠˇ
受到	ㄕㄡˋ ㄉㄠˋ
舒服	ㄕㄨ ㄈㄨ˙
熟	ㄕㄨˊ
收	ㄕㄡ
數字	ㄕㄨˋ ㄗˋ
水平	ㄕㄨㄟˇ ㄆㄧㄥˊ
順利	ㄕㄨㄣˋ ㄌㄧˋ
說明	ㄕㄨㄛ ㄇㄧㄥˊ
司機	ㄙ ㄐㄧ
送到	ㄙㄨㄥˋ ㄉㄠˋ
數	ㄕㄨˋ
算	ㄙㄨㄢˋ
送給	ㄙㄨㄥˋ ㄍㄟˇ
隨便	ㄙㄨㄟˊ ㄅㄧㄢˋ
隨時	ㄙㄨㄟˊ ㄕˊ
所以	ㄙㄨㄛˇ ㄧˇ
雖然	ㄙㄨㄟ ㄖㄢˊ
所有	ㄙㄨㄛˇ ㄧㄡˇ
它	ㄊㄚ
它們	ㄊㄚ ㄇㄣ˙
太太	ㄊㄞˋ ㄊㄞ˙
太陽	ㄊㄞˋ ㄧㄤˊ
討論	ㄊㄠˇ ㄌㄨㄣˋ
態度	ㄊㄞˋ ㄉㄨ˙
套	ㄊㄠˋ
特點	ㄊㄜˋ ㄉㄧㄢˇ
疼	ㄊㄥˊ
提	ㄊㄧˊ
特別	ㄊㄜˋ ㄅㄧㄝˊ
提出	ㄊㄧˊ ㄔㄨ
提到	ㄊㄧˊ ㄉㄠˋ
提高	ㄊㄧˊ ㄍㄠ
體育	ㄊㄧˇ ㄩˋ
題	ㄊㄧˊ
體育場	ㄊㄧˇ ㄩˋ ㄔㄤˇ
體育館	ㄊㄧˇ ㄩˋ ㄍㄨㄢˇ
天上	ㄊㄧㄢ ㄕㄤ˙
條	ㄊㄧㄠˊ
條件	ㄊㄧㄠˊ ㄐㄧㄢˋ
聽說	ㄊㄧㄥ ㄕㄨㄛ
停車	ㄊㄧㄥˊ ㄔㄜ
聽講	ㄊㄧㄥ ㄐㄧㄤˇ
停	ㄊㄧㄥˊ
挺	ㄊㄧㄥˇ
停車場	ㄊㄧㄥˊ ㄔㄜ ㄔㄤˇ
通	ㄊㄨㄥ
挺好	ㄊㄧㄥˇ ㄏㄠˇ
通知	ㄊㄨㄥ ㄓ
同時	ㄊㄨㄥˊ ㄕˊ
同樣	ㄊㄨㄥˊ ㄧㄤˋ
同事	ㄊㄨㄥˊ ㄕˋ
通過	ㄊㄨㄥ ㄍㄨㄛˋ
頭	ㄊㄡˊ
頭髮	ㄊㄡˊ ㄈㄚ˙
圖片	ㄊㄨˊ ㄆㄧㄢˋ
腿	ㄊㄨㄟˇ
外地	ㄨㄞˋ ㄉㄧˋ
完	ㄨㄢˊ
完成	ㄨㄢˊ ㄔㄥˊ
完全	ㄨㄢˊ ㄑㄩㄢˊ
外賣	ㄨㄞˋ ㄇㄞˋ
推	ㄊㄨㄟ
晚報	ㄨㄢˇ ㄅㄠˋ
晚安	ㄨㄚˇ ㄋㄢ
晚餐	ㄨㄢˇ ㄘㄢ
晚會	ㄨㄢˇ ㄏㄨㄟˋ
碗	ㄨㄢˇ
網	ㄨㄤˇ
萬	ㄨㄢˋ
網球	ㄨㄤˇ ㄑㄧㄡˊ
網站	ㄨㄤˇ ㄓㄢˋ
往	ㄨㄤˇ
為什麼	ㄨㄟˋ ㄕㄣˊ ㄇㄜ˙
為	ㄨㄟˋ
位	ㄨㄟˋ
味道	ㄨㄟˋ ㄉㄠ˙
喂	ㄨㄟˋ
聞	ㄨㄣˊ
問路	ㄨㄣˋ ㄌㄨˋ
午餐	ㄨˇ ㄘㄢ
問題	ㄨㄣˋ ㄊㄧˊ
午睡	ㄨˇ ㄕㄨㄟˋ
西北	ㄒㄧ ㄅㄟˇ
溫度	ㄨㄣ ㄉㄨˋ
西南	ㄒㄧ ㄋㄢˊ
西方	ㄒㄧ ㄈㄤ
西醫	ㄒㄧ ㄧ
西餐	ㄒㄧ ㄘㄢ
習慣	ㄒㄧˊ ㄍㄨㄢˋ
洗衣機	ㄒㄧˇ ㄧ ㄐㄧ
下	ㄒㄧㄚˋ
洗澡	ㄒㄧˇ ㄗㄠˇ
下週	ㄒㄧㄚˋ ㄓㄡ
相同	ㄒㄧㄤ ㄊㄨㄥˊ
夏天	ㄒㄧㄚˋ ㄊㄧㄢ
相信	ㄒㄧㄤ ㄒㄧㄣˋ
想到	ㄒㄧㄤˇ ㄉㄠˋ
想法	ㄒㄧㄤˇ ㄈㄚ˙
下雪	ㄒㄧㄚˋ ㄒㄩㄝˇ
想起	ㄒㄧㄤˇ ㄑㄧˇ
嚮	ㄒㄧㄤˋ
相機	ㄒㄧㄤˋ ㄐㄧ
響	ㄒㄧㄤˇ
像	ㄒㄧㄤˋ
小聲	ㄒㄧㄠˇ ㄕㄥ
小時候	ㄒㄧㄠˇ ㄕˊ ㄏㄡ˙
小說	ㄒㄧㄠˇ ㄕㄨㄛ
小心	ㄒㄧㄠˇ ㄒㄧㄣ˙
小	ㄒㄧㄠˇ
小組	ㄒㄧㄠˇ ㄗㄨˇ
校園	ㄒㄧㄠˋ ㄩㄢˊ
校長	ㄒㄧㄠˋ ㄓㄤˇ
笑話兒	ㄒㄧㄠˋ ㄏㄨㄚ˙ ㄦ˙
笑話	ㄒㄧㄠˋ ㄏㄨㄚ˙
心裡	ㄒㄧㄣ ㄌㄧ˙
心情	ㄒㄧㄣ ㄑㄧㄥˊ
鞋	ㄒㄧㄝˊ
心中	ㄒㄧㄣ ㄓㄨㄥ
信	ㄒㄧㄣˋ
新聞	ㄒㄧㄣ ㄨㄣˊ
信號	ㄒㄧㄣˋ ㄏㄠˋ
信心	ㄒㄧㄣˋ ㄒㄧㄣ
信用卡	ㄒㄧㄣˋ ㄩㄥˋ ㄎㄚˇ
信息	ㄒㄧㄣˋ ㄒㄧ
星星	ㄒㄧㄥ ㄒㄧㄥ˙
行動	ㄒㄧㄥˊ ㄉㄨㄥˋ
行人	ㄒㄧㄥˊ ㄖㄣˊ
姓	ㄒㄧㄥˋ
行為	ㄒㄧㄥˊ ㄨㄟˊ
姓名	ㄒㄧㄥˋ ㄇㄧㄥˊ
學期	ㄒㄩㄝˊ ㄑㄧ
休假	ㄒㄧㄡ ㄐㄧㄚˋ
許多	ㄒㄩˇ ㄉㄨㄛ
選	ㄒㄩㄢˇ
顏色	ㄧㄢˊ ㄙㄜˋ
雪	ㄒㄩㄝˇ
眼睛	ㄧㄢˇ ㄐㄧㄥ˙
眼	ㄧㄢˇ
養	ㄧㄤˇ
樣子	ㄧㄤˋ ㄗ˙
要求	ㄧㄠ ㄑㄧㄡˊ
藥片	ㄧㄠˋ ㄆㄧㄢˋ
藥	ㄧㄠˋ
也許	ㄧㄝˇ ㄒㄩˇ
藥水	ㄧㄠˋ ㄕㄨㄟˇ
夜	ㄧㄝˋ
藥店	ㄧㄠˋ ㄉㄧㄢˋ
夜裡	ㄧㄝˋ ㄌㄧ˙
一定	ㄧ ㄉㄧㄥˋ
一部分	ㄧ ㄅㄨˋ ㄈㄣ˙
一會兒	ㄧ ㄏㄨㄟˋ ㄦ˙
一路平安	ㄧ ㄌㄨˋ-ㄆㄧㄣˊ ㄍㄢ
已經	ㄧˇ ㄐㄧㄥ
一路順風	ㄧ ㄌㄨˋ ㄕㄨㄣˋ ㄈㄥ
以前	ㄧˇ ㄑㄧㄢˊ
一共	ㄧ ㄍㄨㄥˋ
以後	ㄧˇ ㄏㄡˋ
以上	ㄧˇ ㄕㄤˋ
以外	ㄧˇ ㄨㄞˋ
椅子	ㄧˇ ㄗ˙
以下	ㄧˇ ㄒㄧㄚˋ
一點點	ㄧ ㄉㄧㄢˇ ㄉㄧㄢˇ
一般	ㄧ ㄅㄢ
一生	ㄧ ㄕㄥ
一直	ㄧ ㄓˊ
億	ㄧˋ
以為	ㄧˇ ㄨㄟˊ
因為	ㄧㄣ ㄨㄟ˙
意見	ㄧˋ ㄐㄧㄢ˙
意思	ㄧˋ ㄙ˙
陰天	ㄧㄣ ㄊㄧㄢ
音節	ㄧㄣ ㄐㄧㄝˊ
音樂	ㄧㄣ ㄩㄝˋ
音樂會	ㄧㄣ ㄩㄝˋ ㄏㄨㄟˋ
銀行卡	ㄧㄣˊ ㄏㄤˊ ㄎㄚˇ
應該	ㄧㄥ ㄍㄞ
銀行	ㄧㄣˊ ㄏㄤˊ
英文	ㄧㄥ ㄨㄣˊ
英語	ㄧㄥ ㄩˇ
影片	ㄧㄥˇ ㄆㄧㄢˋ
陰	ㄧㄣ
影響	ㄧㄥˇ ㄒㄧㄤˇ
油	ㄧㄡˊ
永遠	ㄩㄥˇ ㄩㄢˇ
有空兒	ㄧㄡˇ ㄎㄨㄥˋ ㄦ˙
友好	ㄧㄡˇ ㄏㄠˇ
有點兒	ㄧㄡˇ ㄉㄧㄢˇ ㄦ˙
遊客	ㄧㄡˊ ㄎㄜˋ
有人	ㄧㄡˇ ㄖㄣˊ
有意思	ㄧㄡˇ ㄧˋ ㄙ˙
語言	ㄩˇ ㄧㄢˊ
又	ㄧㄡˋ
原來	ㄩㄢˊ ㄌㄞˊ
原因	ㄩㄢˊ ㄧㄣ
魚	ㄩˊ
院長	ㄩㄢˋ ㄓㄤˇ
院	ㄩㄢˋ
願意	ㄩㄢˋ ㄧ˙
月份	ㄩㄝˋ ㄈㄣˋ
月亮	ㄩㄝˋ ㄌㄧㄤ˙
越來越	ㄩㄝˋ ㄌㄞˊ ㄩㄝˋ
越	ㄩㄝˋ
運動	ㄩㄣˋ ㄉㄨㄥ˙
雲	ㄩㄣˊ
咱們	ㄗㄢˊ ㄇㄣ˙
咱	ㄗㄢˊ
臟	ㄗㄤˋ
院子	ㄩㄢˋ ㄗ˙
早餐	ㄗㄠˇ ㄘㄢ
早晨	ㄗㄠˇ ㄔㄣ˙
怎麼辦	ㄗㄣˇ ㄇㄜ˙ ㄅㄢˋ
怎麼樣	ㄗㄣˇ ㄇㄜ˙ ㄧㄤˋ
早就	ㄗㄠˇ ㄐㄧㄡˋ
怎樣	ㄗㄣˇ ㄧㄤˋ
占	ㄓㄢˋ
站住	ㄓㄢˋ ㄓㄨˋ
長大	ㄓㄤˇ ㄉㄚˋ
站	ㄓㄢˋ
找出	ㄓㄠˇ ㄔㄨ
照片	ㄓㄠˋ ㄆㄧㄢˋ
照相	ㄓㄠˋ ㄒㄧㄤˋ
照顧	ㄓㄠˋ ㄍㄨ˙
這麼	ㄓㄜˋ ㄇㄜ˙
這時候	ㄓㄜˋ ㄕˊ ㄏㄡˋ
真正	ㄓㄣ ㄓㄥˋ
正常	ㄓㄥˋ ㄔㄤˊ
正是	ㄓㄥˋ ㄕˋ
這樣	ㄓㄜˋ ㄧㄤˋ
正確	ㄓㄥˋ ㄑㄩㄝˋ
只	ㄓˇ
只能	ㄓˇ ㄋㄥˊ
直接	ㄓˊ ㄐㄧㄝ
正好	ㄓㄥˋ ㄏㄠˇ
紙	ㄓˇ
只要	ㄓˇ ㄧㄠˋ
中級	ㄓㄨㄥ ㄐㄧˊ
中年	ㄓㄨㄥ ㄋㄧㄢˊ
中小學	ㄓㄨㄥ ㄒㄧㄠˇ ㄒㄩㄝˊ
中心	ㄓㄨㄥ ㄒㄧㄣ
中餐	ㄓㄨㄥ ㄘㄢ
中醫	ㄓㄨㄥ ㄧ
重視	ㄓㄨㄥˋ ㄕˋ
周	ㄓㄡ
週末	ㄓㄡ ㄇㄛˋ
週年	ㄓㄡ ㄋㄧㄢˊ
重點	ㄓㄨㄥˋ ㄉㄧㄢˇ
住房	ㄓㄨˋ ㄈㄤˊ
主人	ㄓㄨˇ ㄖㄣˊ
住院	ㄓㄨˋ ㄩㄢˋ
自己	ㄗˋ ㄐㄧˇ
裝	ㄓㄨㄤ
準確	ㄓㄨㄣˇ ㄑㄩㄝˋ
自行車	ㄗˋ ㄒㄧㄥˊ ㄔㄜ
自由	ㄗˋ ㄧㄡˊ
字典	ㄗˋ ㄉㄧㄢˇ
走過	ㄗㄡˇ ㄍㄨㄛˋ
走進	ㄗㄡˇ ㄐㄧㄣˋ
租	ㄗㄨ
組	ㄗㄨˇ
走開	ㄗㄡˇ ㄎㄞ
組成	ㄗㄨˇ ㄔㄥˊ
主要	ㄓㄨˇ ㄧㄠˋ
嘴	ㄗㄨㄟˇ
最近	ㄗㄨㄟˋ ㄐㄧㄣˋ
組長	ㄗㄨˇ ㄓㄤˇ
作家	ㄗㄨㄛˋ ㄐㄧㄚ
作文	ㄗㄨㄛˋ ㄨㄣˊ
作用	ㄗㄨㄛˋ ㄩㄥˋ
座	ㄗㄨㄛˋ
座位	ㄗㄨㄛˋ ㄨㄟ˙
做到	ㄗㄨㄛˋ ㄉㄠˋ
做法	ㄗㄨㄛˋ ㄈㄚ˙
作業	ㄗㄨㄛˋ ㄧㄝˋ
做飯	ㄗㄨㄛˋ ㄈㄢˋ
