挨著	ㄞ ㄓㄜ˙
挨	ㄞ
安檢	ㄢ ㄐㄧㄢˇ
罷工	ㄅㄚˋ ㄍㄨㄥ
挨打	ㄞˊ ㄉㄚˇ
白領	ㄅㄞˊ ㄌㄧㄥˇ
辦公	ㄅㄢˋ ㄍㄨㄥ
百分點	ㄅㄞˇ ㄈㄣ ㄉㄧㄢˇ
辦學	ㄅㄢˋ ㄒㄩㄝˊ
辦事處	ㄅㄢˋ ㄕˋ ㄔㄨˋ
半決賽	ㄅㄢˋ ㄐㄩㄝˊ ㄙㄞˋ
罷了	ㄅㄚˋ ㄌㄜ˙
保健	ㄅㄠˇ ㄐㄧㄢˋ
報刊	ㄅㄠˋ ㄎㄢ
傍晚	ㄅㄤˋ ㄨㄢˇ
暴風雨	ㄅㄠˋ ㄈㄥ ㄩˇ
抱歉	ㄅㄠˋ ㄑㄧㄢˋ
暴露	ㄅㄠˋ ㄌㄨˋ
報考	ㄅㄠˋ ㄎㄠˇ
爆	ㄅㄠˋ
暴雨	ㄅㄠˋ ㄩˇ
爆炸	ㄅㄠˋ ㄓㄚˋ
暴力	ㄅㄠˋ ㄌㄧˋ
悲慘	ㄅㄟ ㄘㄢˇ
爆發	ㄅㄠˋ ㄈㄚ
背著	ㄅㄟ ㄓㄜ˙
背心	ㄅㄟˋ ㄒㄧㄣ
本	ㄅㄣˇ
奔跑	ㄅㄣ ㄆㄠˇ
被告	ㄅㄟˋ ㄍㄠˋ
本期	ㄅㄣˇ ㄑㄧ
本身	ㄅㄣˇ ㄕㄣ
本質	ㄅㄣˇ ㄓˋ
本土	ㄅㄣˇ ㄊㄨˇ
逼	ㄅㄧ
本地	ㄅㄣˇ ㄉㄧˋ
必將	ㄅㄧˋ ㄐㄧㄤ
筆試	ㄅㄧˇ ㄕˋ
邊緣	ㄅㄧㄢ ㄩㄢˊ
必修	ㄅㄧˋ ㄒㄧㄡ
閉	ㄅㄧˋ
扁	ㄅㄧㄢˇ
編制	ㄅㄧㄢ ㄓˋ
變更	ㄅㄧㄢˋ ㄍㄥ
變形	ㄅㄧㄢˋ ㄒㄧㄥˊ
變換	ㄅㄧㄢˋ ㄏㄨㄢˋ
便是	ㄅㄧㄢˋ ㄕˋ
便	ㄅㄧㄢˋ
遍地	ㄅㄧㄢˋ ㄉㄧˋ
表面上	ㄅㄧㄠˇ ㄇㄧㄢˋ ㄕㄤ˙
病情	ㄅㄧㄥˋ ㄑㄧㄥˊ
撥打	ㄅㄛ ㄉㄚˇ
病房	ㄅㄧㄥˋ ㄈㄤˊ
波浪	ㄅㄛ ㄌㄤˋ
播	ㄅㄛ
波動	ㄅㄛ ㄉㄨㄥˋ
不見	ㄅㄨˋ ㄐㄧㄢˋ
不便	ㄅㄨˋ ㄅㄧㄢˋ
不再	ㄅㄨˋ ㄗㄞˋ
不料	ㄅㄨˋ ㄌㄧㄠˋ
不至於	ㄅㄨˋ ㄓˋ ㄩˊ
補考	ㄅㄨˇ ㄎㄠˇ
補習	ㄅㄨˇ ㄒㄧˊ
補課	ㄅㄨˇ ㄎㄜˋ
補助	ㄅㄨˇ ㄓㄨˋ
不成	ㄅㄨˋ ㄔㄥˊ
捕	ㄅㄨˇ
不禁	ㄅㄨˋ ㄐㄧㄣ
不僅僅	ㄅㄨˋ ㄐㄧㄣˇ ㄐㄧㄣˇ
不通	ㄅㄨˋ ㄊㄨㄥ
不怎麼樣	ㄅㄨˋ ㄗㄣˇ ㄇㄜ˙ ㄧㄤˋ
不值	ㄅㄨˋ ㄓˊ
不怎麼	ㄅㄨˋ ㄗㄣˇ ㄇㄜ˙
布滿	ㄅㄨˋ ㄇㄢˇ
部隊	ㄅㄨˋ ㄉㄨㄟˋ
採納	ㄘㄞˇ ㄋㄚˋ
參賽	ㄘㄢ ㄙㄞˋ
踩	ㄘㄞˇ
參展	ㄘㄢ ㄓㄢˇ
餐	ㄘㄢ
殘疾	ㄘㄢˊ ㄐㄧ˙
殘疾人	ㄘㄢˊ ㄐㄧˊ ㄖㄣˊ
殘酷	ㄘㄢˊ ㄎㄨˋ
倉庫	ㄘㄤ ㄎㄨˋ
慘	ㄘㄢˇ
藏	ㄘㄤˊ
操縱	ㄘㄠ ㄗㄨㄥˋ
側	ㄘㄜˋ
廁所	ㄘㄜˋ ㄙㄨㄛˇ
測定	ㄘㄜˋ ㄉㄧㄥˋ
策劃	ㄘㄜˋ ㄏㄨㄚˋ
策略	ㄘㄜˋ ㄌㄩㄝˋ
層面	ㄘㄥˊ ㄇㄧㄢˋ
差異	ㄔㄚ ㄧˋ
查出	ㄔㄚˊ ㄔㄨ
查看	ㄔㄚˊ ㄎㄢˋ
拆遷	ㄔㄞ ㄑㄧㄢ
產量	ㄔㄢˇ ㄌㄧㄤˋ
昌盛	ㄔㄤ ㄕㄥˋ
長假	ㄔㄤˊ ㄐㄧㄚˋ
長短	ㄔㄤˊ ㄉㄨㄢˇ
長跑	ㄔㄤˊ ㄆㄠˇ
長遠	ㄔㄤˊ ㄩㄢˇ
常規	ㄔㄤˊ ㄍㄨㄟ
長久	ㄔㄤˊ ㄐㄧㄡˇ
常年	ㄔㄤˊ ㄋㄧㄢˊ
場地	ㄔㄤˇ ㄉㄧˋ
廠商	ㄔㄤˇ ㄕㄤ
場館	ㄔㄤˇ ㄍㄨㄢˇ
場景	ㄔㄤˇ ㄐㄧㄥˇ
暢通	ㄔㄤˋ ㄊㄨㄥ
超出	ㄔㄠ ㄔㄨ
炒	ㄔㄠˇ
超	ㄔㄠ
炒股	ㄔㄠˇ ㄍㄨˇ
車號	ㄔㄜ ㄏㄠˋ
炒作	ㄔㄠˇ ㄗㄨㄛˋ
車展	ㄔㄜ ㄓㄢˇ
車牌	ㄔㄜ ㄆㄞˊ
撤銷	ㄔㄜˋ ㄒㄧㄠ
撤離	ㄔㄜˋ ㄌㄧˊ
撐	ㄔㄥ
成分	ㄔㄥˊ ㄈㄣ˙
成品	ㄔㄥˊ ㄆㄧㄣˇ
承諾	ㄔㄥˊ ㄋㄨㄛˋ
城區	ㄔㄥˊ ㄑㄩ
城鄉	ㄔㄥˊ ㄒㄧㄤ
城鎮	ㄔㄥˊ ㄓㄣˋ
成	ㄔㄥˊ
衝擊	ㄔㄨㄥ ㄐㄧ
持有	ㄔˊ ㄧㄡˇ
重建	ㄔㄨㄥˊ ㄐㄧㄢˋ
寵物	ㄔㄨㄥˇ ㄨˋ
崇拜	ㄔㄨㄥˊ ㄅㄞˋ
重組	ㄔㄨㄥˊ ㄗㄨˇ
沖	ㄔㄨㄥ
出場	ㄔㄨ ㄔㄤˇ
出動	ㄔㄨ ㄉㄨㄥˋ
出訪	ㄔㄨ ㄈㄤˇ
出路	ㄔㄨ ㄌㄨˋ
出面	ㄔㄨ ㄇㄧㄢˋ
出入	ㄔㄨ ㄖㄨˋ
出事	ㄔㄨ ㄕˋ
出名	ㄔㄨ ㄇㄧㄥˊ
出臺	ㄔㄨ ㄊㄞˊ
初等	ㄔㄨ ㄉㄥˇ
除	ㄔㄨˊ
出行	ㄔㄨ ㄒㄧㄥˊ
廚師	ㄔㄨˊ ㄕ
儲存	ㄔㄨˇ ㄘㄨㄣˊ
處處	ㄔㄨˋ ㄔㄨˋ
處長	ㄔㄨˋ ㄓㄤˇ
傳輸	ㄔㄨㄢˊ ㄕㄨ
傳媒	ㄔㄨㄢˊ ㄇㄟˊ
傳言	ㄔㄨㄢˊ ㄧㄢˊ
傳出	ㄔㄨㄢˊ ㄔㄨ
船員	ㄔㄨㄢˊ ㄩㄢˊ
船隻	ㄔㄨㄢˊ ㄓ
船長	ㄔㄨㄢˊ ㄓㄤˇ
串	ㄔㄨㄢˋ
窗口	ㄔㄨㄤ ㄎㄡˇ
創建	ㄔㄨㄤˋ ㄐㄧㄢˋ
創意	ㄔㄨㄤˋ ㄧˋ
創辦	ㄔㄨㄤˋ ㄅㄢˋ
此處	ㄘˇ ㄔㄨˋ
此前	ㄘˇ ㄑㄧㄢˊ
此次	ㄘˇ ㄘˋ
此事	ㄘˇ ㄕˋ
次數	ㄘˋ ㄕㄨˋ
此致	ㄘˇ ㄓˋ
從不	ㄘㄨㄥˊ ㄅㄨˋ
從沒	ㄘㄨㄥˊ ㄇㄟˊ
醋	ㄘㄨˋ
村莊	ㄘㄨㄣ ㄓㄨㄤ
搭	ㄉㄚ
錯過	ㄘㄨㄛˋ ㄍㄨㄛˋ
搭配	ㄉㄚ ㄆㄟˋ
搭檔	ㄉㄚ ㄉㄤˋ
打動	ㄉㄚˇ ㄉㄨㄥˋ
打斷	ㄉㄚˇ ㄉㄨㄢˋ
打牌	ㄉㄚˇ ㄆㄞˊ
打發	ㄉㄚˇ ㄈㄚ˙
打官司	ㄉㄚˇ ㄍㄨㄢ ㄙ˙
打印機	ㄉㄚˇ ㄧㄣˋ ㄐㄧ
大道	ㄉㄚˋ ㄉㄠˋ
打造	ㄉㄚˇ ㄗㄠˋ
大街	ㄉㄚˋ ㄐㄧㄝ
大米	ㄉㄚˋ ㄇㄧˇ
大批	ㄉㄚˋ ㄆㄧ
大賽	ㄉㄚˋ ㄙㄞˋ
大師	ㄉㄚˋ ㄕ
大力	ㄉㄚˋ ㄌㄧˋ
大使	ㄉㄚˋ ㄕˇ
待會兒	ㄉㄞ ㄏㄨㄟ˙ ㄦ˙
擔憂	ㄉㄢ ㄧㄡ
誕生	ㄉㄢˋ ㄕㄥ
單打	ㄉㄢ ㄉㄚˇ
黨	ㄉㄤˇ
當	ㄉㄤ
當天	ㄉㄤ ㄊㄧㄢ
當成	ㄉㄤˋ ㄔㄥˊ
檔	ㄉㄤˋ
當作	ㄉㄤˋ ㄗㄨㄛˋ
檔案	ㄉㄢˋ ㄍㄢˋ
到期	ㄉㄠˋ ㄑㄧ
盜版	ㄉㄠˋ ㄅㄢˇ
島	ㄉㄠˇ
道教	ㄉㄠˋ ㄐㄧㄠˋ
道歉	ㄉㄠˋ ㄑㄧㄢˋ
低溫	ㄉㄧ ㄨㄣ
低頭	ㄉㄧ ㄊㄡˊ
抵達	ㄉㄧˇ ㄉㄚˊ
抵抗	ㄉㄧˇ ㄎㄤˋ
地名	ㄉㄧˋ ㄇㄧㄥˊ
地板	ㄉㄧˋ ㄅㄢˇ
地下室	ㄉㄧˋ ㄒㄧㄚˋ ㄕˋ
電動	ㄉㄧㄢˋ ㄉㄨㄥˋ
滴	ㄉㄧ
電車	ㄉㄧㄢˋ ㄔㄜ
電器	ㄉㄧㄢˋ ㄑㄧˋ
電力	ㄉㄧㄢˋ ㄌㄧˋ
吊	ㄉㄧㄠˋ
調研	ㄉㄧㄠˋ ㄧㄢˊ
定價	ㄉㄧㄥˋ ㄐㄧㄚˋ
定時	ㄉㄧㄥˋ ㄕˊ
跌	ㄉㄧㄝ
定位	ㄉㄧㄥˋ ㄨㄟˋ
鬥爭	ㄉㄡˋ ㄓㄥ
動畫	ㄉㄨㄥˋ ㄏㄨㄚˋ
毒品	ㄉㄨˊ ㄆㄧㄣˇ
賭	ㄉㄨˇ
賭博	ㄉㄨˇ ㄅㄛˊ
端	ㄉㄨㄢ
都市	ㄉㄨ ㄕˋ
端午節	ㄉㄨㄢ ㄨˇ ㄐㄧㄝˊ
短片	ㄉㄨㄢˇ ㄆㄧㄢˋ
渡	ㄉㄨˋ
隊伍	ㄉㄨㄟˋ ㄨ˙
對外	ㄉㄨㄟˋ ㄨㄞˋ
對抗	ㄉㄨㄟˋ ㄎㄤˋ
多半	ㄉㄨㄛ ㄅㄢˋ
多方面	ㄉㄨㄛ ㄈㄤ ㄇㄧㄢˋ
多媒體	ㄉㄨㄛ ㄇㄟˊ ㄊㄧˇ
奪	ㄉㄨㄛˊ
蹲	ㄉㄨㄣ
奪取	ㄉㄨㄛˊ ㄑㄩˇ
恩人	ㄣ ㄖㄣˊ
兒科	ㄦˊ ㄎㄜ
發病	ㄈㄚ ㄅㄧㄥˋ
發電	ㄈㄚ ㄉㄧㄢˋ
發放	ㄈㄚ ㄈㄤˋ
發起	ㄈㄚ ㄑㄧˇ
發怒	ㄈㄚ ㄋㄨˋ
發言人	ㄈㄚ ㄧㄢˊ ㄖㄣˊ
法庭	ㄈㄚˇ ㄊㄧㄥˊ
發炎	ㄈㄚ ㄧㄢˊ
番	ㄈㄢ
番茄	ㄈㄢ ㄑㄧㄝˊ
凡是	ㄈㄢˊ ㄕˋ
法語	ㄈㄚˇ ㄩˇ
繁殖	ㄈㄢˊ ㄓˊ
反問	ㄈㄢˇ ㄨㄣˋ
反響	ㄈㄢˇ ㄒㄧㄤˇ
犯規	ㄈㄢˋ ㄍㄨㄟ
犯	ㄈㄢˋ
反抗	ㄈㄢˇ ㄎㄤˋ
犯罪	ㄈㄢˋ ㄗㄨㄟˋ
防守	ㄈㄤˊ ㄕㄡˇ
房價	ㄈㄤˊ ㄐㄧㄚˋ
防範	ㄈㄤˊ ㄈㄢˋ
仿佛	ㄈㄤˇ ㄈㄨˊ
飛船	ㄈㄟ ㄔㄨㄢˊ
飛行員	ㄈㄟ ㄒㄧㄥˊ ㄩㄢˊ
肺	ㄈㄟˋ
分工	ㄈㄣ ㄍㄨㄥ
憤怒	ㄈㄣˋ ㄋㄨˋ
分裂	ㄈㄣ ㄌㄧㄝˋ
峰會	ㄈㄥ ㄏㄨㄟˋ
奉獻	ㄈㄥˋ ㄒㄧㄢˋ
風暴	ㄈㄥ ㄅㄠˋ
佛教	ㄈㄛˊ ㄐㄧㄠˋ
佛	ㄈㄨˊ
服	ㄈㄨˊ
父女	ㄈㄨˋ ㄋㄩˇ
父子	ㄈㄨˋ ㄗˇ
負	ㄈㄨˋ
浮	ㄈㄨˊ
婦女	ㄈㄨˋ ㄋㄩˇ
副	ㄈㄨˋ
復蘇	ㄈㄨˋ ㄙㄨ
富人	ㄈㄨˋ ㄖㄣˊ
改裝	ㄍㄞˇ ㄓㄨㄤ
干涉	ㄍㄢ ㄕㄜˋ
肝	ㄍㄢ
富有	ㄈㄨˋ ㄧㄡˇ
杆	ㄍㄢ
趕不上	ㄍㄢˇ ㄅㄨ˙ ㄕㄤˋ
趕上	ㄍㄢˇ ㄕㄤˋ
趕忙	ㄍㄢˇ ㄇㄤˊ
剛好	ㄍㄤ ㄏㄠˇ
感人	ㄍㄢˇ ㄖㄣˊ
崗位	ㄍㄤˇ ㄨㄟˋ
港口	ㄍㄤˇ ㄎㄡˇ
高層	ㄍㄠ ㄘㄥˊ
敢於	ㄍㄢˇ ㄩˊ
高檔	ㄍㄠ ㄉㄤˋ
高峰	ㄍㄠ ㄈㄥ
高等	ㄍㄠ ㄉㄥˇ
高考	ㄍㄠ ㄎㄠˇ
高科技	ㄍㄠ ㄎㄜ ㄐㄧˋ
稿子	ㄍㄠˇ ㄗ˙
高手	ㄍㄠ ㄕㄡˇ
歌詞	ㄍㄜ ㄘˊ
歌星	ㄍㄜ ㄒㄧㄥ
革新	ㄍㄜˊ ㄒㄧㄣ
工商	ㄍㄨㄥ ㄕㄤ
公	ㄍㄨㄥ
更是	ㄍㄥˋ ㄕˋ
公雞	ㄍㄨㄥ ㄐㄧ
公眾	ㄍㄨㄥ ㄓㄨㄥˋ
公安	ㄍㄨㄥ ㄢ
歌唱	ㄍㄜ ㄔㄤˋ
攻擊	ㄍㄨㄥ ㄐㄧ
供給	ㄍㄨㄥ ㄐㄧˇ
宮	ㄍㄨㄥ
公主	ㄍㄨㄥ ㄓㄨˇ
鞏固	ㄍㄨㄥˇ ㄍㄨˋ
貢獻	ㄍㄨㄥˋ ㄒㄧㄢˋ
孤獨	ㄍㄨ ㄉㄨˊ
孤兒	ㄍㄨ ㄦˊ
古典	ㄍㄨˇ ㄉㄧㄢˇ
構建	ㄍㄡˋ ㄐㄧㄢˋ
股	ㄍㄨˇ
姑姑	ㄍㄨ ㄍㄨ˙
股票	ㄍㄨˇ ㄆㄧㄠˋ
故障	ㄍㄨˋ ㄓㄤˋ
顧	ㄍㄨˋ
刮	ㄍㄨㄚ
拐	ㄍㄨㄞˇ
關愛	ㄍㄨㄚ ㄋㄞˋ
關聯	ㄍㄨㄢ ㄌㄧㄢˊ
觀光	ㄍㄨㄢ ㄍㄨㄤ
官司	ㄍㄨㄢ ㄙ˙
管道	ㄍㄨㄢˇ ㄉㄠˋ
廣闊	ㄍㄨㄤˇ ㄎㄨㄛˋ
股東	ㄍㄨˇ ㄉㄨㄥ
光輝	ㄍㄨㄤ ㄏㄨㄟ
軌道	ㄍㄨㄟˇ ㄉㄠˋ
跪	ㄍㄨㄟˋ
國產	ㄍㄨㄛˊ ㄔㄢˇ
國會	ㄍㄨㄛˊ ㄏㄨㄟˋ
國旗	ㄍㄨㄛˊ ㄑㄧˊ
國王	ㄍㄨㄛˊ ㄨㄤˊ
果醬	ㄍㄨㄛˇ ㄐㄧㄤˋ
果樹	ㄍㄨㄛˇ ㄕㄨˋ
國歌	ㄍㄨㄛˊ ㄍㄜ
過後	ㄍㄨㄛˋ ㄏㄡˋ
過渡	ㄍㄨㄛˋ ㄉㄨˋ
海報	ㄏㄞˇ ㄅㄠˋ
過時	ㄍㄨㄛˋ ㄕˊ
海浪	ㄏㄞˇ ㄌㄤˋ
海外	ㄏㄞˇ ㄨㄞˋ
海底	ㄏㄞˇ ㄉㄧˇ
海軍	ㄏㄞˇ ㄐㄩㄣ
海洋	ㄏㄞˇ ㄧㄤˊ
海灣	ㄏㄞˇ ㄨㄢ
好轉	ㄏㄠˇ ㄓㄨㄢˇ
好容易	ㄏㄠˇ ㄖㄨㄥˊ ㄧ˙
好學	ㄏㄠˋ ㄒㄩㄝˊ
好似	ㄏㄠˇ ㄙˋ
合約	ㄏㄜˊ ㄩㄝ
核心	ㄏㄜˊ ㄒㄧㄣ
黑夜	ㄏㄟ ㄧㄝˋ
和諧	ㄏㄜˊ ㄒㄧㄝˊ
很難說	ㄏㄣˇ ㄋㄢˊ ㄕㄨㄛ
橫	ㄏㄥˊ
衡量	ㄏㄥˊ ㄌㄧㄤ˙
狠	ㄏㄣˇ
宏大	ㄏㄨㄥˊ ㄉㄚˋ
洪水	ㄏㄨㄥˊ ㄕㄨㄟˇ
互動	ㄏㄨˋ ㄉㄨㄥˋ
忽略	ㄏㄨ ㄌㄩㄝˋ
戶外	ㄏㄨˋ ㄨㄞˋ
護	ㄏㄨˋ
花瓶	ㄏㄨㄚ ㄆㄧㄥˊ
花費	ㄏㄨㄚ ㄈㄟ˙
花生	ㄏㄨㄚ ㄕㄥ
化解	ㄏㄨㄚˋ ㄐㄧㄝˇ
幻想	ㄏㄨㄢˋ ㄒㄧㄤˇ
壺	ㄏㄨˊ
患者	ㄏㄨㄢˋ ㄓㄜˇ
回應	ㄏㄨㄟˊ ㄧㄥˋ
皇帝	ㄏㄨㄤˊ ㄉㄧˋ
會見	ㄏㄨㄟˋ ㄐㄧㄢˋ
會長	ㄏㄨㄟˋ ㄓㄤˇ
毀	ㄏㄨㄟˇ
混	ㄏㄨㄣˋ
繪畫	ㄏㄨㄟˋ ㄏㄨㄚˋ
混亂	ㄏㄨㄣˋ ㄌㄨㄢˋ
混合	ㄏㄨㄣˋ ㄏㄜˊ
活躍	ㄏㄨㄛˊ ㄩㄝˋ
火箭	ㄏㄨㄛˇ ㄐㄧㄢˋ
機動車	ㄐㄧ ㄉㄨㄥˋ ㄔㄜ
昏	ㄏㄨㄣ
機關	ㄐㄧ ㄍㄨㄢ
基督教	ㄐㄧ ㄉㄨ ㄐㄧㄠˋ
機械	ㄐㄧ ㄒㄧㄝˋ
激情	ㄐㄧ ㄑㄧㄥˊ
吉祥	ㄐㄧˊ ㄒㄧㄤˊ
極端	ㄐㄧˊ ㄉㄨㄢ
急救	ㄐㄧˊ ㄐㄧㄡˋ
集	ㄐㄧˊ
疾病	ㄐㄧˊ ㄅㄧㄥˋ
加盟	ㄐㄧㄚ ㄇㄥˊ
吉利	ㄐㄧˊ ㄌㄧˋ
家電	ㄐㄧㄚ ㄉㄧㄢˋ
家園	ㄐㄧㄚ ㄩㄢˊ
嘉賓	ㄐㄧㄚ ㄅㄧㄣ
給予	ㄐㄧˇ ㄩˇ
假日	ㄐㄧㄚˋ ㄖˋ
監督	ㄐㄧㄢ ㄉㄨ
監測	ㄐㄧㄢ ㄘㄜˋ
撿	ㄐㄧㄢˇ
簡介	ㄐㄧㄢˇ ㄐㄧㄝˋ
劍	ㄐㄧㄢˋ
鑒定	ㄐㄧㄢˋ ㄉㄧㄥˋ
箭	ㄐㄧㄢˋ
將軍	ㄐㄧㄤ ㄐㄩㄣ
講課	ㄐㄧㄤˇ ㄎㄜˋ
醬	ㄐㄧㄤˋ
驕傲	ㄐㄧㄠ ㄠˋ
醬油	ㄐㄧㄤˋ ㄧㄡˊ
焦點	ㄐㄧㄠ ㄉㄧㄢˇ
尖	ㄐㄧㄢ
腳印	ㄐㄧㄠˇ ㄧㄣˋ
教堂	ㄐㄧㄠˋ ㄊㄤˊ
教育部	ㄐㄧㄠˋ ㄩˋ ㄅㄨˋ
接收	ㄐㄧㄝ ㄕㄡ
街頭	ㄐㄧㄝ ㄊㄡˊ
覺	ㄐㄩㄝˊ
節	ㄐㄧㄝˊ
節假日	ㄐㄧㄝˊ ㄐㄧㄚˋ ㄖˋ
節能	ㄐㄧㄝˊ ㄋㄥˊ
傑出	ㄐㄧㄝˊ ㄔㄨ
揭	ㄐㄧㄝ
截止	ㄐㄧㄝˊ ㄓˇ
解	ㄐㄧㄝˇ
解說	ㄐㄧㄝˇ ㄕㄨㄛ
截至	ㄐㄧㄝˊ ㄓˋ
界	ㄐㄧㄝˋ
金額	ㄐㄧ ㄋㄜˊ
節奏	ㄐㄧㄝˊ ㄗㄡˋ
借鑒	ㄐㄧㄝˋ ㄐㄧㄢˋ
金錢	ㄐㄧㄣ ㄑㄧㄢˊ
儘	ㄐㄧㄣˇ
進攻	ㄐㄧㄣˋ ㄍㄨㄥ
近日	ㄐㄧㄣˋ ㄖˋ
近視	ㄐㄧㄣˋ ㄕˋ
驚人	ㄐㄧㄥ ㄖㄣˊ
精	ㄐㄧㄥ
精美	ㄐㄧㄥ ㄇㄟˇ
精品	ㄐㄧㄥ ㄆㄧㄣˇ
井	ㄐㄧㄥˇ
驚喜	ㄐㄧㄥ ㄒㄧˇ
金融	ㄐㄧㄣ ㄖㄨㄥˊ
景點	ㄐㄧㄥˇ ㄉㄧㄢˇ
糾紛	ㄐㄧㄡ ㄈㄣ
糾正	ㄐㄧㄡ ㄓㄥˋ
淨	ㄐㄧㄥˋ
酒水	ㄐㄧㄡˇ ㄕㄨㄟˇ
救命	ㄐㄧㄡˋ ㄇㄧㄥˋ
救援	ㄐㄧㄡˋ ㄩㄢˊ
救助	ㄐㄧㄡˋ ㄓㄨˋ
景	ㄐㄧㄥˇ
就算	ㄐㄧㄡˋ ㄙㄨㄢˋ
就是說	ㄐㄧㄡˋ ㄕˋ ㄕㄨㄛ
據	ㄐㄩˋ
捐	ㄐㄩㄢ
局	ㄐㄩˊ
捐款	ㄐㄩㄢ ㄎㄨㄢˇ
捐贈	ㄐㄩㄢ ㄗㄥˋ
捐助	ㄐㄩㄢ ㄓㄨˋ
劇	ㄐㄩˋ
決策	ㄐㄩㄝˊ ㄘㄜˋ
覺悟	ㄐㄩㄝˊ ㄨˋ
絕	ㄐㄩㄝˊ
絕大多數	ㄐㄩㄝˊ ㄉㄚˋ ㄉㄨㄛ ㄕㄨˋ
軍艦	ㄐㄩㄣ ㄐㄧㄢˋ
軍事	ㄐㄩㄣ ㄕˋ
軍隊	ㄐㄩㄣ ㄉㄨㄟˋ
開關	ㄎㄞ ㄍㄨㄢ
開創	ㄎㄞ ㄔㄨㄤˋ
開通	ㄎㄞ ㄊㄨㄥ˙
開設	ㄎㄞ ㄕㄜˋ
開夜車	ㄎㄞ ㄧㄝˋ ㄔㄜ
看得見	ㄎㄢˋ ㄉㄜˊ ㄐㄧㄢˋ
開頭	ㄎㄞ ㄊㄡˊ
看	ㄎㄢˋ
看管	ㄎㄢ ㄍㄨㄢˇ
看得起	ㄎㄢˋ ㄉㄜ˙ ㄑㄧˇ
看作	ㄎㄢˋ ㄗㄨㄛˋ
康復	ㄎㄤ ㄈㄨˋ
看好	ㄎㄢˋ ㄏㄠˇ
考場	ㄎㄠˇ ㄔㄤˇ
抗議	ㄎㄤˋ ㄧˋ
科研	ㄎㄜ ㄧㄢˊ
客車	ㄎㄜˋ ㄔㄜ
考題	ㄎㄠˇ ㄊㄧˊ
空軍	ㄎㄨㄥ ㄐㄩㄣ
肯	ㄎㄣˇ
口試	ㄎㄡˇ ㄕˋ
扣	ㄎㄡˋ
跨	ㄎㄨㄚˋ
快車	ㄎㄨㄞˋ ㄔㄜ
酷	ㄎㄨˋ
礦	ㄎㄨㄤˋ
寬闊	ㄎㄨㄢ ㄎㄨㄛˋ
闊	ㄎㄨㄛˋ
來往	ㄌㄞˊ ㄨㄤ˙
賴	ㄌㄞˋ
啦	ㄌㄚ˙
藍天	ㄌㄢˊ ㄊㄧㄢ
欄目	ㄌㄢˊ ㄇㄨˋ
藍領	ㄌㄢˊ ㄌㄧㄥˇ
牢	ㄌㄠˊ
老鄉	ㄌㄠˇ ㄒㄧㄤ
冷氣	ㄌㄥˇ ㄑㄧˋ
冷水	ㄌㄥˇ ㄕㄨㄟˇ
理財	ㄌㄧˇ ㄘㄞˊ
禮堂	ㄌㄧˇ ㄊㄤˊ
理	ㄌㄧˇ
力	ㄌㄧˋ
理智	ㄌㄧˇ ㄓˋ
聯盟	ㄌㄧㄢˊ ㄇㄥˊ
利	ㄌㄧˋ
懶	ㄌㄢˇ
聯賽	ㄌㄧㄢˊ ㄙㄞˋ
涼鞋	ㄌㄧㄤˊ ㄒㄧㄝˊ
兩側	ㄌㄧㄤˇ ㄘㄜˋ
兩手	ㄌㄧㄤˇ ㄕㄡˇ
聊天兒	ㄌㄧㄠˊ ㄊㄧㄢ ㄦ˙
聊	ㄌㄧㄠˊ
聯手	ㄌㄧㄢˊ ㄕㄡˇ
靈活	ㄌㄧㄥˊ ㄏㄨㄛˊ
裂	ㄌㄧㄝˋ
料	ㄌㄧㄠˋ
領袖	ㄌㄧㄥˇ ㄒㄧㄡˋ
留言	ㄌㄧㄡˊ ㄧㄢˊ
另	ㄌㄧㄥˋ
流感	ㄌㄧㄡˊ ㄍㄢˇ
樓道	ㄌㄡˊ ㄉㄠˋ
樓房	ㄌㄡˊ ㄈㄤˊ
領取	ㄌㄧㄥˇ ㄑㄩˇ
陸軍	ㄌㄨˋ ㄐㄩㄣ
錄像	ㄌㄨˋ ㄒㄧㄤˋ
露	ㄌㄨˋ
錄音機	ㄌㄨˋ ㄧㄣ ㄐㄧ
旅店	ㄌㄩˇ ㄉㄧㄢˋ
馬車	ㄇㄚˇ ㄔㄜ
路過	ㄌㄨˋ ㄍㄨㄛˋ
埋	ㄇㄞˊ
綠化	ㄌㄩˋ ㄏㄨㄚˋ
慢車	ㄇㄢˋ ㄔㄜ
饅頭	ㄇㄢˊ ㄊㄡ˙
盲人	ㄇㄤˊ ㄖㄣˊ
嘛	ㄇㄚ˙
梅花	ㄇㄟˊ ㄏㄨㄚ
美容	ㄇㄟˇ ㄖㄨㄥˊ
猛	ㄇㄥˇ
蒙	ㄇㄥˊ
免得	ㄇㄧㄢˇ ㄉㄜ˙
棉	ㄇㄧㄢˊ
面對面	ㄇㄧㄢˋ ㄉㄨㄟˋ ㄇㄧㄢˋ
面嚮	ㄇㄧㄢˋ ㄒㄧㄤˋ
妙	ㄇㄧㄠˋ
滅	ㄇㄧㄝˋ
民歌	ㄇㄧㄣˊ ㄍㄜ
民工	ㄇㄧㄣˊ ㄍㄨㄥ
民警	ㄇㄧㄣˊ ㄐㄧㄥˇ
民主	ㄇㄧㄣˊ ㄓㄨˇ
名勝	ㄇㄧㄥˊ ㄕㄥˋ
名額	ㄇㄧㄣˊ ㄍㄜˊ
民意	ㄇㄧㄣˊ ㄧˋ
名譽	ㄇㄧㄥˊ ㄩˋ
名義	ㄇㄧㄥˊ ㄧˋ
命	ㄇㄧㄥˋ
明日	ㄇㄧㄥˊ ㄖˋ
磨	ㄇㄛˊ
沒收	ㄇㄛˋ ㄕㄡ
膜	ㄇㄛˊ
墨水	ㄇㄛˋ ㄕㄨㄟˇ
母	ㄇㄨˇ
母雞	ㄇㄨˇ ㄐㄧ
母女	ㄇㄨˇ-ㄋㄩˇ
墓	ㄇㄨˋ
拿走	ㄋㄚˊ ㄗㄡˇ
母子	ㄇㄨˇ ㄗˇ
奶粉	ㄋㄞˇ ㄈㄣˇ
難忘	ㄋㄢˊ ㄨㄤˋ
奶牛	ㄋㄞˇ ㄋㄧㄡˊ
內外	ㄋㄟˋ ㄨㄞˋ
內地	ㄋㄟˋ ㄉㄧˋ
內衣	ㄋㄟˋ ㄧ
能否	ㄋㄥˊ ㄈㄡˇ
泥	ㄋㄧˊ
扭	ㄋㄧㄡˇ
排行榜	ㄆㄞˊ ㄏㄤˊ ㄅㄤˇ
判	ㄆㄢˋ
派出	ㄆㄞˋ ㄔㄨ
盼望	ㄆㄢˋ ㄨㄤˋ
泡	ㄆㄠˋ
陪同	ㄆㄟˊ ㄊㄨㄥˊ
皮球	ㄆㄧˊ ㄑㄧㄡˊ
配置	ㄆㄟˋ ㄓˋ
偏	ㄆㄧㄢ
貧困	ㄆㄧㄣˊ ㄎㄨㄣˋ
聘請	ㄆㄧㄣˋ ㄑㄧㄥˇ
炮	ㄆㄠˋ
品牌	ㄆㄧㄣˇ ㄆㄞˊ
平凡	ㄆㄧㄥˊ ㄈㄢˊ
平衡	ㄆㄧㄥˊ ㄏㄥˊ
評	ㄆㄧㄥˊ
平臺	ㄆㄧㄥˊ ㄊㄞˊ
屏幕	ㄆㄧㄥˊ ㄇㄨˋ
評選	ㄆㄧㄥˊ ㄒㄩㄢˇ
撲	ㄆㄨ
平方米	ㄆㄧㄥˊ ㄈㄤ ㄇㄧˇ
鋪	ㄆㄨˋ
奇妙	ㄑㄧˊ ㄇㄧㄠˋ
坡	ㄆㄛ
欺負	ㄑㄧ ㄈㄨ˙
企圖	ㄑㄧˇ ㄊㄨˊ
氣氛	ㄑㄧˋ ㄈㄣ
恰當	ㄑㄧㄚˋ ㄉㄤˋ
恰好	ㄑㄧㄚˋ ㄏㄠˇ
起訴	ㄑㄧˇ ㄙㄨˋ
恰恰	ㄑㄧㄚˋ ㄑㄧㄚˋ
鉛筆	ㄑㄧㄢ ㄅㄧˇ
謙虛	ㄑㄧㄢ ㄒㄩ
牽	ㄑㄧㄢ
起點	ㄑㄧˇ ㄉㄧㄢˇ
前方	ㄑㄧㄢˊ ㄈㄤ
強盜	ㄑㄧㄤˊ ㄉㄠˋ
潛力	ㄑㄧㄢˊ ㄌㄧˋ
前來	ㄑㄧㄢˊ ㄌㄞˊ
強勢	ㄑㄧㄤˊ ㄕˋ
強壯	ㄑㄧㄤˊ ㄓㄨㄤˋ
巧妙	ㄑㄧㄠˇ ㄇㄧㄠˋ
橋梁	ㄑㄧㄠˊ ㄌㄧㄤˊ
強化	ㄑㄧㄤˊ ㄏㄨㄚˋ
切實	ㄑㄧㄝˋ ㄕˊ
侵犯	ㄑㄧㄣ ㄈㄢˋ
茄子	ㄑㄧㄝˊ ㄗ˙
親屬	ㄑㄧㄣ ㄕㄨˇ
傾向	ㄑㄧㄥ ㄒㄧㄤˋ
清	ㄑㄧㄥ
清潔	ㄑㄧㄥ ㄐㄧㄝˊ
清潔工	ㄑㄧㄥ ㄐㄧㄝˊ ㄍㄨㄥ
親眼	ㄑㄧㄣ ㄧㄢˇ
清明節	ㄑㄧㄥ ㄇㄧㄥˊ ㄐㄧㄝˊ
情緒	ㄑㄧㄥˊ ㄒㄩˋ
球拍	ㄑㄧㄡˊ ㄆㄞ
清洗	ㄑㄧㄥ ㄒㄧˇ
球星	ㄑㄧㄡˊ ㄒㄧㄥ
求職	ㄑㄧㄡˊ ㄓˊ
球員	ㄑㄧㄡˊ ㄩㄢˊ
渠道	ㄑㄩˊ ㄉㄠˋ
取款	ㄑㄩˇ ㄎㄨㄢˇ
去掉	ㄑㄩˋ ㄉㄧㄠˋ
區分	ㄑㄩ ㄈㄣ
取款機	ㄑㄩˇ ㄎㄨㄢˇ ㄐㄧ
權	ㄑㄩㄢˊ
全力	ㄑㄩㄢˊ ㄌㄧˋ
權力	ㄑㄩㄢˊ ㄌㄧˋ
全新	ㄑㄩㄢˊ ㄒㄧㄣ
券	ㄑㄩㄢˋ
缺陷	ㄑㄩㄝ ㄒㄧㄢˋ
讓座	ㄖㄤˋ ㄗㄨㄛˋ
熱點	ㄖㄜˋ ㄉㄧㄢˇ
熱水	ㄖㄜˋ ㄕㄨㄟˇ
熱水器	ㄖㄜˋ ㄕㄨㄟˇ ㄑㄧˋ
熱線	ㄖㄜˋ ㄒㄧㄢˋ
人權	ㄖㄣˊ ㄑㄩㄢˊ
日夜	ㄖˋ ㄧㄝˋ
卻是	ㄑㄩㄝˋ ㄕˋ
認同	ㄖㄣˋ ㄊㄨㄥˊ
融合	ㄖㄨㄥˊ ㄏㄜˊ
融入	ㄖㄨㄥˊ ㄖㄨˋ
日語	ㄖˋ ㄩˇ
如	ㄖㄨˊ
如一	ㄖㄨˊ ㄧ
乳製品	ㄖㄨˇ ㄓˋ ㄆㄧㄣˇ
入	ㄖㄨˋ
入學	ㄖㄨˋ ㄒㄩㄝˊ
若	ㄖㄨㄛˋ
塞	ㄙㄞ
賽	ㄙㄞˋ
賽場	ㄙㄞˋ ㄔㄤˇ
三明治	ㄙㄢ ㄇㄧㄥˊ ㄓˋ
山峰	ㄕㄢ ㄈㄥ
山谷	ㄕㄢ ㄍㄨˇ
喪失	ㄙㄤˋ ㄕ
傷口	ㄕㄤ ㄎㄡˇ
傷亡	ㄕㄤ ㄨㄤˊ
山坡	ㄕㄢ ㄆㄛ
傷員	ㄕㄤ ㄩㄢˊ
商城	ㄕㄤ ㄔㄥˊ
上市	ㄕㄤˋ ㄕˋ
上當	ㄕㄤˋ ㄉㄤˋ
上演	ㄕㄤˋ ㄧㄢˇ
上帝	ㄕㄤˋ ㄉㄧˋ
上臺	ㄕㄤˋ ㄊㄞˊ
勺	ㄕㄠˊ
舌頭	ㄕㄜˊ ㄊㄡ˙
少兒	ㄕㄠˋ ㄦˊ
設計師	ㄕㄜˋ ㄐㄧˋ ㄕ
深化	ㄕㄣ ㄏㄨㄚˋ
涉及	ㄕㄜˋ ㄐㄧˊ
深深	ㄕㄣ ㄕㄣ
審查	ㄕㄣˇ ㄔㄚˊ
升級	ㄕㄥ ㄐㄧˊ
升學	ㄕㄥ ㄒㄩㄝˊ
生活費	ㄕㄥ ㄏㄨㄛˊ ㄈㄟˋ
省錢	ㄕㄥˇ ㄑㄧㄢˊ
升值	ㄕㄥ ㄓˊ
聖誕節	ㄕㄥˋ ㄉㄢˋ ㄐㄧㄝˊ
師父	ㄕ ㄈㄨ˙
盛行	ㄕㄥˋ ㄒㄧㄥˊ
時節	ㄕˊ ㄐㄧㄝˊ
師生	ㄕ-ㄕㄥ
時時	ㄕˊ ㄕˊ
時期	ㄕˊ ㄑㄧ
時裝	ㄕˊ ㄓㄨㄤ
時而	ㄕˊ ㄦˊ
識	ㄕˊ
實踐	ㄕˊ ㄐㄧㄢˋ
食慾	ㄕˊ ㄩˋ
市民	ㄕˋ ㄇㄧㄣˊ
試點	ㄕˋ ㄉㄧㄢˇ
適當	ㄕˋ ㄉㄤˋ
事後	ㄕˋ ㄏㄡˋ
收藏	ㄕㄡ ㄘㄤˊ
識字	ㄕˊ ㄗˋ
收養	ㄕㄡ ㄧㄤˇ
手續費	ㄕㄡˇ ㄒㄩˋ ㄈㄟˋ
收取	ㄕㄡ ㄑㄩˇ
首	ㄕㄡˇ
首腦	ㄕㄡˇ ㄋㄠˇ
首席	ㄕㄡˇ ㄒㄧˊ
首次	ㄕㄡˇ ㄘˋ
書房	ㄕㄨ ㄈㄤˊ
首相	ㄕㄡˇ ㄒㄧㄤˋ
薯片	ㄕㄨˇ ㄆㄧㄢˋ
雙打	ㄕㄨㄤ ㄉㄚˇ
爽	ㄕㄨㄤˇ
水泥	ㄕㄨㄟˇ ㄋㄧˊ
稅	ㄕㄨㄟˋ
順	ㄕㄨㄣˋ
薯條	ㄕㄨˇ ㄊㄧㄠˊ
說明書	ㄕㄨㄛ ㄇㄧㄥˊ ㄕㄨ
司長	ㄙ ㄓㄤˇ
說實話	ㄕㄨㄛ ㄕˊ ㄏㄨㄚˋ
死亡	ㄙˇ ㄨㄤˊ
四處	ㄙˋ ㄔㄨˋ
寺	ㄙˋ
送禮	ㄙㄨㄥˋ ㄌㄧˇ
送行	ㄙㄨㄥˋ ㄒㄧㄥˊ
素質	ㄙㄨˋ ㄓˋ
算是	ㄙㄨㄢˋ ㄕˋ
雖	ㄙㄨㄟ
算了	ㄙㄨㄢˋ ㄌㄜ˙
踏實	ㄊㄚ ㄕ˙
歲數	ㄙㄨㄟˋ ㄕㄨ˙
塔	ㄊㄚˇ
踏	ㄊㄚˋ
所	ㄙㄨㄛˇ
檯燈	ㄊㄞˊ ㄉㄥ
嘆氣	ㄊㄢˋ ㄑㄧˋ
探索	ㄊㄢˋ ㄙㄨㄛˇ
太陽能	ㄊㄞˋ ㄧㄤˊ ㄋㄥˊ
探討	ㄊㄢˋ ㄊㄠˇ
趟	ㄊㄤˋ
掏	ㄊㄠ
特大	ㄊㄜˋ ㄉㄚˋ
特地	ㄊㄜˋ ㄉㄧˋ
特	ㄊㄜˋ
特快	ㄊㄜˋ ㄎㄨㄞˋ
疼痛	ㄊㄥˊ ㄊㄨㄥˋ
特意	ㄊㄜˋ ㄧˋ
踢	ㄊㄧ
提交	ㄊㄧˊ ㄐㄧㄠ
提升	ㄊㄧˊ ㄕㄥ
天然	ㄊㄧㄢ ㄖㄢˊ
天堂	ㄊㄧㄢ ㄊㄤˊ
田	ㄊㄧㄢˊ
天下	ㄊㄧㄢ ㄒㄧㄚˋ
添	ㄊㄧㄢ
田徑	ㄊㄧㄢˊ ㄐㄧㄥˋ
跳水	ㄊㄧㄠˋ ㄕㄨㄟˇ
通報	ㄊㄨㄥ ㄅㄠˋ
聽取	ㄊㄧㄥ ㄑㄩˇ
通道	ㄊㄨㄥ ㄉㄠˋ
通紅	ㄊㄨㄥ ㄏㄨㄥˊ
通行	ㄊㄨㄥ ㄒㄧㄥˊ
通話	ㄊㄨㄥ ㄏㄨㄚˋ
同	ㄊㄨㄥˊ
同胞	ㄊㄨㄥˊ ㄅㄠ
同期	ㄊㄨㄥˊ ㄑㄧ
通訊	ㄊㄨㄥ ㄒㄩㄣˋ
同行	ㄊㄨㄥˊ ㄏㄤˊ
銅牌	ㄊㄨㄥˊ ㄆㄞˊ
同一	ㄊㄨㄥˊ ㄧ
頭疼	ㄊㄡˊ ㄊㄥˊ
投票	ㄊㄡˊ ㄆㄧㄠˋ
圖書	ㄊㄨˊ ㄕㄨ˙
透露	ㄊㄡˋ ㄌㄨˋ
途徑	ㄊㄨˊ ㄐㄧㄥˋ
徒弟	ㄊㄨˊ ㄉㄧ˙
土	ㄊㄨˇ
團隊	ㄊㄨㄢˊ ㄉㄨㄟˋ
退票	ㄊㄨㄟˋ ㄆㄧㄠˋ
吞	ㄊㄨㄣ
推出	ㄊㄨㄟ ㄔㄨ
托	ㄊㄨㄛ
拖	ㄊㄨㄛ
拖鞋	ㄊㄨㄛ ㄒㄧㄝˊ
挖	ㄨㄚ
娃娃	ㄨㄚˊ ㄨㄚ˙
外幣	ㄨㄞˋ ㄅㄧˋ
外部	ㄨㄞˋ ㄅㄨˋ
外出	ㄨㄞˋ ㄔㄨ
哇	ㄨㄚ˙
外科	ㄨㄞˋ ㄎㄜ
外觀	ㄨㄞˋ ㄍㄨㄢ
外衣	ㄨㄞˋ ㄧ
外來	ㄨㄞˋ ㄌㄞˊ
外資	ㄨㄞˋ ㄗ
外頭	ㄨㄞˋ ㄊㄡ˙
彎曲	ㄨㄢ ㄑㄩ
頑皮	ㄨㄢˊ ㄆㄧˊ
頑強	ㄨㄢˊ ㄑㄧㄤˊ
王后	ㄨㄤˊ ㄏㄡˋ
王子	ㄨㄤˊ ㄗˇ
往後	ㄨㄤˇ ㄏㄡˋ
網吧	ㄨㄤˇ ㄅㄚ
網頁	ㄨㄤˇ ㄧㄝˋ
往年	ㄨㄤˇ ㄋㄧㄢˊ
望見	ㄨㄤˋ ㄐㄧㄢˋ
危機	ㄨㄟ ㄐㄧ
威脅	ㄨㄟ ㄒㄧㄝˊ
往來	ㄨㄤˇ ㄌㄞˊ
微波爐	ㄨㄟ ㄅㄛ ㄌㄨˊ
維生素	ㄨㄟˊ ㄕㄥ ㄙㄨˋ
為此	ㄨㄟˋ ㄘˇ
為何	ㄨㄟˋ ㄏㄜˊ
臥鋪	ㄨㄛˋ ㄆㄨˋ
文娛	ㄨㄣˊ ㄩˊ
無邊	ㄨˊ ㄅㄧㄢ
烏雲	ㄨ ㄩㄣˊ
無關	ㄨˊ ㄍㄨㄢ
物品	ㄨˋ ㄆㄧㄣˇ
無效	ㄨˊ ㄒㄧㄠˋ
誤	ㄨˋ
舞蹈	ㄨˇ ㄉㄠˇ
西班牙語	ㄒㄧ ㄅㄢ ㄧㄚˊ ㄩˇ
吸毒	ㄒㄧ ㄉㄨˊ
犧牲	ㄒㄧ ㄕㄥ
洗衣粉	ㄒㄧˇ ㄧ ㄈㄣˇ
細胞	ㄒㄧˋ ㄅㄠ
戲曲	ㄒㄧˋ ㄑㄩˇ
細菌	ㄒㄧˋ ㄐㄩㄣ
先鋒	ㄒㄧㄢ ㄈㄥ
嫌	ㄒㄧㄢˊ
顯出	ㄒㄧㄢˇ ㄔㄨ
險	ㄒㄧㄢˇ
陷入	ㄒㄧㄢˋ ㄖㄨˋ
響聲	ㄒㄧㄤˇ ㄕㄥ
線路	ㄒㄧㄢˋ ㄌㄨˋ
想不到	ㄒㄧㄤˇ ㄅㄨ˙ ㄉㄠˋ
消耗	ㄒㄧㄠ ㄏㄠˋ
消滅	ㄒㄧㄠ ㄇㄧㄝˋ
小費	ㄒㄧㄠˇ ㄈㄟˋ
小麥	ㄒㄧㄠˇ ㄇㄞˋ
小於	ㄒㄧㄠˇ ㄩˊ
笑臉	ㄒㄧㄠˋ ㄌㄧㄢˇ
曉得	ㄒㄧㄠˇ ㄉㄜ˙
笑容	ㄒㄧㄠˋ ㄖㄨㄥˊ
笑聲	ㄒㄧㄠˋ ㄕㄥ
協會	ㄒㄧㄝˊ ㄏㄨㄟˋ
協商	ㄒㄧㄝˊ ㄕㄤ
協調	ㄒㄧㄝˊ ㄊㄧㄠˊ
寫字樓	ㄒㄧㄝˇ ㄗˋ ㄌㄡˊ
協助	ㄒㄧㄝˊ ㄓㄨˋ
寫字檯	ㄒㄧㄝˇ ㄗˋ ㄊㄞˊ
心願	ㄒㄧㄣ ㄩㄢˋ
心臟	ㄒㄧㄣ ㄗㄤˋ
心靈	ㄒㄧㄣ ㄌㄧㄥˊ
心臟病	ㄒㄧㄣ ㄗㄤˋ ㄅㄧㄥˋ
新人	ㄒㄧㄣ ㄖㄣˊ
新興	ㄒㄧㄣ ㄒㄧㄥ
薪水	ㄒㄧㄣ ㄕㄨㄟ˙
信仰	ㄒㄧㄣˋ ㄧㄤˇ
信用	ㄒㄧㄣˋ ㄩㄥˋ
行程	ㄒㄧㄥˊ ㄔㄥˊ
興旺	ㄒㄧㄥ ㄨㄤˋ
形	ㄒㄧㄥˊ
凶手	ㄒㄩㄥ ㄕㄡˇ
袖珍	ㄒㄧㄡˋ ㄓㄣ
修車	ㄒㄧㄡ ㄔㄜ
凶	ㄒㄩㄥ
懸	ㄒㄩㄢˊ
旋轉	ㄒㄩㄢˊ ㄓㄨㄢˇ
選拔	ㄒㄩㄢˇ ㄅㄚˊ
學會	ㄒㄩㄝˊ ㄏㄨㄟˋ
選舉	ㄒㄩㄢˇ ㄐㄩˇ
學員	ㄒㄩㄝˊ ㄩㄢˊ
血液	ㄒㄩㄝˋ ㄧㄝˋ
血管	ㄒㄩㄝˋ ㄍㄨㄢˇ
壓迫	ㄧㄚ ㄆㄛˋ
循環	ㄒㄩㄣˊ ㄏㄨㄢˊ
煙花	ㄧㄢ ㄏㄨㄚ
沿海	ㄧㄢˊ ㄏㄞˇ
沿	ㄧㄢˊ
沿著	ㄧㄢˊ ㄓㄜ˙
研發	ㄧㄢˊ ㄈㄚ
眼看	ㄧㄢˇ ㄎㄢˋ
演奏	ㄧㄢˇ ㄗㄡˋ
宴會	ㄧㄢˋ ㄏㄨㄟˋ
仰	ㄧㄤˇ
洋	ㄧㄤˊ
養老	ㄧㄤˇ ㄌㄠˇ
樣	ㄧㄤˋ
氧氣	ㄧㄤˇ ㄑㄧˋ
藥品	ㄧㄠˋ ㄆㄧㄣˇ
要不然	ㄧㄠˋ ㄅㄨ˙ ㄖㄢˊ
要好	ㄧㄠˋ ㄏㄠˇ
要麼	ㄧㄠˋ ㄇㄜ˙
要素	ㄧㄠˋ ㄙㄨˋ
野	ㄧㄝˇ
野生	ㄧㄝˇ ㄕㄥ
醫藥	ㄧ ㄧㄠˋ
依次	ㄧ ㄘˋ
依賴	ㄧ ㄌㄞˋ
一次性	ㄧ ㄘˋ ㄒㄧㄥˋ
一道	ㄧ ㄉㄠˋ
一代	ㄧ ㄉㄞˋ
一貫	ㄧ ㄍㄨㄢˋ
一路上	ㄧ ㄌㄨˋ ㄕㄤˋ
儀器	ㄧˊ ㄑㄧˋ
儀式	ㄧˊ ㄕˋ
一番	ㄧˋ ㄈㄢ
遺憾	ㄧˊ ㄏㄢˋ
一模一樣	ㄧ ㄇㄨˊ-ㄧ ㄧㄤˋ
一時	ㄧ ㄕˊ
一同	ㄧ ㄊㄨㄥˊ
一齊	ㄧ ㄑㄧˊ
一行	ㄧ ㄒㄧㄥˊ
藝人	ㄧˋ ㄖㄣˊ
議題	ㄧˋ ㄊㄧˊ
異常	ㄧˋ ㄔㄤˊ
意想不到	ㄧˋ ㄒㄧㄤˇ ㄅㄨˋ ㄉㄠˋ
意願	ㄧˋ ㄩㄢˋ
因素	ㄧㄣ ㄙㄨˋ
因	ㄧㄣ
陰謀	ㄧㄣ ㄇㄡˊ
音量	ㄧㄣ ㄌㄧㄤˋ
陰影	ㄧㄣ ㄧㄥˇ
音像	ㄧㄣ ㄒㄧㄤˋ
隱私	ㄧㄣˇ ㄙ
隱藏	ㄧㄣˇ ㄘㄤˊ
印	ㄧㄣˋ
迎來	ㄧㄥˊ ㄌㄞˊ
英雄	ㄧㄥ ㄒㄩㄥˊ
影迷	ㄧㄥˇ ㄇㄧˊ
影星	ㄧㄥˇ ㄒㄧㄥ
用處	ㄩㄥˋ ㄔㄨ˙
應急	ㄧㄥˋ ㄐㄧˊ
用法	ㄩㄥˋ ㄈㄚˇ
用得著	ㄩㄥˋ ㄉㄜ˙ ㄓㄠˊ
應對	ㄧㄥˋ ㄉㄨㄟˋ
用心	ㄩㄥˋ ㄒㄧㄣ
優質	ㄧㄡ ㄓˋ
用品	ㄩㄥˋ ㄆㄧㄣˇ
遊玩	ㄧㄡˊ ㄨㄢˊ
遊人	ㄧㄡˊ ㄖㄣˊ
遊戲機	ㄧㄡˊ ㄒㄧˋ ㄐㄧ
遊行	ㄧㄡˊ ㄒㄧㄥˊ
有關	ㄧㄡˇ ㄍㄨㄢ
有沒有	ㄧㄡˇ ㄇㄟˊ ㄧㄡˇ
有事	ㄧㄡˇ ㄕˋ
於	ㄩˊ
娛樂	ㄩˊ ㄌㄜˋ
愉快	ㄩˊ ㄎㄨㄞˋ
與	ㄩˇ
宇航員	ㄩˇ ㄏㄤˊ ㄩㄢˊ
預約	ㄩˋ ㄩㄝ
雨衣	ㄩˇ ㄧ
元素	ㄩㄢˊ ㄙㄨˋ
園	ㄩㄢˊ
園地	ㄩㄢˊ ㄉㄧˋ
原	ㄩㄢˊ
原告	ㄩㄢˊ ㄍㄠˋ
原諒	ㄩㄢˊ ㄌㄧㄤˋ
圓珠筆	ㄩㄢˊ ㄓㄨ ㄅㄧˇ
緣故	ㄩㄢˊ ㄍㄨˋ
援助	ㄩㄢˊ ㄓㄨˋ
遠遠	ㄩㄢˇ ㄩㄢˇ
遠離	ㄩㄢˇ ㄌㄧˊ
遠方	ㄩㄢˇ ㄈㄤ
暈	ㄩㄣ
約定	ㄩㄝ ㄉㄧㄥˋ
運作	ㄩㄣˋ ㄗㄨㄛˋ
樂曲	ㄩㄝˋ ㄑㄩˇ
允許	ㄩㄣˇ ㄒㄩˇ
暈車	ㄩㄣˋ ㄔㄜ
雜	ㄗㄚˊ
再生	ㄗㄞˋ ㄕㄥ
再說	ㄗㄞˋ ㄕㄨㄛ
遭到	ㄗㄠ ㄉㄠˋ
遭受	ㄗㄠ ㄕㄡˋ
遭遇	ㄗㄠ ㄩˋ
早晚	ㄗㄠˇ ㄨㄢˇ
增進	ㄗㄥ ㄐㄧㄣˋ
扎	ㄓㄚ
增值	ㄗㄥ ㄓˊ
炸彈	ㄓㄚˋ ㄉㄢˋ
扎實	ㄓㄚ ㄕ˙
炸	ㄓㄚˋ
債	ㄓㄞˋ
炸藥	ㄓㄚˋ ㄧㄠˋ
占據	ㄓㄢˋ ㄐㄩˋ
戰場	ㄓㄢˋ ㄔㄤˇ
戰術	ㄓㄢˋ ㄕㄨˋ
戰略	ㄓㄢˋ ㄌㄩㄝˋ
戰友	ㄓㄢˋ ㄧㄡˇ
章	ㄓㄤ
站臺	ㄓㄢˋ ㄊㄞˊ
掌聲	ㄓㄤˇ ㄕㄥ
長	ㄓㄤˇ
賬	ㄓㄤˋ
賬戶	ㄓㄤˋ ㄏㄨˋ
漲	ㄓㄤˇ
招	ㄓㄠ
障礙	ㄓㄢˋ ㄍㄞˋ
照樣	ㄓㄠˋ ㄧㄤˋ
照耀	ㄓㄠˋ ㄧㄠˋ
招聘	ㄓㄠ ㄆㄧㄣˋ
哲學	ㄓㄜˊ ㄒㄩㄝˊ
這就是說	ㄓㄜˋ ㄐㄧㄡˋ ㄕˋ ㄕㄨㄛ
鎮	ㄓㄣˋ
爭奪	ㄓㄥ ㄉㄨㄛˊ
整頓	ㄓㄥˇ ㄉㄨㄣˋ
正當	ㄓㄥˋ ㄉㄤ
整治	ㄓㄥˇ ㄓˋ
政策	ㄓㄥˋ ㄘㄜˋ
政權	ㄓㄥˋ ㄑㄩㄢˊ
癥狀	ㄓㄥˋ ㄓㄨㄤˋ
政黨	ㄓㄥˋ ㄉㄤˇ
之類	ㄓ ㄌㄟˋ
支援	ㄓ ㄩㄢˊ
支撐	ㄓ ㄔㄥ˙
知名	ㄓ ㄇㄧㄥˊ
織	ㄓ
枝	ㄓ
直升機	ㄓˊ ㄕㄥ ㄐㄧ
職責	ㄓˊ ㄗㄜˊ
止	ㄓˇ
只得	ㄓˇ ㄉㄜˊ
只顧	ㄓˇ ㄍㄨˋ
只管	ㄓˇ ㄍㄨㄢˇ
指數	ㄓˇ ㄕㄨˋ
指定	ㄓˇ ㄉㄧㄥˋ
指頭	ㄓˇ ㄊㄡ˙
指著	ㄓˇ ㄓㄜ˙
至於	ㄓˋ ㄩˊ
智慧	ㄓˋ ㄏㄨㄟˋ
治病	ㄓˋ ㄅㄧㄥˋ
中華	ㄓㄨㄥ ㄏㄨㄚˊ
中等	ㄓㄨㄥ ㄉㄥˇ
中外	ㄓㄨㄥ ㄨㄞˋ
中期	ㄓㄨㄥ ㄑㄧ
忠心	ㄓㄨㄥ ㄒㄧㄣ
腫	ㄓㄨㄥˇ
鐘頭	ㄓㄨㄥ ㄊㄡˊ
種種	ㄓㄨㄥˇ ㄓㄨㄥˇ
珠寶	ㄓㄨ ㄅㄠˇ
諸位	ㄓㄨ ㄨㄟˋ
主持人	ㄓㄨˇ ㄔˊ ㄖㄣˊ
粥	ㄓㄡ
主角	ㄓㄨˇ ㄐㄩㄝˊ
煮	ㄓㄨˇ
主流	ㄓㄨˇ ㄌㄧㄡˊ
住宅	ㄓㄨˋ ㄓㄞˊ
駐	ㄓㄨˋ
柱子	ㄓㄨˋ ㄗ˙
專用	ㄓㄨㄢ ㄩㄥˋ
祝願	ㄓㄨˋ ㄩㄢˋ
轉動	ㄓㄨㄢˇ ㄉㄨㄥˋ
轉	ㄓㄨㄢˇ
賺錢	ㄓㄨㄢˋ ㄑㄧㄢˊ
壯觀	ㄓㄨㄤˋ ㄍㄨㄢ
賺	ㄓㄨㄢˋ
追究	ㄓㄨㄟ ㄐㄧㄡ
裝備	ㄓㄨㄤ ㄅㄟˋ
自來水	ㄗˋ ㄌㄞˊ ㄕㄨㄟˇ
咨詢	ㄗ ㄒㄩㄣˊ
捉	ㄓㄨㄛ
自我	ㄗˋ ㄨㄛˇ
自學	ㄗˋ ㄒㄩㄝˊ
自言自語	ㄗˋ ㄧㄢˊ-ㄗˋ ㄩˇ
自在	ㄗˋ ㄗㄞ˙
宗教	ㄗㄨㄥ ㄐㄧㄠˋ
總部	ㄗㄨㄥˇ ㄅㄨˋ
總經理	ㄗㄨㄥˇ ㄐㄧㄥ ㄌㄧˇ
總監	ㄗㄨㄥˇ ㄐㄧㄢ
總量	ㄗㄨㄥˇ ㄌㄧㄤˋ
走私	ㄗㄡˇ ㄙ
奏	ㄗㄡˋ
租金	ㄗㄨ ㄐㄧㄣ
足	ㄗㄨˊ
足以	ㄗㄨˊ ㄧˇ
祖父	ㄗㄨˇ ㄈㄨˋ
族	ㄗㄨˊ
祖國	ㄗㄨˇ ㄍㄨㄛˊ
祖母	ㄗㄨˇ ㄇㄨˇ
最終	ㄗㄨㄟˋ ㄓㄨㄥ
罪	ㄗㄨㄟˋ
鑽	ㄗㄨㄢ
罪惡	ㄗㄨㄟˋ ㄜˋ
作	ㄗㄨㄛˋ
最佳	ㄗㄨㄟˋ ㄐㄧㄚ
作廢	ㄗㄨㄛˋ ㄈㄟˋ
座談會	ㄗㄨㄛˋ ㄊㄢˊ ㄏㄨㄟˋ
作戰	ㄗㄨㄛˋ ㄓㄢˋ
