安慰	ㄢ ㄨㄟˋ
岸	ㄢˋ
岸上	ㄢˋ ㄕㄤˋ
拔	ㄅㄚˊ
按摩	ㄢˋ ㄇㄛˊ
白酒	ㄅㄞˊ ㄐㄧㄡˇ
扮演	ㄅㄢˋ ㄧㄢˇ
拜訪	ㄅㄞˋ ㄈㄤˇ
包圍	ㄅㄠ ㄨㄟˊ
包裝	ㄅㄠ ㄓㄨㄤ
版	ㄅㄢˇ
棒	ㄅㄤˋ
保衛	ㄅㄠˇ ㄨㄟˋ
報答	ㄅㄠˋ ㄉㄚˊ
報警	ㄅㄠˋ ㄐㄧㄥˇ
背包	ㄅㄟ ㄅㄠ
保養	ㄅㄠˇ ㄧㄤˇ
悲傷	ㄅㄟ ㄕㄤ
悲劇	ㄅㄟ ㄐㄩˋ
抱怨	ㄅㄠˋ ㄩㄢ˙
被動	ㄅㄟˋ ㄉㄨㄥˋ
輩	ㄅㄟˋ
本人	ㄅㄣˇ ㄖㄣˊ
鼻子	ㄅㄧˊ ㄗ˙
比方	ㄅㄧˇ ㄈㄤ˙
比重	ㄅㄧˇ ㄓㄨㄥˋ
北極	ㄅㄟˇ ㄐㄧˊ
必需	ㄅㄧˋ ㄒㄩ
畢竟	ㄅㄧˋ ㄐㄧㄥˋ
閉幕	ㄅㄧˋ ㄇㄨˋ
彼此	ㄅㄧˇ ㄘˇ
閉幕式	ㄅㄧˋ ㄇㄨˋ ㄕˋ
編輯	ㄅㄧㄢ ㄐㄧˊ
必	ㄅㄧˋ
便利	ㄅㄧㄢˋ ㄌㄧˋ
變動	ㄅㄧㄢˋ ㄉㄨㄥˋ
便條	ㄅㄧㄢˋ ㄊㄧㄠˊ
邊境	ㄅㄧㄢ ㄐㄧㄥˋ
便於	ㄅㄧㄢˋ ㄩˊ
賓館	ㄅㄧㄣ ㄍㄨㄢˇ
病毒	ㄅㄧㄥˋ ㄉㄨˊ
餅乾	ㄅㄧㄥˇ ㄍㄢ
博客	ㄅㄛˊ ㄎㄜˋ
餅	ㄅㄧㄥˇ
玻璃	ㄅㄛ ㄌㄧ˙
博士	ㄅㄛˊ ㄕˋ
博覽會	ㄅㄛˊ ㄌㄢˇ ㄏㄨㄟˋ
博物館	ㄅㄛˊ ㄨˋ ㄍㄨㄢˇ
不利	ㄅㄨˋ ㄌㄧˋ
薄弱	ㄅㄛˊ ㄖㄨㄛˋ
不耐煩	ㄅㄨˋ ㄋㄞˋ ㄈㄢˊ
不顧	ㄅㄨˋ ㄍㄨˋ
補償	ㄅㄨˇ ㄔㄤˊ
不幸	ㄅㄨˋ ㄒㄧㄥˋ
不易	ㄅㄨˋ ㄧˋ
不曾	ㄅㄨˋ ㄘㄥˊ
不得了	ㄅㄨˋ ㄉㄜˊ ㄌㄧㄠˇ
補貼	ㄅㄨˇ ㄊㄧㄝ
不敢當	ㄅㄨˋ ㄍㄢˇ ㄉㄤ
不免	ㄅㄨˋ ㄇㄧㄢˇ
不時	ㄅㄨˋ ㄕˊ
不能不	ㄅㄨˋ ㄋㄥˊ ㄅㄨˋ
不停	ㄅㄨˋ ㄊㄧㄥˊ
不許	ㄅㄨˋ ㄒㄩˇ
不良	ㄅㄨˋ ㄌㄧㄤˊ
部位	ㄅㄨˋ ㄨㄟˋ
不止	ㄅㄨˋ ㄓˇ
猜測	ㄘㄞ ㄘㄜˋ
不足	ㄅㄨˋ ㄗㄨˊ
採購	ㄘㄞˇ ㄍㄡˋ
裁判	ㄘㄞˊ ㄆㄢˋ
猜	ㄘㄞ
餐館	ㄘㄢ ㄍㄨㄢˇ
餐廳	ㄘㄢ ㄊㄧㄥ
彩票	ㄘㄞˇ ㄆㄧㄠˋ
草原	ㄘㄠˇ ㄩㄢˊ
層次	ㄘㄥˊ ㄘˋ
冊	ㄘㄜˋ
餐飲	ㄘㄢ ㄧㄣˇ
叉子	ㄔㄚ ㄗ˙
差別	ㄔㄚ ㄅㄧㄝˊ
差距	ㄔㄚ ㄐㄩˋ
查詢	ㄔㄚˊ ㄒㄩㄣˊ
插	ㄔㄚ
叉	ㄔㄚ
差點兒	ㄔㄚˋ ㄉㄧㄢˇ ㄦ˙
拆除	ㄔㄞ ㄔㄨˊ
拆	ㄔㄞ
長度	ㄔㄤˊ ㄉㄨˋ
長壽	ㄔㄤˊ ㄕㄡˋ
產業	ㄔㄢˇ ㄧㄝˋ
腸	ㄔㄤˊ
嘗	ㄔㄤˊ
嘗試	ㄔㄤˊ ㄕˋ
廠長	ㄔㄤˇ ㄓㄤˇ
場面	ㄔㄤˇ ㄇㄧㄢˋ
超越	ㄔㄠ ㄩㄝˋ
倡導	ㄔㄤˋ ㄉㄠˇ
稱	ㄔㄥ
車主	ㄔㄜ ㄓㄨˇ
稱號	ㄔㄥ ㄏㄠˋ
成交	ㄔㄥˊ ㄐㄧㄠ
成效	ㄔㄥˊ ㄒㄧㄠˋ
成本	ㄔㄥˊ ㄅㄣˇ
成語	ㄔㄥˊ ㄩˇ
承辦	ㄔㄥˊ ㄅㄢˋ
城裡	ㄔㄥˊ ㄌㄧˇ
乘	ㄔㄥˊ
乘車	ㄔㄥˊ ㄔㄜ
乘坐	ㄔㄥˊ ㄗㄨㄛˋ
吃力	ㄔ ㄌㄧˋ
池子	ㄔˊ ㄗ˙
乘客	ㄔㄥˊ ㄎㄜˋ
衝動	ㄔㄨㄥ ㄉㄨㄥˋ
遲	ㄔˊ
充足	ㄔㄨㄥ ㄗㄨˊ
衝突	ㄔㄨㄥ ㄊㄨ
愁	ㄔㄡˊ
臭	ㄔㄡˋ
醜	ㄔㄡˇ
出差	ㄔㄨ ㄔㄞ
出版	ㄔㄨ ㄅㄢˇ
出汗	ㄔㄨ ㄏㄢˋ
初期	ㄔㄨ ㄑㄧ
出於	ㄔㄨ ㄩˊ
除非	ㄔㄨˊ ㄈㄟ
廚房	ㄔㄨˊ ㄈㄤˊ
處罰	ㄔㄨˇ ㄈㄚˊ
除夕	ㄔㄨˊ ㄒㄧ
處分	ㄔㄨˇ ㄈㄣˋ
傳達	ㄔㄨㄢˊ ㄉㄚˊ
傳遞	ㄔㄨㄢˊ ㄉㄧˋ
傳真	ㄔㄨㄢˊ ㄓㄣ
窗簾	ㄔㄨㄤ ㄌㄧㄢˊ
處在	ㄔㄨˇ ㄗㄞˋ
闖	ㄔㄨㄤˇ
創立	ㄔㄨㄤˋ ㄌㄧˋ
辭典	ㄘˊ ㄉㄧㄢˇ
此後	ㄘˇ ㄏㄡˋ
辭職	ㄘˊ ㄓˊ
聰明	ㄘㄨㄥ ㄇㄧㄥ˙
此刻	ㄘˇ ㄎㄜˋ
此時	ㄘˇ ㄕˊ
從而	ㄘㄨㄥˊ ㄦ˙
從中	ㄘㄨㄥˊ ㄓㄨㄥ
脆	ㄘㄨㄟˋ
寸	ㄘㄨㄣˋ
存款	ㄘㄨㄣˊ ㄎㄨㄢˇ
達成	ㄉㄚˊ ㄔㄥˊ
答復	ㄉㄚˊ ㄈㄨ˙
答	ㄉㄚˊ
打	ㄉㄚˇ
打扮	ㄉㄚˇ ㄅㄢ˙
打擊	ㄉㄚˇ ㄐㄧ
打包	ㄉㄚˇ ㄅㄠ
打擾	ㄉㄚˇ ㄖㄠˇ
打架	ㄉㄚˇ ㄐㄧㄚˋ
大膽	ㄉㄚˋ ㄉㄢˇ
大綱	ㄉㄚˋ ㄍㄤ
大都	ㄉㄚˋ ㄉㄨ
大伙兒	ㄉㄚˋ ㄏㄨㄛˇ ㄦ˙
大獎賽	ㄉㄚˋ ㄐㄧㄤˇ ㄙㄞˋ
大腦	ㄉㄚˋ ㄋㄠˇ
大事	ㄉㄚˋ ㄕˋ
大廳	ㄉㄚˋ ㄊㄧㄥ
大象	ㄉㄚˋ ㄒㄧㄤˋ
大熊貓	ㄉㄚˋ ㄒㄩㄥˊ ㄇㄠ
大於	ㄉㄚˋ ㄩˊ
呆	ㄉㄞ
大致	ㄉㄚˋ ㄓˋ
代價	ㄉㄞˋ ㄐㄧㄚˋ
待	ㄉㄞˋ
代理	ㄉㄞˋ ㄌㄧˇ
帶有	ㄉㄞˋ ㄧㄡˇ
貸款	ㄉㄞˋ ㄎㄨㄢˇ
單一	ㄉㄢ ㄧ
膽小	ㄉㄢˇ ㄒㄧㄠˇ
膽	ㄉㄢˇ
當場	ㄉㄤ ㄔㄤˇ
蛋糕	ㄉㄢˋ ㄍㄠ
當代	ㄉㄤ ㄉㄞˋ
當年	ㄉㄤ ㄋㄧㄢˊ
當前	ㄉㄤ ㄑㄧㄢˊ
當選	ㄉㄤ ㄒㄩㄢˇ
擋	ㄉㄤˇ
到來	ㄉㄠˋ ㄌㄞˊ
道德	ㄉㄠˋ ㄉㄜˊ
倒是	ㄉㄠˋ ㄕˋ
得了	ㄉㄜˊ ㄌㄜ˙
得以	ㄉㄜˊ ㄧˇ
等級	ㄉㄥˇ ㄐㄧˊ
等候	ㄉㄥˇ ㄏㄡˋ
地帶	ㄉㄧˋ ㄉㄞˋ
低于	ㄉㄧ ㄩˊ
地形	ㄉㄧˋ ㄒㄧㄥˊ
遞	ㄉㄧˋ
地震	ㄉㄧˋ ㄓㄣˋ
遞給	ㄉㄧˋ ㄍㄟˇ
典禮	ㄉㄧㄢˇ ㄌㄧˇ
點燃	ㄉㄧㄢˇ ㄖㄢˊ
電池	ㄉㄧㄢˋ ㄔˊ
電子版	ㄉㄧㄢˋ ㄗˇ ㄅㄢˇ
電飯鍋	ㄉㄧㄢˋ ㄈㄢˋ ㄍㄨㄛ
丟	ㄉㄧㄡ
調動	ㄉㄧㄠˋ ㄉㄨㄥˋ
動手	ㄉㄨㄥˋ ㄕㄡˇ
動機	ㄉㄨㄥˋ ㄐㄧ
動態	ㄉㄨㄥˋ ㄊㄞˋ
動員	ㄉㄨㄥˋ ㄩㄢˊ
洞	ㄉㄨㄥˋ
凍	ㄉㄨㄥˋ
豆製品	ㄉㄡˋ ㄓˋ ㄆㄧㄣˇ
毒	ㄉㄨˊ
堆	ㄉㄨㄟ
對立	ㄉㄨㄟˋ ㄌㄧˋ
對應	ㄉㄨㄟˋ ㄧㄥˋ
朵	ㄉㄨㄛˇ
噸	ㄉㄨㄣ
躲	ㄉㄨㄛˇ
耳朵	ㄦˇ ㄉㄨㄛ˙
兒女	ㄦˊ ㄋㄩˇ
二維碼	ㄦˋ ㄨㄟˊ ㄇㄚˇ
發覺	ㄈㄚ ㄐㄩㄝˊ
發射	ㄈㄚ ㄕㄜˋ
發行	ㄈㄚ ㄏㄤˊ
罰	ㄈㄚˊ
發布	ㄈㄚ ㄅㄨˋ
罰款	ㄈㄚˊ ㄎㄨㄢˇ
法制	ㄈㄚˇ ㄓˋ
法規	ㄈㄚˇ ㄍㄨㄟ
返回	ㄈㄢˇ ㄏㄨㄟˊ
繁榮	ㄈㄢˊ ㄖㄨㄥˊ
放大	ㄈㄤˋ ㄉㄚˋ
防治	ㄈㄤˊ ㄓˋ
放棄	ㄈㄤˋ ㄑㄧˋ
分成	ㄈㄣ ㄔㄥˊ
分類	ㄈㄣ ㄌㄟˋ
分離	ㄈㄣ ㄌㄧˊ
分解	ㄈㄣ ㄐㄧㄝˇ
豐收	ㄈㄥ ㄕㄡ
分享	ㄈㄣ ㄒㄧㄤˇ
分析	ㄈㄣ ㄒㄧ
風度	ㄈㄥ ㄉㄨˋ
風光	ㄈㄥ ㄍㄨㄤ˙
封	ㄈㄥ
瘋狂	ㄈㄥ ㄎㄨㄤˊ
扶	ㄈㄨˊ
瘋	ㄈㄥ
服從	ㄈㄨˊ ㄘㄨㄥˊ
幅度	ㄈㄨˊ ㄉㄨˋ
福利	ㄈㄨˊ ㄌㄧˋ
幅	ㄈㄨˊ
輔助	ㄈㄨˇ ㄓㄨˋ
負責人	ㄈㄨˋ ㄗㄜˊ ㄖㄣˊ
附件	ㄈㄨˋ ㄐㄧㄢˋ
改革	ㄍㄞˇ ㄍㄜˊ
乾脆	ㄍㄢ ㄘㄨㄟˋ
感想	ㄍㄢˇ ㄒㄧㄤˇ
干擾	ㄍㄢ ㄖㄠˇ
干預	ㄍㄢ ㄩˋ
鋼琴	ㄍㄤ ㄑㄧㄣˊ
鋼筆	ㄍㄤ ㄅㄧˇ
高度	ㄍㄠ ㄉㄨˋ
高跟鞋	ㄍㄠ ㄍㄣ ㄒㄧㄝˊ
高大	ㄍㄠ ㄉㄚˋ
高溫	ㄍㄠ ㄨㄣ
高原	ㄍㄠ ㄩㄢˊ
高於	ㄍㄠ ㄩˊ
搞好	ㄍㄠˇ ㄏㄠˇ
搞	ㄍㄠˇ
歌曲	ㄍㄜ ㄑㄩˇ
個兒	ㄍㄜˋ ㄦ˙
隔壁	ㄍㄜˊ ㄅㄧˋ
跟前	ㄍㄣ ㄑㄧㄢ˙
更換	ㄍㄥ ㄏㄨㄢˋ
跟隨	ㄍㄣ ㄙㄨㄟˊ
工藝	ㄍㄨㄥ ㄧˋ
工作日	ㄍㄨㄥ ㄗㄨㄛˋ ㄖˋ
更新	ㄍㄥ ㄒㄧㄣ
公認	ㄍㄨㄥ ㄖㄣˋ
公式	ㄍㄨㄥ ㄕˋ
公告	ㄍㄨㄥ ㄍㄠˋ
公正	ㄍㄨㄥ ㄓㄥˋ
共計	ㄍㄨㄥˋ ㄐㄧˋ
共享	ㄍㄨㄥˋ ㄒㄧㄤˇ
溝通	ㄍㄡ ㄊㄨㄥ
溝	ㄍㄡ
鼓	ㄍㄨˇ
估計	ㄍㄨ ㄐㄧˋ
古老	ㄍㄨˇ ㄌㄠˇ
鼓掌	ㄍㄨˇ ㄓㄤˇ
鼓勵	ㄍㄨˇ ㄌㄧˋ
顧問	ㄍㄨˋ ㄨㄣˋ
關懷	ㄍㄨㄢ ㄏㄨㄞˊ
關鍵	ㄍㄨㄢ ㄐㄧㄢˋ
冠軍	ㄍㄨㄢˋ ㄐㄩㄣ
怪	ㄍㄨㄞˋ
光榮	ㄍㄨㄤ ㄖㄨㄥˊ
光線	ㄍㄨㄤ ㄒㄧㄢˋ
廣	ㄍㄨㄤˇ
廣泛	ㄍㄨㄤˇ ㄈㄢˋ
鬼	ㄍㄨㄟˇ
規劃	ㄍㄨㄟ ㄏㄨㄚˋ
櫃子	ㄍㄨㄟˋ ㄗ˙
滾	ㄍㄨㄣˇ
國籍	ㄍㄨㄛˊ ㄐㄧˊ
鍋	ㄍㄨㄛ
國民	ㄍㄨㄛˊ ㄇㄧㄣˊ
過於	ㄍㄨㄛˋ ㄩˊ
過敏	ㄍㄨㄛˋ ㄇㄧㄣˇ
害	ㄏㄞˋ
過度	ㄍㄨㄛˋ ㄉㄨˋ
好運	ㄏㄠˇ ㄩㄣˋ
號召	ㄏㄠˋ ㄓㄠˋ
汗	ㄏㄢˋ
合併	ㄏㄜˊ ㄅㄧㄥˋ
合成	ㄏㄜˊ ㄔㄥˊ
盒飯	ㄏㄜˊ ㄈㄢˋ
盒	ㄏㄜˊ
賀卡	ㄏㄜˋ ㄎㄚˇ
恨	ㄏㄣˋ
盒子	ㄏㄜˊ ㄗ˙
後悔	ㄏㄡˋ ㄏㄨㄟˇ
胡同兒	ㄏㄨˊ ㄊㄨㄥˋ ㄦ˙
鬍子	ㄏㄨˊ ㄗ˙
猴	ㄏㄡˊ
華語	ㄏㄨㄚˊ ㄩˇ
虎	ㄏㄨˇ
滑	ㄏㄨㄚˊ
化石	ㄏㄨㄚˋ ㄕˊ
畫面	ㄏㄨㄚˋ ㄇㄧㄢˋ
劃分	ㄏㄨㄚˋ ㄈㄣ
環節	ㄏㄨㄢˊ ㄐㄧㄝˊ
慌忙	ㄏㄨㄤ ㄇㄤˊ
慌	ㄏㄨㄤ
灰色	ㄏㄨㄟ ㄙㄜˋ
回報	ㄏㄨㄟˊ ㄅㄠˋ
回顧	ㄏㄨㄟˊ ㄍㄨˋ
回收	ㄏㄨㄟˊ ㄕㄡ
迴避	ㄏㄨㄟˊ ㄅㄧˋ
回頭	ㄏㄨㄟˊ ㄊㄡˊ
恢復	ㄏㄨㄟ ㄈㄨˋ
回信	ㄏㄨㄟˊ ㄒㄧㄣˋ
匯款	ㄏㄨㄟˋ ㄎㄨㄢˇ
活力	ㄏㄨㄛˊ ㄌㄧˋ
會談	ㄏㄨㄟˋ ㄊㄢˊ
活潑	ㄏㄨㄛˊ ㄆㄛ˙
迴憶	ㄏㄨㄟˊ ㄧˋ
火柴	ㄏㄨㄛˇ ㄔㄞˊ
火腿	ㄏㄨㄛˇ ㄊㄨㄟˇ
或是	ㄏㄨㄛˋ ㄕˋ
機器人	ㄐㄧ ㄑㄧˋ ㄖㄣˊ
火災	ㄏㄨㄛˇ ㄗㄞ
肌肉	ㄐㄧ ㄖㄡˋ
機製	ㄐㄧ ㄓˋ
基金	ㄐㄧ ㄐㄧㄣ
即使	ㄐㄧˊ ㄕˇ
基地	ㄐㄧ ㄉㄧˋ
擠	ㄐㄧˇ
記憶	ㄐㄧˋ ㄧˋ
集團	ㄐㄧˊ ㄊㄨㄢˊ
加熱	ㄐㄧㄚ ㄖㄜˋ
繼承	ㄐㄧˋ ㄔㄥˊ
技能	ㄐㄧˋ ㄋㄥˊ
加上	ㄐㄧㄚ ㄕㄤ˙
加速	ㄐㄧㄚ ㄙㄨˋ
夾	ㄐㄧㄚ
加以	ㄐㄧㄚ ㄧˇ
駕駛	ㄐㄧㄚˋ ㄕˇ
價	ㄐㄧㄚˋ
駕照	ㄐㄧㄚˋ ㄓㄠˋ
堅定	ㄐㄧㄢ ㄉㄧㄥˋ
艱苦	ㄐㄧㄢ ㄎㄨˇ
艱難	ㄐㄧㄢ ㄋㄢˊ
檢驗	ㄐㄧㄢˇ ㄧㄢˋ
減輕	ㄐㄧㄢˇ ㄑㄧㄥ
肩	ㄐㄧㄢ
剪	ㄐㄧㄢˇ
剪刀	ㄐㄧㄢˇ ㄉㄠ
剪子	ㄐㄧㄢˇ ㄗ˙
間接	ㄐㄧㄢˋ ㄐㄧㄝ
建造	ㄐㄧㄢˋ ㄗㄠˋ
健全	ㄐㄧㄢˋ ㄑㄩㄢˊ
甲	ㄐㄧㄚˇ
建築	ㄐㄧㄢˋ ㄓㄨˋ
鍵盤	ㄐㄧㄢˋ ㄆㄢˊ
鍵	ㄐㄧㄢˋ
將	ㄐㄧㄤ
獎勵	ㄐㄧㄤˇ ㄌㄧˋ
將要	ㄐㄧㄤ ㄧㄠˋ
交代	ㄐㄧㄠ ㄉㄞˋ
膠帶	ㄐㄧㄠ ㄉㄞˋ
膠水	ㄐㄧㄠ ㄕㄨㄟˇ
郊區	ㄐㄧㄠ ㄑㄩ
腳步	ㄐㄧㄠˇ ㄅㄨˋ
接連	ㄐㄧㄝ ㄌㄧㄢˊ
解除	ㄐㄧㄝˇ ㄔㄨˊ
接觸	ㄐㄧㄝ ㄔㄨˋ
解放	ㄐㄧㄝˇ ㄈㄤˋ
屆	ㄐㄧㄝˋ
今日	ㄐㄧㄣ ㄖˋ
戒	ㄐㄧㄝˋ
緊緊	ㄐㄧㄣˇ ㄐㄧㄣˇ
儘可能	ㄐㄧㄣˇ ㄎㄜˇ ㄋㄥˊ
儘管	ㄐㄧㄣˇ ㄍㄨㄢˇ
進化	ㄐㄧㄣˋ ㄏㄨㄚˋ
近來	ㄐㄧㄣˋ ㄌㄞˊ
經費	ㄐㄧㄥ ㄈㄟˋ
景象	ㄐㄧㄥˇ ㄒㄧㄤˋ
警告	ㄐㄧㄥˇ ㄍㄠˋ
競賽	ㄐㄧㄥˋ ㄙㄞˋ
競爭	ㄐㄧㄥˋ ㄓㄥ
救災	ㄐㄧㄡˋ ㄗㄞ
酒鬼	ㄐㄧㄡˇ ㄍㄨㄟˇ
居然	ㄐㄩ ㄖㄢˊ
局面	ㄐㄩˊ ㄇㄧㄢˋ
局長	ㄐㄩˊ ㄓㄤˇ
拒絕	ㄐㄩˋ ㄐㄩㄝˊ
俱樂部	ㄐㄩˋ ㄌㄜˋ ㄅㄨˋ
劇本	ㄐㄩˋ ㄅㄣˇ
舉動	ㄐㄩˇ ㄉㄨㄥˋ
絕望	ㄐㄩㄝˊ ㄨㄤˋ
軍人	ㄐㄩㄣ ㄖㄣˊ
決不	ㄐㄩㄝˊ ㄅㄨˋ
開幕	ㄎㄞ ㄇㄨˋ
開幕式	ㄎㄞ ㄇㄨˋ ㄕˋ
看成	ㄎㄢˋ ㄔㄥˊ
看待	ㄎㄢˋ ㄉㄞˋ
看出	ㄎㄢˋ ㄔㄨ
烤肉	ㄎㄠˇ ㄖㄡˋ
考核	ㄎㄠˇ ㄏㄜˊ
靠近	ㄎㄠˋ ㄐㄧㄣˋ
烤鴨	ㄎㄠˇ ㄧㄚ
咳	ㄏㄞ
顆	ㄎㄜ
可憐	ㄎㄜˇ ㄌㄧㄢˊ
可	ㄎㄜˇ
可惜	ㄎㄜˇ ㄒㄧ
渴望	ㄎㄜˇ ㄨㄤˋ
客戶	ㄎㄜˋ ㄏㄨˋ
刻	ㄎㄜˋ
客氣	ㄎㄜˋ ㄑㄧ˙
課題	ㄎㄜˋ ㄊㄧˊ
客廳	ㄎㄜˋ ㄊㄧㄥ
空中	ㄎㄨㄥ ㄓㄨㄥ
口號	ㄎㄡˇ ㄏㄠˋ
控制	ㄎㄨㄥˋ ㄓˋ
肯定	ㄎㄣˇ ㄉㄧㄥˋ
庫	ㄎㄨˋ
快活	ㄎㄨㄞˋ ㄏㄨㄛ˙
狂	ㄎㄨㄤˊ
寬度	ㄎㄨㄢ ㄉㄨˋ
落	ㄌㄨㄛˋ
困擾	ㄎㄨㄣˋ ㄖㄠˇ
虧	ㄎㄨㄟ
來信	ㄌㄞˊ ㄒㄧㄣˋ
爛	ㄌㄢˋ
朗讀	ㄌㄤˇ ㄉㄨˊ
浪漫	ㄌㄤˋ ㄇㄢˋ
梨	ㄌㄧˊ
勞動	ㄌㄠˊ ㄉㄨㄥ˙
禮拜	ㄌㄧˇ ㄅㄞˋ
禮貌	ㄌㄧˇ ㄇㄠˋ
禮	ㄌㄧˇ
厲害	ㄌㄧˋ ㄏㄞ˙
立場	ㄌㄧˋ ㄔㄤˇ
利潤	ㄌㄧˋ ㄖㄨㄣˋ
例外	ㄌㄧˋ ㄨㄞˋ
連接	ㄌㄧㄢˊ ㄐㄧㄝ
聯想	ㄌㄧㄢˊ ㄒㄧㄤˇ
聯絡	ㄌㄧㄢˊ ㄌㄨㄛˋ
立	ㄌㄧˋ
臉盆	ㄌㄧㄢˇ ㄆㄣˊ
戀愛	ㄌㄧㄚˋ ㄋㄞˋ
兩岸	ㄌㄧㄢˇ ㄍㄢˋ
臉色	ㄌㄧㄢˇ ㄙㄜˋ
鈴聲	ㄌㄧㄥˊ ㄕㄥ
鄰居	ㄌㄧㄣˊ ㄐㄩ
領帶	ㄌㄧㄥˇ ㄉㄞˋ
令	ㄌㄧㄥˋ
流動	ㄌㄧㄡˊ ㄉㄨㄥˋ
鈴	ㄌㄧㄥˊ
流通	ㄌㄧㄡˊ ㄊㄨㄥ
漏洞	ㄌㄡˋ ㄉㄨㄥˋ
漏	ㄌㄡˋ
邏輯	ㄌㄨㄛˊ ㄐㄧ˙
落實	ㄌㄨㄛˋ ㄕˊ
碼頭	ㄇㄚˇ ㄊㄡ˙
買賣	ㄇㄞˇ ㄇㄞ˙
漫長	ㄇㄢˋ ㄔㄤˊ
毛筆	ㄇㄠˊ ㄅㄧˇ
漫畫	ㄇㄢˋ ㄏㄨㄚˋ
冒	ㄇㄠˋ
矛盾	ㄇㄠˊ ㄉㄨㄣˋ
罵	ㄇㄚˋ
貿易	ㄇㄠˋ ㄧˋ
煤	ㄇㄟˊ
煤氣	ㄇㄟˊ ㄑㄧˋ
門診	ㄇㄣˊ ㄓㄣˇ
迷信	ㄇㄧˊ ㄒㄧㄣˋ
面貌	ㄇㄧㄢˋ ㄇㄠˋ
迷人	ㄇㄧˊ ㄖㄣˊ
秒	ㄇㄧㄠˇ
敏感	ㄇㄧㄣˇ ㄍㄢˇ
明亮	ㄇㄧㄥˊ ㄌㄧㄤˋ
面子	ㄇㄧㄢˋ ㄗ˙
明明	ㄇㄧㄥˊ ㄇㄧㄥˊ
命令	ㄇㄧㄥˋ ㄌㄧㄥˋ
模仿	ㄇㄛˊ ㄈㄤˇ
模範	ㄇㄛˊ ㄈㄢˋ
模糊	ㄇㄛˊ ㄏㄨ˙
模式	ㄇㄛˊ ㄕˋ
摩擦	ㄇㄛˊ ㄘㄚ
摩託	ㄇㄛˊ ㄊㄨㄛ
模樣	ㄇㄨˊ ㄧㄤˋ
目光	ㄇㄨˋ ㄍㄨㄤ
男性	ㄋㄢˊ ㄒㄧㄥˋ
南北	ㄋㄢˊ ㄅㄟˇ
耐心	ㄋㄞˋ ㄒㄧㄣ
南極	ㄋㄢˊ ㄐㄧˊ
難得	ㄋㄢˊ ㄉㄜˊ
難以	ㄋㄢˊ ㄧˇ
能量	ㄋㄥˊ ㄌㄧㄤˋ
內在	ㄋㄟˋ ㄗㄞˋ
年齡	ㄋㄧㄢˊ ㄌㄧㄥˊ
年度	ㄋㄧㄢˊ ㄉㄨˋ
年前	ㄋㄧㄢˊ ㄑㄧㄢˊ
腦子	ㄋㄠˇ ㄗ˙
牛仔褲	ㄋㄧㄡˊ ㄗㄞˇ ㄎㄨˋ
牛	ㄋㄧㄡˊ
農產品	ㄋㄨㄥˊ ㄔㄢˇ ㄆㄧㄣˇ
暖	ㄋㄨㄢˇ
女性	ㄋㄩˇ ㄒㄧㄥˋ
偶然	ㄡˇ ㄖㄢˊ
偶像	ㄡˇ ㄒㄧㄤˋ
偶爾	ㄡˇ ㄦˇ
排除	ㄆㄞˊ ㄔㄨˊ
拍攝	ㄆㄞ ㄕㄜˋ
陪	ㄆㄟˊ
賠	ㄆㄟˊ
賠償	ㄆㄟˊ ㄔㄤˊ
配備	ㄆㄟˋ ㄅㄟˋ
旁	ㄆㄤˊ
配套	ㄆㄟˋ ㄊㄠˋ
噴	ㄆㄣ
盆	ㄆㄣˊ
披	ㄆㄧ
皮膚	ㄆㄧˊ ㄈㄨ
脾氣	ㄆㄧˊ ㄑㄧ˙
皮鞋	ㄆㄧˊ ㄒㄧㄝˊ
騙	ㄆㄧㄢˋ
騙子	ㄆㄧㄢˋ ㄗ˙
頻道	ㄆㄧㄣˊ ㄉㄠˋ
拼	ㄆㄧㄣ
頻繁	ㄆㄧㄣˊ ㄈㄢˊ
品	ㄆㄧㄣˇ
品種	ㄆㄧㄣˇ ㄓㄨㄥˇ
匹	ㄆㄧˇ
平坦	ㄆㄧㄥˊ ㄊㄢˇ
平原	ㄆㄧㄥˊ ㄩㄢˊ
評論	ㄆㄧㄥˊ ㄌㄨㄣˋ
評估	ㄆㄧㄥˊ ㄍㄨ
憑	ㄆㄧㄥˊ
葡萄	ㄆㄨˊ ㄊㄠ˙
潑	ㄆㄛ
葡萄酒	ㄆㄨˊ ㄊㄠ˙ ㄐㄧㄡˇ
其	ㄑㄧˊ
啟動	ㄑㄧˇ ㄉㄨㄥˋ
齊全	ㄑㄧˊ ㄑㄩㄢˊ
啟發	ㄑㄧˇ ㄈㄚ
啟事	ㄑㄧˇ ㄕˋ
起到	ㄑㄧˇ ㄉㄠˋ
期望	ㄑㄧ ㄨㄤˋ
氣象	ㄑㄧˋ ㄒㄧㄤˋ
簽訂	ㄑㄧㄢ ㄉㄧㄥˋ
簽	ㄑㄧㄢ
起碼	ㄑㄧˇ ㄇㄚˇ
簽名	ㄑㄧㄢ ㄇㄧㄥˊ
簽證	ㄑㄧㄢ ㄓㄥˋ
簽約	ㄑㄧㄢ ㄩㄝ
簽字	ㄑㄧㄢ ㄗˋ
前景	ㄑㄧㄢˊ ㄐㄧㄥˇ
氣體	ㄑㄧˋ ㄊㄧˇ
欠	ㄑㄧㄢˋ
槍	ㄑㄧㄤ
前提	ㄑㄧㄢˊ ㄊㄧˊ
強度	ㄑㄧㄤˊ ㄉㄨˋ
牆壁	ㄑㄧㄤˊ ㄅㄧˋ
搶救	ㄑㄧㄤˇ ㄐㄧㄡˋ
強迫	ㄑㄧㄤˇ ㄆㄛˋ
悄悄	ㄑㄧㄠ ㄑㄧㄠ
搶	ㄑㄧㄤˇ
瞧	ㄑㄧㄠˊ
敲	ㄑㄧㄠ
勤奮	ㄑㄧㄣˊ ㄈㄣˋ
琴	ㄑㄧㄣˊ
青	ㄑㄧㄥ
敲門	ㄑㄧㄠ ㄇㄣˊ
清理	ㄑㄧㄥ ㄌㄧˇ
清晨	ㄑㄧㄥ ㄔㄣˊ
區域	ㄑㄩ ㄩˋ
晴朗	ㄑㄧㄥˊ ㄌㄤˇ
全都	ㄑㄩㄢˊ ㄉㄡ
情節	ㄑㄧㄥˊ ㄐㄧㄝˊ
全世界	ㄑㄩㄢˊ ㄕˋ ㄐㄧㄝˋ
情形	ㄑㄧㄥˊ ㄒㄧㄥ˙
勸	ㄑㄩㄢˋ
泉	ㄑㄩㄢˊ
缺乏	ㄑㄩㄝ ㄈㄚˊ
確立	ㄑㄩㄝˋ ㄌㄧˋ
群眾	ㄑㄩㄣˊ ㄓㄨㄥˋ
群體	ㄑㄩㄣˊ ㄊㄧˇ
熱量	ㄖㄜˋ ㄌㄧㄤˋ
染	ㄖㄢˇ
熱門	ㄖㄜˋ ㄇㄣˊ
人間	ㄖㄣˊ ㄐㄧㄢ
人士	ㄖㄣˊ ㄕˋ
人物	ㄖㄣˊ ㄨˋ
忍	ㄖㄣˇ
人力	ㄖㄣˊ ㄌㄧˋ
忍不住	ㄖㄣˇ ㄅㄨ˙ ㄓㄨˋ
繞	ㄖㄠˋ
認	ㄖㄣˋ
認定	ㄖㄣˋ ㄉㄧㄥˋ
忍受	ㄖㄣˇ ㄕㄡˋ
扔	ㄖㄥ
如此	ㄖㄨˊ ㄘˇ
仍舊	ㄖㄥˊ ㄐㄧㄡˋ
入門	ㄖㄨˋ ㄇㄣˊ
如同	ㄖㄨˊ ㄊㄨㄥˊ
軟件	ㄖㄨㄢˇ ㄐㄧㄢˋ
如下	ㄖㄨˊ ㄒㄧㄚˋ
軟	ㄖㄨㄢˇ
散	ㄙㄢˋ
灑	ㄙㄚˇ
殺毒	ㄕㄚ ㄉㄨˊ
殺	ㄕㄚ
沙漠	ㄕㄚ ㄇㄛˋ
散文	ㄙㄢˇ ㄨㄣˊ
山區	ㄕㄢ ㄑㄩ
傻	ㄕㄚˇ
扇	ㄕㄢˋ
扇子	ㄕㄢˋ ㄗ˙
商標	ㄕㄤ ㄅㄧㄠ
上級	ㄕㄤˋ ㄐㄧˊ
上下	ㄕㄤˋ ㄒㄧㄚˋ
上漲	ㄕㄤˋ ㄓㄤˇ
稍微	ㄕㄠ ㄨㄟ
蛇	ㄕㄜˊ
稍	ㄕㄠ
捨不得	ㄕㄜˇ ㄅㄨ˙ ㄉㄜ˙
捨得	ㄕㄜˇ ㄉㄜ˙
設想	ㄕㄜˋ ㄒㄧㄤˇ
社	ㄕㄜˋ
社區	ㄕㄜˋ ㄑㄩ
射	ㄕㄜˋ
射擊	ㄕㄜˋ ㄐㄧ
攝像	ㄕㄜˋ ㄒㄧㄤˋ
攝像機	ㄕㄜˋ ㄒㄧㄤˋ ㄐㄧ
攝影師	ㄕㄜˋ ㄧㄥˇ ㄕ
伸	ㄕㄣ
攝影	ㄕㄜˋ ㄧㄥˇ
深度	ㄕㄣ ㄉㄨˋ
神	ㄕㄣˊ
神經	ㄕㄣˊ ㄐㄧㄥ
深處	ㄕㄣ ㄔㄨˋ
神情	ㄕㄣˊ ㄑㄧㄥˊ
生成	ㄕㄥ ㄔㄥˊ
昇高	ㄕㄥ ㄍㄠ
聲	ㄕㄥ
神奇	ㄕㄣˊ ㄑㄧˊ
勝負	ㄕㄥˋ-ㄈㄨˋ
剩	ㄕㄥˋ
剩下	ㄕㄥˋ ㄒㄧㄚ˙
失誤	ㄕ ㄨˋ
師傅	ㄕ ㄈㄨ˙
詩歌	ㄕ ㄍㄜ
時常	ㄕˊ ㄔㄤˊ
十足	ㄕˊ ㄗㄨˊ
時光	ㄕˊ ㄍㄨㄤ
時機	ㄕˊ ㄐㄧ
時事	ㄕˊ ㄕˋ
實惠	ㄕˊ ㄏㄨㄟˋ
拾	ㄕㄜˋ
使得	ㄕˇ ㄉㄜ˙
示範	ㄕˋ ㄈㄢˋ
式	ㄕˋ
勢力	ㄕˋ ㄌㄧ˙
試圖	ㄕˋ ㄊㄨˊ
視頻	ㄕˋ ㄆㄧㄣˊ
收購	ㄕㄡ ㄍㄡˋ
收集	ㄕㄡ ㄐㄧˊ
收拾	ㄕㄡ ㄕ˙
手段	ㄕㄡˇ ㄉㄨㄢˋ
壽司	ㄕㄡˋ ㄙ
手法	ㄕㄡˇ ㄈㄚˇ
受災	ㄕㄡˋ ㄗㄞ
視為	ㄕˋ ㄨㄟˊ
瘦	ㄕㄡˋ
書法	ㄕㄨ ㄈㄚˇ
書桌	ㄕㄨ ㄓㄨㄛ
輸出	ㄕㄨ ㄔㄨ
書櫃	ㄕㄨ ㄍㄨㄟˋ
鼠	ㄕㄨˇ
蔬菜	ㄕㄨ ㄘㄞˋ
鼠標	ㄕㄨˇ ㄅㄧㄠ
熟悉	ㄕㄨˊ ㄒㄧ˙
摔倒	ㄕㄨㄞ ㄉㄠˇ
摔	ㄕㄨㄞ
數目	ㄕㄨˋ ㄇㄨˋ
雙手	ㄕㄨㄤ ㄕㄡˇ
水產品	ㄕㄨㄟˇ ㄔㄢˇ ㄆㄧㄣˇ
率領	ㄕㄨㄞˋ ㄌㄧㄥˇ
水分	ㄕㄨㄟˇ ㄈㄣˋ
水庫	ㄕㄨㄟˇ ㄎㄨˋ
水災	ㄕㄨㄟˇ ㄗㄞ
說法	ㄕㄨㄛ ㄈㄚ˙
碩士	ㄕㄨㄛˋ ㄕˋ
私人	ㄙ ㄖㄣˊ
睡眠	ㄕㄨㄟˋ ㄇㄧㄢˊ
搜	ㄙㄡ
四周	ㄙˋ ㄓㄡ
搜索	ㄙㄡ ㄙㄨㄛˇ
宿舍	ㄙㄨˋ ㄕㄜˋ
酸甜苦辣	ㄙㄨㄢ-ㄊㄧㄢˊ-ㄎㄨˇ-ㄌㄚˋ
隨意	ㄙㄨㄟˊ ㄧˋ
隨後	ㄙㄨㄟˊ ㄏㄡˋ
歲月	ㄙㄨㄟˋ ㄩㄝˋ
思維	ㄙ ㄨㄟˊ
碎	ㄙㄨㄟˋ
隨著	ㄙㄨㄟˊ ㄓㄜ˙
損害	ㄙㄨㄣˇ ㄏㄞˋ
所在	ㄙㄨㄛˇ ㄗㄞˋ
鎖	ㄙㄨㄛˇ
損失	ㄙㄨㄣˇ ㄕ
颱風	ㄊㄞˊ ㄈㄥ
抬頭	ㄊㄞˊ ㄊㄡˊ
太空	ㄊㄞˋ ㄎㄨㄥ
抬	ㄊㄞˊ
彈	ㄉㄢˋ
逃跑	ㄊㄠˊ ㄆㄠˇ
逃走	ㄊㄠˊ ㄗㄡˇ
逃	ㄊㄠˊ
桃	ㄊㄠˊ
桃樹	ㄊㄠˊ ㄕㄨˋ
討厭	ㄊㄠˇ ㄧㄢˋ
桃花	ㄊㄠˊ ㄏㄨㄚ
特性	ㄊㄜˋ ㄒㄧㄥˋ
特有	ㄊㄜˋ ㄧㄡˇ
特定	ㄊㄜˋ ㄉㄧㄥˋ
提倡	ㄊㄧˊ ㄔㄤˋ
提起	ㄊㄧˊ ㄑㄧˇ
提示	ㄊㄧˊ ㄕˋ
體積	ㄊㄧˇ ㄐㄧ
題材	ㄊㄧˊ ㄘㄞˊ
天才	ㄊㄧㄢ ㄘㄞˊ
天然氣	ㄊㄧㄢ ㄖㄢˊ ㄑㄧˋ
體力	ㄊㄧˇ ㄌㄧˋ
天文	ㄊㄧㄢ ㄨㄣˊ
廳	ㄊㄧㄥ
調解	ㄊㄧㄠˊ ㄐㄧㄝˇ
通用	ㄊㄨㄥ ㄩㄥˋ
偷	ㄊㄡ
調節	ㄊㄧㄠˊ ㄐㄧㄝˊ
停留	ㄊㄧㄥˊ ㄌㄧㄡˊ
偷偷	ㄊㄡ ㄊㄡ
土豆	ㄊㄨˇ ㄉㄡˋ
突破	ㄊㄨ ㄆㄛˋ
吐	ㄊㄨˇ
兔	ㄊㄨˋ
團長	ㄊㄨㄢˊ ㄓㄤˇ
推行	ㄊㄨㄟ ㄒㄧㄥˊ
脫離	ㄊㄨㄛ ㄌㄧˊ
外界	ㄨㄞˋ ㄐㄧㄝˋ
完了	ㄨㄢˊ ㄌㄧㄠˇ
為難	ㄨㄟˊ ㄋㄢˊ
微博	ㄨㄟ ㄅㄛˊ
為期	ㄨㄟˊ ㄑㄧ
為止	ㄨㄟˊ ㄓˇ
違法	ㄨㄟˊ ㄈㄚˇ
違反	ㄨㄟˊ ㄈㄢˇ
圍繞	ㄨㄟˊ ㄖㄠˋ
違規	ㄨㄟˊ ㄍㄨㄟ
委託	ㄨㄟˇ ㄊㄨㄛ
唯一	ㄨㄟˊ ㄧ
為主	ㄨㄟˊ ㄓㄨˇ
衛星	ㄨㄟˋ ㄒㄧㄥ
溫和	ㄨㄣ ㄏㄜˊ
胃	ㄨㄟˋ
慰問	ㄨㄟˋ ㄨㄣˋ
握	ㄨㄛˋ
文藝	ㄨㄣˊ ㄧˋ
污水	ㄨ ㄕㄨㄟˇ
臥室	ㄨㄛˋ ㄕˋ
無奈	ㄨˊ ㄋㄞˋ
污染	ㄨ ㄖㄢˇ
舞	ㄨˇ
無疑	ㄨˊ ㄧˊ
物價	ㄨˋ ㄐㄧㄚˋ
屋	ㄨ
物業	ㄨˋ ㄧㄝˋ
物質	ㄨˋ ㄓˋ
誤解	ㄨˋ ㄐㄧㄝˇ
西紅柿	ㄒㄧ ㄏㄨㄥˊ ㄕˋ
喜劇	ㄒㄧˇ ㄐㄩˋ
西裝	ㄒㄧ ㄓㄨㄤ
戲	ㄒㄧˋ
戲劇	ㄒㄧˋ ㄐㄩˋ
嚇	ㄒㄧㄚˋ
先前	ㄒㄧㄢ ㄑㄧㄢˊ
鮮艷	ㄒㄧㄢ ㄧㄢˋ
顯	ㄒㄧㄢˇ
先後	ㄒㄧㄢ ㄏㄡˋ
現有	ㄒㄧㄢˋ ㄧㄡˇ
現狀	ㄒㄧㄢˋ ㄓㄨㄤˋ
獻	ㄒㄧㄢˋ
閑	ㄒㄧㄢˊ
線索	ㄒㄧㄢˋ ㄙㄨㄛˇ
鄉村	ㄒㄧㄤ ㄘㄨㄣ
相等	ㄒㄧㄤ ㄉㄥˇ
香腸	ㄒㄧㄤ ㄔㄤˊ
詳細	ㄒㄧㄤˊ ㄒㄧˋ
相應	ㄒㄧㄤ ㄧㄥ˙
鄉	ㄒㄧㄤ
嚮導	ㄒㄧㄤˋ ㄉㄠˇ
享受	ㄒㄧㄤˇ ㄕㄡˋ
向上	ㄒㄧㄤˋ ㄕㄤˋ
象徵	ㄒㄧㄤˋ ㄓㄥ
相聲	ㄒㄧㄤˋ ㄕㄥ˙
消毒	ㄒㄧㄠ ㄉㄨˊ
消除	ㄒㄧㄠ ㄔㄨˊ
向前	ㄒㄧㄤˋ ㄑㄧㄢˊ
消防	ㄒㄧㄠ ㄈㄤˊ
消費者	ㄒㄧㄠ ㄈㄟˋ ㄓㄜˇ
小偷兒	ㄒㄧㄠˇ ㄊㄡ ㄦ˙
消極	ㄒㄧㄠ ㄐㄧˊ
歇	ㄒㄧㄝ
協議書	ㄒㄧㄝˊ ㄧˋ ㄕㄨ
斜	ㄒㄧㄝˊ
心態	ㄒㄧㄣ ㄊㄞˋ
心疼	ㄒㄧㄣ ㄊㄥˊ
辛苦	ㄒㄧㄣ ㄎㄨˇ
協議	ㄒㄧㄝˊ ㄧˋ
欣賞	ㄒㄧㄣ ㄕㄤˇ
信箱	ㄒㄧㄣˋ ㄒㄧㄤ
行駛	ㄒㄧㄥˊ ㄕˇ
信念	ㄒㄧㄣˋ ㄋㄧㄢˋ
形態	ㄒㄧㄥˊ ㄊㄞˋ
性能	ㄒㄧㄥˋ ㄋㄥˊ
雄偉	ㄒㄩㄥˊ ㄨㄟˇ
熊	ㄒㄩㄥˊ
休閒	ㄒㄧㄡ ㄒㄧㄢˊ
修復	ㄒㄧㄡ ㄈㄨˋ
修養	ㄒㄧㄡ ㄧㄤˇ
修建	ㄒㄧㄡ ㄐㄧㄢˋ
虛心	ㄒㄩ ㄒㄧㄣ
選修	ㄒㄩㄢˇ ㄒㄧㄡ
學科	ㄒㄩㄝˊ ㄎㄜ
學位	ㄒㄩㄝˊ ㄨㄟˋ
尋求	ㄒㄩㄣˊ ㄑㄧㄡˊ
學者	ㄒㄩㄝˊ ㄓㄜˇ
許可	ㄒㄩˇ ㄎㄜˇ
押金	ㄧㄚ ㄐㄧㄣ
詢問	ㄒㄩㄣˊ ㄨㄣˋ
延伸	ㄧㄢˊ ㄕㄣ
亞軍	ㄧㄚˋ ㄐㄩㄣ
鴨子	ㄧㄚ ㄗ˙
嚴厲	ㄧㄢˊ ㄌㄧˋ
嚴肅	ㄧㄢˊ ㄙㄨˋ
言語	ㄧㄢˊ ㄩ˙
研究所	ㄧㄢˊ ㄐㄧㄡ ㄙㄨㄛˇ
邀請	ㄧㄠ ㄑㄧㄥˇ
眼光	ㄧㄢˇ ㄍㄨㄤ
搖頭	ㄧㄠˊ ㄊㄡˊ
也好	ㄧㄝˇ ㄏㄠˇ
咬	ㄧㄠˇ
業務	ㄧㄝˋ ㄨˋ
夜間	ㄧㄝˋ ㄐㄧㄢ˙
依法	ㄧ ㄈㄚˇ
一流	ㄧ ㄌㄧㄡˊ
依據	ㄧ ㄐㄩˋ
依舊	ㄧ ㄐㄧㄡˋ
一輩子	ㄧ ㄅㄟˋ ㄗ˙
一帶	ㄧ ㄉㄞˋ
依照	ㄧ ㄓㄠˋ
一旦	ㄧ ㄉㄢˋ
一句話	ㄧ ㄐㄩˋ ㄏㄨㄚˋ
一下兒	ㄧ ㄒㄧㄚˋ ㄦ˙
一下子	ㄧ ㄒㄧㄚˋ ㄗ˙
一路	ㄧ ㄌㄨˋ
一向	ㄧ ㄒㄧㄤˋ
乙	ㄧˇ
以便	ㄧˇ ㄅㄧㄢˋ
以往	ㄧˇ ㄨㄤˇ
一口氣	ㄧ ㄎㄡˇ ㄑㄧˋ
一身	ㄧ ㄕㄣ
意識	ㄧˋ ㄕ˙
意味著	ㄧˋ ㄨㄟˋ ㄓㄜ˙
意志	ㄧˋ ㄓˋ
因而	ㄧ ㄋㄜˊ ㄦ˙
飲料	ㄧㄣˇ ㄌㄧㄠˋ
印刷	ㄧㄣˋ ㄕㄨㄚ
飲食	ㄧㄣˇ ㄕˊ
硬	ㄧㄥˋ
硬件	ㄧㄥˋ ㄐㄧㄢˋ
擁抱	ㄩㄥ ㄅㄠˋ
擁有	ㄩㄥ ㄧㄡˇ
用不著	ㄩㄥˋ ㄅㄨ˙ ㄓㄠˊ
用戶	ㄩㄥˋ ㄏㄨˋ
應	ㄧㄥ
用來	ㄩㄥˋ ㄌㄞˊ
優惠	ㄧㄡ ㄏㄨㄟˋ
優先	ㄧㄡ ㄒㄧㄢ
用于	ㄩㄥˋ ㄩˊ
幽默	ㄧㄡ ㄇㄛˋ
由此	ㄧㄡˊ ㄘˇ
尤其	ㄧㄡˊ ㄑㄧˊ
猶豫	ㄧㄡˊ ㄩˋ
游泳池	ㄧㄡˊ ㄩㄥˇ ㄔˊ
有毒	ㄧㄡˇ ㄉㄨˊ
有害	ㄧㄡˇ ㄏㄞˋ
友誼	ㄧㄡˇ ㄧˋ
有力	ㄧㄡˇ ㄌㄧˋ
有利於	ㄧㄡˇ ㄌㄧˋ ㄩˊ
有著	ㄧㄡˇ ㄓㄜ˙
羽毛球	ㄩˇ ㄇㄠˊ ㄑㄧㄡˊ
預備	ㄩˋ ㄅㄟˋ
羽絨服	ㄩˇ ㄖㄨㄥˊ ㄈㄨˊ
雨水	ㄩˇ ㄕㄨㄟˇ
元旦	ㄩㄢˊ ㄉㄢˋ
預期	ㄩˋ ㄑㄧ
原理	ㄩㄢˊ ㄌㄧˇ
園林	ㄩㄢˊ ㄌㄧㄣˊ
原先	ㄩㄢˊ ㄒㄧㄢ
原始	ㄩㄢˊ ㄕˇ
怨	ㄩㄢˋ
原有	ㄩㄢˊ ㄧㄡˇ
遠處	ㄩㄢˇ ㄔㄨˋ
願	ㄩㄢˋ
約束	ㄩㄝ ㄕㄨˋ
月餅	ㄩㄝˋ ㄅㄧㄥ˙
閱覽室	ㄩㄝˋ ㄌㄢˇ ㄕˋ
運行	ㄩㄣˋ ㄒㄧㄥˊ
運	ㄩㄣˋ
月球	ㄩㄝˋ ㄑㄧㄡˊ
災	ㄗㄞ
災害	ㄗㄞ ㄏㄞˋ
再次	ㄗㄞˋ ㄘˋ
災區	ㄗㄞ ㄑㄩ
災難	ㄗㄞ ㄋㄢˋ
在場	ㄗㄞˋ ㄔㄤˇ
在內	ㄗㄞˋ ㄋㄟˋ
暫時	ㄗㄢˋ ㄕˊ
暫停	ㄗㄢˋ ㄊㄧㄥˊ
再也	ㄗㄞˋ ㄧㄝˇ
糟	ㄗㄠ
糟糕	ㄗㄠ ㄍㄠ
早期	ㄗㄠˇ ㄑㄧ
增	ㄗㄥ
增產	ㄗㄥ ㄔㄢˇ
增大	ㄗㄥ ㄉㄚˋ
增多	ㄗㄥ ㄉㄨㄛ
增強	ㄗㄥ ㄑㄧㄤˊ
摘	ㄓㄞ
贈	ㄗㄥˋ
展覽	ㄓㄢˇ ㄌㄢˇ
贈送	ㄗㄥˋ ㄙㄨㄥˋ
占領	ㄓㄢˋ ㄌㄧㄥˇ
展現	ㄓㄢˇ ㄒㄧㄢˋ
展示	ㄓㄢˇ ㄕˋ
占有	ㄓㄢˋ ㄧㄡˇ
漲	ㄓㄤˇ
漲價	ㄓㄤˇ ㄐㄧㄚˋ
掌握	ㄓㄤˇ ㄨㄛˋ
招生	ㄓㄠ ㄕㄥ
招手	ㄓㄠ ㄕㄡˇ
珍貴	ㄓㄣ ㄍㄨㄟˋ
珍珠	ㄓㄣ ㄓㄨ
珍惜	ㄓㄣ ㄒㄧ
真誠	ㄓㄣ ㄔㄥˊ
真相	ㄓㄣ ㄒㄧㄤˋ
診斷	ㄓㄣˇ ㄉㄨㄢˋ
真理	ㄓㄣ ㄌㄧˇ
振動	ㄓㄣˋ ㄉㄨㄥˋ
震驚	ㄓㄣˋ ㄐㄧㄥ
爭議	ㄓㄥ ㄧˋ
正版	ㄓㄥˋ ㄅㄢˇ
正如	ㄓㄥˋ ㄖㄨˊ
正規	ㄓㄥˋ ㄍㄨㄟ
證實	ㄓㄥˋ ㄕˊ
證書	ㄓㄥˋ ㄕㄨ
正義	ㄓㄥˋ ㄧˋ
掙錢	ㄓㄥˋ ㄑㄧㄢˊ
之內	ㄓ ㄋㄟˋ
掙	ㄓㄥ
之外	ㄓ ㄨㄞˋ
之中	ㄓ ㄓㄨㄥ
之下	ㄓ ㄒㄧㄚˋ
執行	ㄓˊ ㄒㄧㄥˊ
支出	ㄓ ㄔㄨ
直線	ㄓˊ ㄒㄧㄢˋ
支配	ㄓ ㄆㄟˋ
值班	ㄓˊ ㄅㄢ
職位	ㄓˊ ㄨㄟˋ
職能	ㄓˊ ㄋㄥˊ
只不過	ㄓˇ ㄅㄨ˙ ㄍㄨㄛˋ
只見	ㄓˇ ㄐㄧㄢˋ
指標	ㄓˇ ㄅㄧㄠ
職務	ㄓˊ ㄨˋ
指示	ㄓˇ ㄕˋ
指甲	ㄓˇ ㄐㄧㄚ˙
指責	ㄓˇ ㄗㄜˊ
製成	ㄓˋ ㄔㄥˊ
至	ㄓˋ
治安	ㄓˋ ㄢ
制約	ㄓˋ ㄩㄝ
中斷	ㄓㄨㄥ ㄉㄨㄢˋ
中秋節	ㄓㄨㄥ ㄑㄧㄡ ㄐㄧㄝˊ
治理	ㄓˋ ㄌㄧˇ
中央	ㄓㄨㄥ ㄧㄤ
中藥	ㄓㄨㄥ ㄧㄠˋ
終點	ㄓㄨㄥ ㄉㄧㄢˇ
終身	ㄓㄨㄥ ㄕㄣ
終止	ㄓㄨㄥ ㄓˇ
中毒	ㄓㄨㄥˋ ㄉㄨˊ
週期	ㄓㄡ ㄑㄧ
眾多	ㄓㄨㄥˋ ㄉㄨㄛ
竹子	ㄓㄨˊ ㄗ˙
主辦	ㄓㄨˇ ㄅㄢˋ
主觀	ㄓㄨˇ ㄍㄨㄢ
主體	ㄓㄨˇ ㄊㄧˇ
主管	ㄓㄨˇ ㄍㄨㄢˇ
助理	ㄓㄨˋ ㄌㄧˇ
助手	ㄓㄨˋ ㄕㄡˇ
主導	ㄓㄨˇ ㄉㄠˇ
注視	ㄓㄨˋ ㄕˋ
注射	ㄓㄨˋ ㄕㄜˋ
註冊	ㄓㄨˋ ㄘㄜˋ
注重	ㄓㄨˋ ㄓㄨㄥˋ
祝賀	ㄓㄨˋ ㄏㄜˋ
專輯	ㄓㄨㄢ ㄐㄧˊ
專利	ㄓㄨㄢ ㄌㄧˋ
轉化	ㄓㄨㄢˇ ㄏㄨㄚˋ
轉換	ㄓㄨㄢˇ ㄏㄨㄢˋ
轉讓	ㄓㄨㄢˇ ㄖㄤˋ
轉向	ㄓㄨㄢˇ ㄒㄧㄤˋ
裝飾	ㄓㄨㄤ ㄕˋ
撞	ㄓㄨㄤˋ
資產	ㄗ ㄔㄢˇ
資本	ㄗ ㄅㄣˇ
子彈	ㄗˇ ㄉㄢˋ
仔細	ㄗˇ ㄒㄧˋ
資助	ㄗ ㄓㄨˋ
自殺	ㄗˋ ㄕㄚ
紫	ㄗˇ
自豪	ㄗˋ ㄏㄠˊ
總裁	ㄗㄨㄥˇ ㄘㄞˊ
總數	ㄗㄨㄥˇ ㄕㄨˋ
總體	ㄗㄨㄥˇ ㄊㄧˇ
總算	ㄗㄨㄥˇ ㄙㄨㄢˋ
自願	ㄗˋ ㄩㄢˋ
阻礙	ㄗㄨˇ ㄞˋ
組織	ㄗㄨˇ ㄓ
醉	ㄗㄨㄟˋ
尊敬	ㄗㄨㄣ ㄐㄧㄥˋ
尊重	ㄗㄨㄣ ㄓㄨㄥˋ
遵守	ㄗㄨㄣ ㄕㄡˇ
