愛心	ㄞˋ ㄒㄧㄣ
安排	ㄢ ㄆㄞˊ
安裝	ㄢ ㄓㄨㄤ
按照	ㄢˋ ㄓㄠˋ
按	ㄢˋ
把握	ㄅㄚˇ ㄨㄛˋ
把	ㄅㄚˇ
白菜	ㄅㄞˊ ㄘㄞˋ
搬	ㄅㄢ
白	ㄅㄞˊ
班級	ㄅㄢ ㄐㄧˊ
搬家	ㄅㄢ ㄐㄧㄚ
辦理	ㄅㄢˋ ㄌㄧˇ
板	ㄅㄢˇ
保安	ㄅㄠˇ ㄢ
保持	ㄅㄠˇ ㄔˊ
保存	ㄅㄠˇ ㄘㄨㄣˊ
保	ㄅㄠˇ
保留	ㄅㄠˇ ㄌㄧㄡˊ
保險	ㄅㄠˇ ㄒㄧㄢˇ
保證	ㄅㄠˇ ㄓㄥˋ
保護	ㄅㄠˇ ㄏㄨˋ
報到	ㄅㄠˋ ㄉㄠˋ
背	ㄅㄟˋ
報道	ㄅㄠˋ ㄉㄠˋ
北部	ㄅㄟˇ ㄅㄨˋ
報	ㄅㄠˋ
報告	ㄅㄠˋ ㄍㄠˋ
背後	ㄅㄟˋ ㄏㄡˋ
本來	ㄅㄣˇ ㄌㄞˊ
本領	ㄅㄣˇ ㄌㄧㄥˇ
被	ㄅㄟˋ
比較	ㄅㄧˇ ㄐㄧㄠˋ
比例	ㄅㄧˇ ㄌㄧˋ
比賽	ㄅㄧˇ ㄙㄞˋ
必然	ㄅㄧˋ ㄖㄢˊ
被子	ㄅㄟˋ ㄗ˙
變化	ㄅㄧㄢˋ ㄏㄨㄚˋ
本事	ㄅㄣˇ ㄕ˙
變為	ㄅㄧㄢˋ ㄨㄟˊ
必要	ㄅㄧˋ ㄧㄠˋ
表達	ㄅㄧㄠˇ ㄉㄚˊ
標準	ㄅㄧㄠ ㄓㄨㄣˇ
標題	ㄅㄧㄠ ㄊㄧˊ
表格	ㄅㄧㄠˇ ㄍㄜˊ
表面	ㄅㄧㄠˇ ㄇㄧㄢˋ
表明	ㄅㄧㄠˇ ㄇㄧㄥˊ
表演	ㄅㄧㄠˇ ㄧㄢˇ
表現	ㄅㄧㄠˇ ㄒㄧㄢˋ
播出	ㄅㄛ ㄔㄨ
並且	ㄅㄧㄥˋ ㄑㄧㄝˇ
播放	ㄅㄛ ㄈㄤˋ
不必	ㄅㄨˋ ㄅㄧˋ
并	ㄅㄧㄥˋ
不論	ㄅㄨˋ ㄌㄨㄣˋ
補	ㄅㄨˇ
不斷	ㄅㄨˋ ㄉㄨㄢˋ
補充	ㄅㄨˇ ㄔㄨㄥ
不得不	ㄅㄨˋ ㄉㄜˊ ㄅㄨˋ
不安	ㄅㄨˋ ㄢ
不光	ㄅㄨˋ ㄍㄨㄤ
不僅	ㄅㄨˋ ㄐㄧㄣˇ
布	ㄅㄨˋ
步	ㄅㄨˋ
部門	ㄅㄨˋ ㄇㄣˊ
部	ㄅㄨˋ
部長	ㄅㄨˋ ㄓㄤˇ
才能	ㄘㄞˊ ㄋㄥˊ
採取	ㄘㄞˇ ㄑㄩˇ
彩色	ㄘㄞˇ ㄙㄜˋ
採用	ㄘㄞˇ ㄩㄥˋ
曾經	ㄘㄥˊ ㄐㄧㄥ
產生	ㄔㄢˇ ㄕㄥ
長處	ㄔㄤˊ ㄔㄨ˙
長城	ㄔㄤˊ ㄔㄥˊ
厰	ㄔㄤˇ
長期	ㄔㄤˊ ㄑㄧ
場合	ㄔㄤˇ ㄏㄜˊ
場所	ㄔㄤˇ ㄙㄨㄛˇ
朝	ㄔㄠˊ
吵	ㄔㄠˇ
襯衫	ㄔㄣˋ ㄕㄢ
超級	ㄔㄠ ㄐㄧˊ
吵架	ㄔㄠˇ ㄐㄧㄚˋ
襯衣	ㄔㄣˋ ㄧ
稱為	ㄔㄥ ㄨㄟˊ
成功	ㄔㄥˊ ㄍㄨㄥ
成果	ㄔㄥˊ ㄍㄨㄛˇ
成就	ㄔㄥˊ ㄐㄧㄡˋ
成熟	ㄔㄥˊ ㄕㄨˊ
成立	ㄔㄥˊ ㄌㄧˋ
成員	ㄔㄥˊ ㄩㄢˊ
成長	ㄔㄥˊ ㄓㄤˇ
城	ㄔㄥˊ
城市	ㄔㄥˊ ㄕˋ
持續	ㄔˊ ㄒㄩˋ
程度	ㄔㄥˊ ㄉㄨˋ
初	ㄔㄨ
充滿	ㄔㄨㄥ ㄇㄢˇ
初步	ㄔㄨ ㄅㄨˋ
初級	ㄔㄨ ㄐㄧˊ
重	ㄓㄨㄥˋ
初中	ㄔㄨ ㄓㄨㄥ
除了	ㄔㄨˊ ㄌㄜ˙
處理	ㄔㄨˇ ㄌㄧˇ
傳	ㄔㄨㄢˊ
傳播	ㄔㄨㄢˊ ㄅㄛ
傳說	ㄔㄨㄢˊ ㄕㄨㄛ
創新	ㄔㄨㄤˋ ㄒㄧㄣ
創造	ㄔㄨㄤˋ ㄗㄠˋ
傳來	ㄔㄨㄢˊ ㄌㄞˊ
創作	ㄔㄨㄤˋ ㄗㄨㄛˋ
創業	ㄔㄨㄤˋ ㄧㄝˋ
從前	ㄘㄨㄥˊ ㄑㄧㄢˊ
從來	ㄘㄨㄥˊ ㄌㄞˊ
從事	ㄘㄨㄥˊ ㄕˋ
存	ㄘㄨㄣˊ
村	ㄘㄨㄣ
存在	ㄘㄨㄣˊ ㄗㄞˋ
錯誤	ㄘㄨㄛˋ ㄨˋ
達到	ㄉㄚˊ ㄉㄠˋ
打破	ㄉㄚˇ ㄆㄛ˙
大概	ㄉㄚˋ ㄍㄞˋ
打聽	ㄉㄚˇ ㄊㄧㄥ˙
大使館	ㄉㄚˋ ㄕˇ ㄍㄨㄢˇ
大約	ㄉㄚˋ ㄩㄝ
代	ㄉㄞˋ
代表	ㄉㄞˋ ㄅㄧㄠˇ
大夫	ㄉㄚˋ ㄈㄨ
代表團	ㄉㄞˋ ㄅㄧㄠˇ ㄊㄨㄢˊ
帶動	ㄉㄞˋ ㄉㄨㄥˋ
單元	ㄉㄢ ㄩㄢˊ
當初	ㄉㄤ ㄔㄨ
帶領	ㄉㄞˋ ㄌㄧㄥˇ
當然	ㄉㄤ ㄖㄢˊ
當地	ㄉㄤ ㄉㄧˋ
當中	ㄉㄤ ㄓㄨㄥ
刀	ㄉㄠ
導演	ㄉㄠˇ ㄧㄢˇ
到達	ㄉㄠˋ ㄉㄚˊ
得分	ㄉㄜˊ ㄈㄣ
到底	ㄉㄠˋ ㄉㄧˇ
等待	ㄉㄥˇ ㄉㄞˋ
底下	ㄉㄧˇ ㄒㄧㄚ˙
地區	ㄉㄧˋ ㄑㄩ
電視臺	ㄉㄧㄢˋ ㄕˋ ㄊㄞˊ
電臺	ㄉㄧㄢˋ ㄊㄞˊ
電子郵件	ㄉㄧㄢˋ ㄗˇ ㄧㄡˊ ㄐㄧㄢˋ
調	ㄉㄧㄠˋ
電視劇	ㄉㄧㄢˋ ㄕˋ ㄐㄩˋ
調查	ㄉㄧㄠˋ ㄔㄚˊ
訂	ㄉㄧㄥˋ
定期	ㄉㄧㄥˋ ㄑㄧ
東部	ㄉㄨㄥ ㄅㄨˋ
動人	ㄉㄨㄥˋ ㄖㄣˊ
讀者	ㄉㄨˊ ㄓㄜˇ
動力	ㄉㄨㄥˋ ㄌㄧˋ
短褲	ㄉㄨㄢˇ ㄎㄨˋ
短處	ㄉㄨㄢˇ ㄔㄨ˙
斷	ㄉㄨㄢˋ
短期	ㄉㄨㄢˇ ㄑㄧ
隊員	ㄉㄨㄟˋ ㄩㄢˊ
對待	ㄉㄨㄟˋ ㄉㄞˋ
對方	ㄉㄨㄟˋ ㄈㄤ
對象	ㄉㄨㄟˋ ㄒㄧㄤˋ
對手	ㄉㄨㄟˋ ㄕㄡˇ
發表	ㄈㄚ ㄅㄧㄠˇ
頓	ㄉㄨㄣˋ
發出	ㄈㄚ ㄔㄨ
發達	ㄈㄚ ㄉㄚˊ
發動	ㄈㄚ ㄉㄨㄥˋ
發明	ㄈㄚ ㄇㄧㄥˊ
發生	ㄈㄚ ㄕㄥ
發送	ㄈㄚ ㄙㄨㄥ˙
發言	ㄈㄚ ㄧㄢˊ
發展	ㄈㄚ ㄓㄢˇ
反復	ㄈㄢˇ ㄈㄨˋ
反應	ㄈㄢˇ ㄧㄥˋ
反正	ㄈㄢˇ ㄓㄥ˙
範圍	ㄈㄢˋ ㄨㄟˊ
反對	ㄈㄢˇ ㄉㄨㄟˋ
防	ㄈㄤˊ
防止	ㄈㄤˊ ㄓˇ
方式	ㄈㄤ ㄕˋ
房東	ㄈㄤˊ ㄉㄨㄥ
訪問	ㄈㄤˇ ㄨㄣˋ
放到	ㄈㄤˋ ㄉㄠˋ
房屋	ㄈㄤˊ ㄨ
費	ㄈㄟˋ
飛行	ㄈㄟ ㄒㄧㄥˊ
房租	ㄈㄤˊ ㄗㄨ
費用	ㄈㄟˋ ㄩㄥ˙
分別	ㄈㄣ ㄅㄧㄝˊ
分組	ㄈㄣ ㄗㄨˇ
分配	ㄈㄣ ㄆㄟˋ
豐富	ㄈㄥ ㄈㄨˋ
風險	ㄈㄥ ㄒㄧㄢˇ
否定	ㄈㄡˇ ㄉㄧㄥˋ
服裝	ㄈㄨˊ ㄓㄨㄤ
父母	ㄈㄨˋ ㄇㄨˇ
否認	ㄈㄡˇ ㄖㄣˋ
福	ㄈㄨˊ
父親	ㄈㄨˋ ㄑㄧㄣ˙
負責	ㄈㄨˋ ㄗㄜˊ
複印	ㄈㄨˋ ㄧㄣˋ
付	ㄈㄨˋ
複雜	ㄈㄨˋ ㄗㄚˊ
改造	ㄍㄞˇ ㄗㄠˋ
富	ㄈㄨˋ
改進	ㄍㄞˇ ㄐㄧㄣˋ
概念	ㄍㄞˋ ㄋㄧㄢˋ
趕	ㄍㄢˇ
趕到	ㄍㄢˇ ㄉㄠˋ
趕快	ㄍㄢˇ ㄎㄨㄞˋ
趕緊	ㄍㄢˇ ㄐㄧㄣˇ
敢	ㄍㄢˇ
感冒	ㄍㄢˇ ㄇㄠˋ
感受	ㄍㄢˇ ㄕㄡˋ
幹嗎	ㄍㄢˋ ㄇㄚˊ
感情	ㄍㄢˇ ㄑㄧㄥˊ
高速	ㄍㄠ ㄙㄨˋ
高速公路	ㄍㄠ ㄙㄨˋ ㄍㄨㄥ ㄌㄨˋ
告別	ㄍㄠˋ ㄅㄧㄝˊ
歌聲	ㄍㄜ ㄕㄥ
歌迷	ㄍㄜ ㄇㄧˊ
歌手	ㄍㄜ ㄕㄡˇ
各	ㄍㄜˋ
個性	ㄍㄜˋ ㄒㄧㄥˋ
個人	ㄍㄜˋ ㄖㄣˊ
各位	ㄍㄜˋ ㄨㄟˋ
各地	ㄍㄜˋ ㄉㄧˋ
各種	ㄍㄜˋ ㄓㄨㄥˇ
根本	ㄍㄣ ㄅㄣˇ
各自	ㄍㄜˋ ㄗˋ
更加	ㄍㄥˋ ㄐㄧㄚ
工程師	ㄍㄨㄥ ㄔㄥˊ ㄕ
工夫	ㄍㄨㄥ ㄈㄨ˙
工具	ㄍㄨㄥ ㄐㄩˋ
工業	ㄍㄨㄥ ㄧㄝˋ
工廠	ㄍㄨㄥ ㄔㄤˇ
工資	ㄍㄨㄥ ㄗ
公布	ㄍㄨㄥ ㄅㄨˋ
公共	ㄍㄨㄥ ㄍㄨㄥˋ
公開	ㄍㄨㄥ ㄎㄞ
公務員	ㄍㄨㄥ ㄨˋ ㄩㄢˊ
功課	ㄍㄨㄥ ㄎㄜˋ
公民	ㄍㄨㄥ ㄇㄧㄣˊ
功能	ㄍㄨㄥ ㄋㄥˊ
共同	ㄍㄨㄥˋ ㄊㄨㄥˊ
功夫	ㄍㄨㄥ ㄈㄨ˙
姑娘	ㄍㄨ ㄋㄧㄤ˙
共有	ㄍㄨㄥˋ ㄧㄡˇ
古	ㄍㄨˇ
古代	ㄍㄨˇ ㄉㄞˋ
故鄉	ㄍㄨˋ ㄒㄧㄤ
關係	ㄍㄨㄢ ㄒㄧ˙
關注	ㄍㄨㄢ ㄓㄨˋ
觀察	ㄍㄨㄢ ㄔㄚˊ
掛	ㄍㄨㄚˋ
觀看	ㄍㄨㄢ ㄎㄢˋ
觀念	ㄍㄨㄢ ㄋㄧㄢˋ
管理	ㄍㄨㄢˇ ㄌㄧˇ
觀眾	ㄍㄨㄢ ㄓㄨㄥˋ
光明	ㄍㄨㄤ ㄇㄧㄥˊ
廣播	ㄍㄨㄤˇ ㄅㄛ
管	ㄍㄨㄢˇ
光	ㄍㄨㄤ
規定	ㄍㄨㄟ ㄉㄧㄥˋ
廣大	ㄍㄨㄤˇ ㄉㄚˋ
國內	ㄍㄨㄛˊ ㄋㄟˋ
規範	ㄍㄨㄟ ㄈㄢˋ
國慶	ㄍㄨㄛˊ ㄑㄧㄥˋ
果然	ㄍㄨㄛˇ ㄖㄢˊ
果汁	ㄍㄨㄛˇ ㄓ
過程	ㄍㄨㄛˋ ㄔㄥˊ
哈哈	ㄏㄚ ㄏㄚ˙
過去	ㄍㄨㄛˋ ㄑㄩ˙
海關	ㄏㄞˇ ㄍㄨㄢ
害怕	ㄏㄞˋ ㄆㄚˋ
好好	ㄏㄠˇ ㄏㄠˇ
行	ㄒㄧㄥˊ
好奇	ㄏㄠˋ ㄑㄧˊ
合	ㄏㄜˊ
合法	ㄏㄜˊ ㄈㄚˇ
合格	ㄏㄜˊ ㄍㄜˊ
合理	ㄏㄜˊ ㄌㄧˇ
和平	ㄏㄜˊ ㄆㄧㄥˊ
紅茶	ㄏㄨㄥˊ ㄔㄚˊ
紅酒	ㄏㄨㄥˊ ㄐㄧㄡˇ
後果	ㄏㄡˋ ㄍㄨㄛˇ
後面	ㄏㄡˋ ㄇㄧㄢ˙
後年	ㄏㄡˋ ㄋㄧㄢˊ
互聯網	ㄏㄨˋ ㄌㄧㄢˊ ㄨㄤˇ
合作	ㄏㄜˊ ㄗㄨㄛˋ
划船	ㄏㄨㄚˊ ㄔㄨㄢˊ
互相	ㄏㄨˋ ㄒㄧㄤ
華人	ㄏㄨㄚˊ ㄖㄣˊ
化	ㄏㄨㄚˋ
話劇	ㄏㄨㄚˋ ㄐㄩˋ
歡樂	ㄏㄨㄢ ㄌㄜˋ
環	ㄏㄨㄢˊ
話題	ㄏㄨㄚˋ ㄊㄧˊ
環保	ㄏㄨㄢˊ ㄅㄠˇ
環境	ㄏㄨㄢˊ ㄐㄧㄥˋ
會議	ㄏㄨㄟˋ ㄧˋ
會員	ㄏㄨㄟˋ ㄩㄢˊ
火	ㄏㄨㄛˇ
活	ㄏㄨㄛˊ
機器	ㄐㄧ ㄑㄧˋ
基本	ㄐㄧ ㄅㄣˇ
積極	ㄐㄧ ㄐㄧˊ
基本上	ㄐㄧ ㄅㄣˇ ㄕㄤ˙
及時	ㄐㄧˊ ㄕˊ
基礎	ㄐㄧ ㄔㄨˇ
極了	ㄐㄧˊ ㄌㄜ˙
集中	ㄐㄧˊ ㄓㄨㄥ
集體	ㄐㄧˊ ㄊㄧˇ
計算	ㄐㄧˋ ㄙㄨㄢˋ
記錄	ㄐㄧˋ ㄌㄨˋ
記者	ㄐㄧˋ ㄓㄜˇ
紀念	ㄐㄧˋ ㄋㄧㄢˋ
技術	ㄐㄧˋ ㄕㄨˋ
繼續	ㄐㄧˋ ㄒㄩˋ
加工	ㄐㄧㄚ ㄍㄨㄥ
加強	ㄐㄧㄚ ㄑㄧㄤˊ
家具	ㄐㄧㄚ ㄐㄩ˙
加快	ㄐㄧㄚ ㄎㄨㄞˋ
家鄉	ㄐㄧㄚ ㄒㄧㄤ
紀錄	ㄐㄧˋ ㄌㄨˋ
家屬	ㄐㄧㄚ ㄕㄨˇ
價格	ㄐㄧㄚˋ ㄍㄜˊ
價錢	ㄐㄧㄚˋ ㄑㄧㄢ˙
價值	ㄐㄧㄚˋ ㄓˊ
架	ㄐㄧㄚˋ
堅持	ㄐㄧㄢ ㄔˊ
堅強	ㄐㄧㄢ ㄑㄧㄤˊ
簡單	ㄐㄧㄢˇ ㄉㄢ
簡直	ㄐㄧㄢˇ ㄓˊ
堅決	ㄐㄧㄢ ㄐㄩㄝˊ
建	ㄐㄧㄢˋ
建成	ㄐㄧㄢˋ ㄔㄥˊ
建立	ㄐㄧㄢˋ ㄌㄧˋ
建設	ㄐㄧㄢˋ ㄕㄜˋ
將近	ㄐㄧㄤ ㄐㄧㄣˋ
將來	ㄐㄧㄤ ㄌㄞˊ
交費	ㄐㄧㄠ ㄈㄟˋ
建議	ㄐㄧㄢˋ ㄧˋ
交警	ㄐㄧㄠ ㄐㄧㄥˇ
交流	ㄐㄧㄠ ㄌㄧㄡˊ
交往	ㄐㄧㄠ ㄨㄤˇ
交易	ㄐㄧㄠ ㄧˋ
教材	ㄐㄧㄠˋ ㄘㄞˊ
教練	ㄐㄧㄠˋ ㄌㄧㄢˋ
較	ㄐㄧㄠˋ
接待	ㄐㄧㄝ ㄉㄞˋ
結實	ㄐㄧㄝ ㄕ˙
接近	ㄐㄧㄝ ㄐㄧㄣˋ
結合	ㄐㄧㄝˊ ㄏㄜˊ
結婚	ㄐㄧㄝˊ ㄏㄨㄣ
叫	ㄐㄧㄠˋ
解決	ㄐㄧㄝˇ ㄐㄩㄝˊ
結束	ㄐㄧㄝˊ ㄕㄨˋ
解開	ㄐㄧㄝˇ ㄎㄞ
節約	ㄐㄧㄝˊ ㄩㄝ
金	ㄐㄧㄣ
金牌	ㄐㄧㄣ ㄆㄞˊ
盡量	ㄐㄧㄣˇ ㄌㄧㄤˋ
僅	ㄐㄧㄣˇ
僅僅	ㄐㄧㄣˇ ㄐㄧㄣˇ
緊張	ㄐㄧㄣˇ ㄓㄤ
緊	ㄐㄧㄣˇ
進步	ㄐㄧㄣˋ ㄅㄨˋ
進一步	ㄐㄧㄣˋ ㄧ ㄅㄨˋ
進展	ㄐㄧㄣˋ ㄓㄢˇ
近期	ㄐㄧㄣˋ ㄑㄧ
經濟	ㄐㄧㄥ ㄐㄧˋ
京劇	ㄐㄧㄥ ㄐㄩˋ
經驗	ㄐㄧㄥ ㄧㄢˋ
緊急	ㄐㄧㄣˇ ㄐㄧˊ
經歷	ㄐㄧㄥ ㄌㄧˋ
精神	ㄐㄧㄥ ㄕㄣ˙
精彩	ㄐㄧㄥ ㄘㄞˇ
經營	ㄐㄧㄥ ㄧㄥˊ
景色	ㄐㄧㄥˇ ㄙㄜˋ
警察	ㄐㄧㄥˇ ㄔㄚˊ
靜	ㄐㄧㄥˋ
久	ㄐㄧㄡˇ
就是	ㄐㄧㄡˋ ㄕˋ
救	ㄐㄧㄡˋ
就業	ㄐㄧㄡˋ ㄧㄝˋ
舉辦	ㄐㄩˇ ㄅㄢˋ
舊	ㄐㄧㄡˋ
具有	ㄐㄩˋ ㄧㄡˇ
劇場	ㄐㄩˋ ㄔㄤˇ
具體	ㄐㄩˋ ㄊㄧˇ
決定	ㄐㄩㄝˊ ㄉㄧㄥˋ
據說	ㄐㄩˋ ㄕㄨㄛ
決賽	ㄐㄩㄝˊ ㄙㄞˋ
絕對	ㄐㄩㄝˊ ㄉㄨㄟˋ
咖啡	ㄎㄚ ㄈㄟ
決心	ㄐㄩㄝˊ ㄒㄧㄣ
開放	ㄎㄞ ㄈㄤˋ
開發	ㄎㄞ ㄈㄚ˙
開始	ㄎㄞ ㄕˇ
開展	ㄎㄞ ㄓㄢˇ
開業	ㄎㄞ ㄧㄝˋ
看起來	ㄎㄢˋ ㄑㄧ˙ ㄌㄞ˙
看上去	ㄎㄢˋ ㄕㄤ˙ ㄑㄩ˙
考驗	ㄎㄠˇ ㄧㄢˋ
可靠	ㄎㄜˇ ㄎㄠˋ
科技	ㄎㄜ ㄐㄧˋ
客觀	ㄎㄜˋ ㄍㄨㄢ
可樂	ㄎㄜˇ ㄌㄜˋ
克服	ㄎㄜˋ ㄈㄨˊ
空	ㄎㄨㄥ
課程	ㄎㄜˋ ㄔㄥˊ
空調	ㄎㄨㄥ ㄊㄧㄠˊ
褲子	ㄎㄨˋ ㄗ˙
空兒	ㄎㄨㄥˋ ㄦ˙
快速	ㄎㄨㄞˋ ㄙㄨˋ
困	ㄎㄨㄣˋ
困難	ㄎㄨㄣˋ ㄋㄢ˙
恐怕	ㄎㄨㄥˇ ㄆㄚˋ
浪費	ㄌㄤˋ ㄈㄟˋ
老百姓	ㄌㄠˇ ㄅㄞˇ ㄒㄧㄥˋ
老闆	ㄌㄠˇ ㄅㄢˇ
老太太	ㄌㄠˇ ㄊㄞˋ ㄊㄞ˙
老頭兒	ㄌㄠˇ ㄊㄡˊ ㄦ˙
樂	ㄌㄜˋ
樂觀	ㄌㄜˋ ㄍㄨㄢ
類似	ㄌㄟˋ ㄙˋ
離婚	ㄌㄧˊ ㄏㄨㄣ
裡面	ㄌㄧˇ ㄇㄧㄢ˙
類	ㄌㄟˋ
理髮	ㄌㄧˇ ㄈㄚˋ
理論	ㄌㄧˇ ㄌㄨㄣˋ
理由	ㄌㄧˇ ㄧㄡˊ
理解	ㄌㄧˇ ㄐㄧㄝˇ
力量	ㄌㄧˋ ㄌㄧㄤ˙
力	ㄌㄧˋ
利用	ㄌㄧˋ ㄩㄥˋ
連	ㄌㄧㄢˊ
立刻	ㄌㄧˋ ㄎㄜˋ
連忙	ㄌㄧㄢˊ ㄇㄤˊ
連續劇	ㄌㄧㄢˊ ㄒㄩˋ ㄐㄩˋ
聯合國	ㄌㄧㄢˊ ㄏㄜˊ ㄍㄨㄛˊ
連續	ㄌㄧㄢˊ ㄒㄩˋ
聯繫	ㄌㄧㄢˊ ㄒㄧˋ
聯合	ㄌㄧㄢˊ ㄏㄜˊ
涼水	ㄌㄧㄤˊ ㄕㄨㄟˇ
了	ㄌㄜ˙
領	ㄌㄧㄥˇ
領導	ㄌㄧㄥˇ ㄉㄠˇ
領先	ㄌㄧㄥˇ ㄒㄧㄢ
另一方面	ㄌㄧㄥˋ ㄧ ㄈㄤ ㄇㄧㄢˋ
留學	ㄌㄧㄡˊ ㄒㄩㄝˊ
龍	ㄌㄨㄥˊ
另外	ㄌㄧㄥˋ ㄨㄞˋ
錄	ㄌㄨˋ
路線	ㄌㄨˋ ㄒㄧㄢˋ
旅館	ㄌㄩˇ ㄍㄨㄢˇ
錄音	ㄌㄨˋ ㄧㄣ
旅行社	ㄌㄩˇ ㄒㄧㄥˊ ㄕㄜˋ
綠茶	ㄌㄩˋ ㄔㄚˊ
落後	ㄌㄨㄛˋ ㄏㄡˋ
麻煩	ㄇㄚˊ ㄈㄢ˙
滿足	ㄇㄢˇ ㄗㄨˊ
亂	ㄌㄨㄢˋ
慢慢	ㄇㄢˋ ㄇㄢˋ
馬	ㄇㄚˇ
毛	ㄇㄠˊ
沒用	ㄇㄟˊ ㄩㄥˋ
毛病	ㄇㄠˊ ㄅㄧㄥ˙
每	ㄇㄟˇ
媒體	ㄇㄟˊ ㄊㄧˇ
美	ㄇㄟˇ
美麗	ㄇㄟˇ ㄌㄧˋ
美好	ㄇㄟˇ ㄏㄠˇ
美術	ㄇㄟˇ ㄕㄨˋ
美元	ㄇㄟˇ ㄩㄢˊ
米	ㄇㄧˇ
美食	ㄇㄟˇ ㄕˊ
面對	ㄇㄧㄢˋ ㄉㄨㄟˋ
迷	ㄇㄧˊ
民間	ㄇㄧㄣˊ ㄐㄧㄢ
民族	ㄇㄧㄣˊ ㄗㄨˊ
面積	ㄇㄧㄢˋ ㄐㄧ
明確	ㄇㄧㄥˊ ㄑㄩㄝˋ
命運	ㄇㄧㄥˋ ㄩㄣˋ
明顯	ㄇㄧㄥˊ ㄒㄧㄢˇ
某	ㄇㄡˇ
母親	ㄇㄨˇ ㄑㄧㄣ˙
目標	ㄇㄨˋ ㄅㄧㄠ
目前	ㄇㄨˋ ㄑㄧㄢˊ
木頭	ㄇㄨˋ ㄊㄡ˙
男子	ㄋㄢˊ ㄗˇ
南部	ㄋㄢˊ ㄅㄨˋ
奶茶	ㄋㄞˇ ㄔㄚˊ
難道	ㄋㄢˊ ㄉㄠˋ
難度	ㄋㄢˊ ㄉㄨˋ
內心	ㄋㄟˋ ㄒㄧㄣ
內	ㄋㄟˋ
內容	ㄋㄟˋ ㄖㄨㄥˊ
能不能	ㄋㄥˊ ㄅㄨˋ ㄋㄥˊ
年代	ㄋㄧㄢˊ ㄉㄞˋ
能力	ㄋㄥˊ ㄌㄧˋ
年初	ㄋㄧㄢˊ ㄔㄨ
年紀	ㄋㄧㄢˊ ㄐㄧˋ
念	ㄋㄧㄢˋ
年底	ㄋㄧㄢˊ ㄉㄧˇ
農民	ㄋㄨㄥˊ ㄇㄧㄣˊ
牛	ㄋㄧㄡˊ
農村	ㄋㄨㄥˊ ㄘㄨㄣ
農業	ㄋㄨㄥˊ ㄧㄝˋ
女子	ㄋㄩˇ ㄗˇ
暖和	ㄋㄨㄢˇ ㄏㄨㄛ˙
怕	ㄆㄚˋ
拍	ㄆㄞ
排	ㄆㄞˊ
排名	ㄆㄞˊ ㄇㄧㄥˊ
牌子	ㄆㄞˊ ㄗ˙
派	ㄆㄞˋ
判斷	ㄆㄢˋ ㄉㄨㄢˋ
配合	ㄆㄟˋ ㄏㄜ˙
跑步	ㄆㄠˇ ㄅㄨˋ
胖	ㄆㄤˋ
配	ㄆㄟˋ
批評	ㄆㄧ ㄆㄧㄥˊ
批准	ㄆㄧ ㄓㄨㄣˇ
皮	ㄆㄧˊ
啤酒	ㄆㄧˊ ㄐㄧㄡˇ
票價	ㄆㄧㄠˋ ㄐㄧㄚˋ
皮包	ㄆㄧˊ ㄅㄠ
評價	ㄆㄧㄥˊ ㄐㄧㄚˋ
蘋果	ㄆㄧㄥˊ ㄍㄨㄛˇ
破壞	ㄆㄛˋ ㄏㄨㄞˋ
普遍	ㄆㄨˇ ㄅㄧㄢˋ
普及	ㄆㄨˇ ㄐㄧˊ
期	ㄑㄧ
破	ㄆㄛˋ
齊	ㄑㄧˊ
其實	ㄑㄧˊ ㄕˊ
其次	ㄑㄧˊ ㄘˋ
氣候	ㄑㄧˋ ㄏㄡˋ
千萬	ㄑㄧㄢ ㄨㄢˋ
前後	ㄑㄧㄢˊ ㄏㄡˋ
奇怪	ㄑㄧˊ ㄍㄨㄞˋ
前進	ㄑㄧㄢˊ ㄐㄧㄣˋ
前往	ㄑㄧㄢˊ ㄨㄤˇ
前面	ㄑㄧㄢˊ ㄇㄧㄢ˙
強	ㄑㄧㄤˊ
強大	ㄑㄧㄤˊ ㄉㄚˋ
強調	ㄑㄧㄤˊ ㄉㄧㄠˋ
強烈	ㄑㄧㄤˊ ㄌㄧㄝˋ
巧	ㄑㄧㄠˇ
橋	ㄑㄧㄠˊ
親切	ㄑㄧㄣ ㄑㄧㄝˋ
親人	ㄑㄧㄣ ㄖㄣˊ
親	ㄑㄧㄣ
情感	ㄑㄧㄥˊ ㄍㄢˇ
請教	ㄑㄧㄥˇ ㄐㄧㄠˋ
情況	ㄑㄧㄥˊ ㄎㄨㄤˋ
親自	ㄑㄧㄣ ㄗˋ
球迷	ㄑㄧㄡˊ ㄇㄧˊ
取消	ㄑㄩˇ ㄒㄧㄠ
慶祝	ㄑㄧㄥˋ ㄓㄨˋ
區	ㄑㄩ
去世	ㄑㄩˋ ㄕˋ
全場	ㄑㄩㄢˊ ㄔㄤˇ
全面	ㄑㄩㄢˊ ㄇㄧㄢˋ
全球	ㄑㄩㄢˊ ㄑㄧㄡˊ
區別	ㄑㄩ ㄅㄧㄝˊ
缺少	ㄑㄩㄝ ㄕㄠˇ
缺點	ㄑㄩㄝ ㄉㄧㄢˇ
缺	ㄑㄩㄝ
確保	ㄑㄩㄝˋ ㄅㄠˇ
確定	ㄑㄩㄝˋ ㄉㄧㄥˋ
群	ㄑㄩㄣˊ
確實	ㄑㄩㄝˋ ㄕˊ
裙子	ㄑㄩㄣˊ ㄗ˙
熱烈	ㄖㄜˋ ㄌㄧㄝˋ
熱愛	ㄖㄜˋ ㄞˋ
人才	ㄖㄣˊ ㄘㄞˊ
人類	ㄖㄣˊ ㄌㄟˋ
人工	ㄖㄣˊ ㄍㄨㄥ
人民	ㄖㄣˊ ㄇㄧㄣˊ
人民幣	ㄖㄣˊ ㄇㄧㄣˊ ㄅㄧˋ
人群	ㄖㄣˊ ㄑㄩㄣˊ
人生	ㄖㄣˊ ㄕㄥ
人員	ㄖㄣˊ ㄩㄢˊ
認得	ㄖㄣˋ ㄉㄜ˙
認出	ㄖㄣˋ ㄔㄨ
認可	ㄖㄣˋ ㄎㄜˇ
任	ㄖㄣˋ
任何	ㄖㄣˋ ㄏㄜˊ
仍然	ㄖㄥˊ ㄖㄢˊ
仍	ㄖㄥˊ
任務	ㄖㄣˋ ㄨ˙
日常	ㄖˋ ㄔㄤˊ
如何	ㄖㄨˊ ㄏㄜˊ
容易	ㄖㄨㄥˊ ㄧˋ
沙發	ㄕㄚ ㄈㄚ
散步	ㄙㄢˋ ㄅㄨˋ
傷心	ㄕㄤ ㄒㄧㄣ
傷	ㄕㄤ
商業	ㄕㄤ ㄧㄝˋ
商品	ㄕㄤ ㄆㄧㄣˇ
上面	ㄕㄤˋ ㄇㄧㄢ˙
上去	ㄕㄤˋ ㄑㄩ˙
上來	ㄕㄤˋ ㄌㄞ˙
上升	ㄕㄤˋ ㄕㄥ
沙子	ㄕㄚ ㄗ˙
上衣	ㄕㄤˋ ㄧ
設計	ㄕㄜˋ ㄐㄧˋ
設備	ㄕㄜˋ ㄅㄟˋ
設立	ㄕㄜˋ ㄌㄧˋ
身份證	ㄕㄣ ㄈㄣˋ ㄓㄥˋ
社會	ㄕㄜˋ ㄏㄨㄟˋ
深刻	ㄕㄣ ㄎㄜˋ
深	ㄕㄣ
深入	ㄕㄣ ㄖㄨˋ
生產	ㄕㄥ ㄔㄢˇ
生存	ㄕㄥ ㄘㄨㄣˊ
升	ㄕㄥ
生動	ㄕㄥ ㄉㄨㄥˋ
生命	ㄕㄥ ㄇㄧㄥˋ
生意	ㄕㄥ ㄧ˙
生長	ㄕㄥ ㄓㄤˇ
生	ㄕㄥ
聲明	ㄕㄥ ㄇㄧㄥˊ
勝	ㄕㄥˋ
勝利	ㄕㄥˋ ㄌㄧˋ
石頭	ㄕˊ ㄊㄡ˙
石油	ㄕˊ ㄧㄡˊ
時	ㄕˊ
失去	ㄕ ㄑㄩˋ
時代	ㄕˊ ㄉㄞˋ
實際上	ㄕˊ ㄐㄧˋ ㄕㄤ˙
實行	ㄕˊ ㄒㄧㄥˊ
實力	ㄕˊ ㄌㄧˋ
時刻	ㄕˊ ㄎㄜˋ
實驗室	ㄕˊ ㄧㄢˋ ㄕˋ
實驗	ㄕˊ ㄧㄢˋ
食品	ㄕˊ ㄆㄧㄣˇ
始終	ㄕˇ ㄓㄨㄥ
使	ㄕˇ
世紀	ㄕˋ ㄐㄧˋ
世界	ㄕˋ ㄐㄧㄝˋ
市場	ㄕˋ ㄔㄤˇ
世界杯	ㄕˋ ㄐㄧㄝˋ ㄅㄟ
事故	ㄕˋ ㄍㄨˋ
事件	ㄕˋ ㄐㄧㄢˋ
事實	ㄕˋ ㄕˊ
事實上	ㄕˋ ㄕˊ ㄕㄤ˙
事業	ㄕˋ ㄧㄝˋ
試驗	ㄕˋ ㄧㄢˋ
試題	ㄕˋ ㄊㄧˊ
適合	ㄕˋ ㄏㄜˊ
適用	ㄕˋ ㄩㄥˋ
適應	ㄕˋ ㄧㄥˋ
收費	ㄕㄡ ㄈㄟˋ
收看	ㄕㄡ ㄎㄢˋ
室	ㄕˋ
收聽	ㄕㄡ ㄊㄧㄥ
手續	ㄕㄡˇ ㄒㄩˋ
收音機	ㄕㄡ ㄧㄣ ㄐㄧ
首都	ㄕㄡˇ ㄉㄨ
手指	ㄕㄡˇ ㄓˇ
首先	ㄕㄡˇ ㄒㄧㄢ
受傷	ㄕㄡˋ ㄕㄤ
受	ㄕㄡˋ
輸	ㄕㄨ
書架	ㄕㄨ ㄐㄧㄚˋ
熟人	ㄕㄨˊ ㄖㄣˊ
輸入	ㄕㄨ ㄖㄨˋ
屬	ㄕㄨˇ
束	ㄕㄨˋ
屬於	ㄕㄨˇ ㄩˊ
雙方	ㄕㄨㄤ ㄈㄤ
數量	ㄕㄨˋ ㄌㄧㄤˋ
思想	ㄙ ㄒㄧㄤˇ
雙	ㄕㄨㄤ
死	ㄙˇ
速度	ㄙㄨˋ ㄉㄨˋ
隨	ㄙㄨㄟˊ
所	ㄙㄨㄛˇ
颱	ㄊㄞˊ
所長	ㄙㄨㄛˇ ㄔㄤˊ
談判	ㄊㄢˊ ㄆㄢˋ
談話	ㄊㄢˊ ㄏㄨㄚˋ
談	ㄊㄢˊ
湯	ㄊㄤ
糖	ㄊㄤˊ
特色	ㄊㄜˋ ㄙㄜˋ
提問	ㄊㄧˊ ㄨㄣˋ
提前	ㄊㄧˊ ㄑㄧㄢˊ
體會	ㄊㄧˇ ㄏㄨㄟˋ
體現	ㄊㄧˇ ㄒㄧㄢˋ
題目	ㄊㄧˊ ㄇㄨˋ
體驗	ㄊㄧˇ ㄧㄢˋ
天空	ㄊㄧㄢ ㄎㄨㄥ
甜	ㄊㄧㄢˊ
跳	ㄊㄧㄠˋ
跳高	ㄊㄧㄠˋ ㄍㄠ
跳遠	ㄊㄧㄠˋ ㄩㄢˇ
調整	ㄊㄧㄠˊ ㄓㄥˇ
鐵	ㄊㄧㄝˇ
跳舞	ㄊㄧㄠˋ ㄨˇ
聽眾	ㄊㄧㄥ ㄓㄨㄥˋ
聽力	ㄊㄧㄥ ㄌㄧˋ
通常	ㄊㄨㄥ ㄔㄤˊ
通信	ㄊㄨㄥ ㄒㄧㄣˋ
鐵路	ㄊㄧㄝˇ ㄌㄨˋ
停止	ㄊㄧㄥˊ ㄓˇ
同意	ㄊㄨㄥˊ ㄧˋ
痛苦	ㄊㄨㄥˋ ㄎㄨˇ
痛	ㄊㄨㄥˋ
頭	ㄊㄡˊ
頭腦	ㄊㄡˊ ㄋㄠˇ
突出	ㄊㄨ ㄔㄨ
圖	ㄊㄨˊ
突然	ㄊㄨ ㄖㄢˊ
圖畫	ㄊㄨˊ ㄏㄨㄚˋ
土	ㄊㄨˇ
團	ㄊㄨㄢˊ
團結	ㄊㄨㄢˊ ㄐㄧㄝˊ
團體	ㄊㄨㄢˊ ㄊㄧˇ
推動	ㄊㄨㄟ ㄉㄨㄥˋ
推廣	ㄊㄨㄟ ㄍㄨㄤˇ
推進	ㄊㄨㄟ ㄐㄧㄣˋ
推開	ㄊㄨㄟ ㄎㄞ
退	ㄊㄨㄟˋ
退出	ㄊㄨㄟˋ ㄔㄨ
退休	ㄊㄨㄟˋ ㄒㄧㄡ
外交	ㄨㄞˋ ㄐㄧㄠ
外文	ㄨㄞˋ ㄨㄣˊ
完美	ㄨㄢˊ ㄇㄟˇ
外面	ㄨㄞˋ ㄇㄧㄢ˙
完整	ㄨㄢˊ ㄓㄥˇ
完善	ㄨㄢˊ ㄕㄢˋ
玩具	ㄨㄢˊ ㄐㄩˋ
往往	ㄨㄤˇ ㄨㄤˇ
危險	ㄨㄟ ㄒㄧㄢˇ
危害	ㄨㄟ ㄏㄞˋ
為	ㄨㄟˋ
偉大	ㄨㄟˇ ㄉㄚˋ
衛生間	ㄨㄟˋ ㄕㄥ ㄐㄧㄢ
衛生	ㄨㄟˋ ㄕㄥ
為了	ㄨㄟˋ ㄌㄜ˙
溫暖	ㄨㄣ ㄋㄨㄢˇ
圍	ㄨㄟˊ
文化	ㄨㄣˊ ㄏㄨㄚˋ
文明	ㄨㄣˊ ㄇㄧㄥˊ
文件	ㄨㄣˊ ㄐㄧㄢˋ
文章	ㄨㄣˊ ㄓㄤ
文學	ㄨㄣˊ ㄒㄩㄝˊ
握手	ㄨㄛˋ ㄕㄡˇ
屋子	ㄨ ㄗ˙
武器	ㄨˇ ㄑㄧˋ
武術	ㄨˇ ㄕㄨˋ
文字	ㄨㄣˊ ㄗˋ
西部	ㄒㄧ ㄅㄨˋ
舞臺	ㄨˇ ㄊㄞˊ
下來	ㄒㄧㄚˋ ㄌㄞ˙
系	ㄒㄧˋ
希望	ㄒㄧ ㄨㄤˋ
下去	ㄒㄧㄚˋ ㄑㄩ˙
顯然	ㄒㄧㄢˇ ㄖㄢˊ
先進	ㄒㄧㄢ ㄐㄧㄣˋ
顯得	ㄒㄧㄢˇ ㄉㄜ˙
下面	ㄒㄧㄚˋ ㄇㄧㄢ˙
顯示	ㄒㄧㄢˇ ㄕˋ
現場	ㄒㄧㄢˋ ㄔㄤˇ
現代	ㄒㄧㄢˋ ㄉㄞˋ
現金	ㄒㄧㄢˋ ㄐㄧㄣ
現實	ㄒㄧㄢˋ ㄕˊ
線	ㄒㄧㄢˋ
相當	ㄒㄧㄤ ㄉㄤ
相比	ㄒㄧㄤ ㄅㄧˇ
現象	ㄒㄧㄢˋ ㄒㄧㄤˋ
相互	ㄒㄧㄤ ㄏㄨˋ
相關	ㄒㄧㄤ ㄍㄨㄢ
相似	ㄒㄧㄤ ㄙˋ
香	ㄒㄧㄤ
香蕉	ㄒㄧㄤ ㄐㄧㄠ
消費	ㄒㄧㄠ ㄈㄟˋ
消失	ㄒㄧㄠ ㄕ
消息	ㄒㄧㄠ ㄒㄧ˙
寫作	ㄒㄧㄝˇ ㄗㄨㄛˋ
血	ㄒㄩㄝˋ
效果	ㄒㄧㄠˋ ㄍㄨㄛˇ
心	ㄒㄧㄣ
信封	ㄒㄧㄣˋ ㄈㄥ
行李	ㄒㄧㄥˊ ㄌㄧ˙
信任	ㄒㄧㄣˋ ㄖㄣˋ
形成	ㄒㄧㄥˊ ㄔㄥˊ
形式	ㄒㄧㄥˊ ㄕˋ
形象	ㄒㄧㄥˊ ㄒㄧㄤˋ
形狀	ㄒㄧㄥˊ ㄓㄨㄤˋ
幸福	ㄒㄧㄥˋ ㄈㄨˊ
幸運	ㄒㄧㄥˋ ㄩㄣˋ
信	ㄒㄧㄣˋ
性	ㄒㄧㄥˋ
性別	ㄒㄧㄥˋ ㄅㄧㄝˊ
性格	ㄒㄧㄥˋ ㄍㄜˊ
修	ㄒㄧㄡ
修改	ㄒㄧㄡ ㄍㄞˇ
需求	ㄒㄩ ㄑㄧㄡˊ
需要	ㄒㄩ ㄧㄠˋ
宣布	ㄒㄩㄢ ㄅㄨˋ
宣傳	ㄒㄩㄢ ㄔㄨㄢˊ
訓練	ㄒㄩㄣˋ ㄌㄧㄢˋ
選手	ㄒㄩㄢˇ ㄕㄡˇ
學費	ㄒㄩㄝˊ ㄈㄟˋ
壓	ㄧㄚ
壓力	ㄧㄚ ㄌㄧˋ
煙	ㄧㄢ
演	ㄧㄢˇ
眼前	ㄧㄢˇ ㄑㄧㄢˊ
演唱	ㄧㄢˇ ㄔㄤˋ
演唱會	ㄧㄢˇ ㄔㄤˋ ㄏㄨㄟˋ
演員	ㄧㄢˇ ㄩㄢˊ
演出	ㄧㄢˇ ㄔㄨ
羊	ㄧㄤˊ
陽光	ㄧㄤˊ ㄍㄨㄤ
要是	ㄧㄠˋ ㄕ˙
一切	ㄧ ㄑㄧㄝˋ
衣架	ㄧ ㄐㄧㄚˋ
以來	ㄧˇ ㄌㄞˊ
已	ㄧˇ
一方面	ㄧ ㄈㄤ ㄇㄧㄢˋ
藝術	ㄧˋ ㄕㄨˋ
意義	ㄧˋ ㄧˋ
意外	ㄧˋ ㄨㄞˋ
因此	ㄧㄣ ㄘˇ
銀牌	ㄧㄣˊ ㄆㄞˊ
印象	ㄧㄣˋ ㄒㄧㄤˋ
應當	ㄧㄥ ㄉㄤ
銀	ㄧㄣˊ
迎接	ㄧㄥˊ ㄐㄧㄝ
營養	ㄧㄥˊ ㄧㄤˇ
影視	ㄧㄥˇ ㄕˋ
贏	ㄧㄥˊ
應用	ㄧㄥˋ ㄩㄥˋ
優點	ㄧㄡ ㄉㄧㄢˇ
由	ㄧㄡˊ
優勢	ㄧㄡ ㄕˋ
郵件	ㄧㄡˊ ㄐㄧㄢˋ
郵票	ㄧㄡˊ ㄆㄧㄠˋ
由於	ㄧㄡˊ ㄩˊ
郵箱	ㄧㄡˊ ㄒㄧㄤ
遊戲	ㄧㄡˊ ㄒㄧˋ
游	ㄧㄡˊ
游泳	ㄧㄡˊ ㄩㄥˇ
有的是	ㄧㄡˇ ㄉㄜ˙ ㄕˋ
有利	ㄧㄡˇ ㄌㄧˋ
有效	ㄧㄡˇ ㄒㄧㄠˋ
預報	ㄩˋ ㄅㄠˋ
預防	ㄩˋ ㄈㄤˊ
預計	ㄩˋ ㄐㄧˋ
員	ㄩㄢˊ
員工	ㄩㄢˊ ㄍㄨㄥ
願望	ㄩㄢˋ ㄨㄤˋ
約	ㄩㄝ
預習	ㄩˋ ㄒㄧˊ
樂隊	ㄩㄝˋ ㄉㄨㄟˋ
運輸	ㄩㄣˋ ㄕㄨ
雜誌	ㄗㄚˊ ㄓˋ
早已	ㄗㄠˇ ㄧˇ
造成	ㄗㄠˋ ㄔㄥˊ
責任	ㄗㄜˊ ㄖㄣˋ
增加	ㄗㄥ ㄐㄧㄚ
造	ㄗㄠˋ
增長	ㄗㄥ ㄓㄤˇ
張	ㄓㄤ
展開	ㄓㄢˇ ㄎㄞ
者	ㄓㄜˇ
真實	ㄓㄣ ㄕˊ
爭取	ㄓㄥ ㄑㄩˇ
爭	ㄓㄥ
照	ㄓㄠˋ
整	ㄓㄥˇ
整理	ㄓㄥˇ ㄌㄧˇ
整個	ㄓㄥˇ ㄍㄜˋ
整齊	ㄓㄥˇ ㄑㄧˊ
整天	ㄓㄥˇ ㄊㄧㄢ
整整	ㄓㄥˇ ㄓㄥˇ
整體	ㄓㄥˇ ㄊㄧˇ
正式	ㄓㄥˋ ㄕˋ
正	ㄓㄥˋ
證	ㄓㄥˋ
證據	ㄓㄥˋ ㄐㄩˋ
證件	ㄓㄥˋ ㄐㄧㄢˋ
支	ㄓ
支持	ㄓ ㄔˊ
支付	ㄓ ㄈㄨˋ
證明	ㄓㄥˋ ㄇㄧㄥˊ
只	ㄓˇ
直播	ㄓˊ ㄅㄛ
直	ㄓˊ
直到	ㄓˊ ㄉㄠˋ
值得	ㄓˊ ㄉㄜ˙
值	ㄓˊ
職工	ㄓˊ ㄍㄨㄥ
職業	ㄓˊ ㄧㄝˋ
只好	ㄓˇ ㄏㄠˇ
只有	ㄓˇ ㄧㄡˇ
只是	ㄓˇ ㄕˋ
指	ㄓˇ
指導	ㄓˇ ㄉㄠˇ
指出	ㄓˇ ㄔㄨ
至少	ㄓˋ ㄕㄠˇ
至今	ㄓˋ ㄐㄧㄣ
志願者	ㄓˋ ㄩㄢˋ ㄓㄜˇ
制度	ㄓˋ ㄉㄨˋ
制定	ㄓˋ ㄉㄧㄥˋ
製作	ㄓˋ ㄗㄨㄛˋ
志願	ㄓˋ ㄩㄢˋ
製造	ㄓˋ ㄗㄠˋ
中部	ㄓㄨㄥ ㄅㄨˋ
中華民族	ㄓㄨㄥ ㄏㄨㄚˊ ㄇㄧㄣˊ ㄗㄨˊ
鐘	ㄓㄨㄥ
終於	ㄓㄨㄥ ㄩˊ
種	ㄓㄨㄥˇ
種子	ㄓㄨㄥˇ ㄗ˙
週圍	ㄓㄡ ㄨㄟˊ
重大	ㄓㄨㄥˋ ㄉㄚˋ
豬	ㄓㄨ
主持	ㄓㄨˇ ㄔˊ
主動	ㄓㄨˇ ㄉㄨㄥˋ
主張	ㄓㄨˇ ㄓㄤ
主意	ㄓㄨˇ ㄧ˙
主任	ㄓㄨˇ ㄖㄣˋ
抓	ㄓㄨㄚ
祝	ㄓㄨˋ
注意	ㄓㄨˋ ㄧˋ
專家	ㄓㄨㄢ ㄐㄧㄚ
專門	ㄓㄨㄢ ㄇㄣˊ
抓住	ㄓㄨㄚ ㄓㄨˋ
專題	ㄓㄨㄢ ㄊㄧˊ
專業	ㄓㄨㄢ ㄧㄝˋ
轉	ㄓㄨㄢˇ
轉變	ㄓㄨㄢˇ ㄅㄧㄢˋ
狀況	ㄓㄨㄤˋ ㄎㄨㄤˋ
狀態	ㄓㄨㄤˋ ㄊㄞˋ
準	ㄓㄨㄣˇ
資格	ㄗ ㄍㄜ˙
追	ㄓㄨㄟ
資金	ㄗ ㄐㄧㄣ
自從	ㄗˋ ㄘㄨㄥˊ
子女	ㄗˇ ㄋㄩˇ
自動	ㄗˋ ㄉㄨㄥˋ
自然	ㄗˋ ㄖㄢ˙
自覺	ㄗˋ ㄐㄩㄝˊ
自身	ㄗˋ ㄕㄣ
縂	ㄗㄨㄥˇ
自主	ㄗˋ ㄓㄨˇ
足夠	ㄗㄨˊ ㄍㄡˋ
總是	ㄗㄨㄥˇ ㄕˋ
組合	ㄗㄨˇ ㄏㄜˊ
足球	ㄗㄨˊ ㄑㄧㄡˊ
作品	ㄗㄨㄛˋ ㄆㄧㄣˇ
左右	ㄗㄨㄛˇ ㄧㄡˋ
總結	ㄗㄨㄥˇ ㄐㄧㄝˊ
做客	ㄗㄨㄛˋ ㄎㄜˋ
作者	ㄗㄨㄛˋ ㄓㄜˇ
