阿拉伯語	ㄚ ㄌㄚ ㄅㄛˊ ㄩˇ
哎	ㄞ
哀求	ㄞ ㄑㄧㄡˊ
哎呀	ㄞ ㄧㄚ
挨家挨戶	ㄞ ㄐㄧㄚ-ㄞ ㄏㄨˋ
艾滋病	ㄞˋ ㄗ ㄅㄧㄥˋ
癌	ㄞˊ
癌癥	ㄞˊ ㄓㄥˋ
愛不釋手	ㄞˋ ㄅㄨˋ ㄕˋ ㄕㄡˇ
唉	ㄞ
愛理不理	ㄞˋ ㄌㄧˇ ㄅㄨˋ ㄌㄧˇ
愛面子	ㄞˋ ㄇㄧㄢˋ ㄗ˙
愛惜	ㄞˋ ㄒㄧ
礙事	ㄞˋ ㄕˋ
安定	ㄢ ㄉㄧㄥˋ
安眠藥	ㄢ ㄇㄧㄢˊ ㄧㄠˋ
安撫	ㄢ ㄈㄨˇ
安穩	ㄢ ㄨㄣˇ
安寧	ㄢ ㄋㄧㄥˊ
按鍵	ㄢˋ ㄐㄧㄢˋ
按理說	ㄢˋ ㄌㄧˇ ㄕㄨㄛ
安逸	ㄢ ㄧˋ
安心	ㄢ ㄒㄧㄣ
案件	ㄢˋ ㄐㄧㄢˋ
暗地裡	ㄢˋ ㄉㄧˋ ㄌㄧ˙
暗中	ㄢˋ ㄓㄨㄥ
按說	ㄢˋ ㄕㄨㄛ
凹	ㄠ
昂貴	ㄤˊ ㄍㄨㄟˋ
熬	ㄠˊ
傲	ㄠˋ
暗殺	ㄢˋ ㄕㄚ
熬夜	ㄠˊ ㄧㄝˋ
奧祕	ㄠˋ ㄇㄧˋ
傲慢	ㄠˋ ㄇㄢˋ
八卦	ㄅㄚ ㄍㄨㄚˋ
巴不得	ㄅㄚ ㄅㄨ˙ ㄉㄜ˙
奧運會	ㄠˋ ㄩㄣˋ ㄏㄨㄟˋ
扒	ㄅㄚ
芭蕾	ㄅㄚ ㄌㄟˇ
把柄	ㄅㄚˇ ㄅㄧㄥˇ
把關	ㄅㄚˇ ㄍㄨㄢ
把手	ㄅㄚˇ ㄕㄡ˙
罷免	ㄅㄚˋ ㄇㄧㄢˇ
靶子	ㄅㄚˇ ㄗ˙
壩	ㄅㄚˋ
罷休	ㄅㄚˋ ㄒㄧㄡ
掰	ㄅㄞ
白白	ㄅㄞˊ ㄅㄞˊ
霸占	ㄅㄚˋ ㄓㄢˋ
百分比	ㄅㄞˇ ㄈㄣ ㄅㄧˇ
百科全書	ㄅㄞˇ ㄎㄜ ㄑㄩㄢˊ ㄕㄨ
柏樹	ㄅㄞˇ ㄕㄨˋ
百合	ㄅㄞˇ ㄏㄜˊ
擺放	ㄅㄞˇ ㄈㄤˋ
擺設	ㄅㄞˇ ㄕㄜ˙
擺平	ㄅㄞˇ ㄆㄧㄥˊ
拜會	ㄅㄞˋ ㄏㄨㄟˋ
拜年	ㄅㄞˋ ㄋㄧㄢˊ
拜託	ㄅㄞˋ ㄊㄨㄛ
扳	ㄅㄢ
拜見	ㄅㄞˋ ㄐㄧㄢˋ
頒發	ㄅㄢ ㄈㄚ
頒獎	ㄅㄢ ㄐㄧㄤˇ
頒布	ㄅㄢ ㄅㄨˋ
斑點	ㄅㄢ ㄉㄧㄢˇ
搬遷	ㄅㄢ ㄑㄧㄢ
辦不到	ㄅㄢˋ ㄅㄨ˙ ㄉㄠˋ
半邊天	ㄅㄢˋ ㄅㄧㄢ ㄊㄧㄢ
板塊	ㄅㄢˇ ㄎㄨㄞˋ
半場	ㄅㄢˋ ㄔㄤˇ
半島	ㄅㄢˋ ㄉㄠˇ
半路	ㄅㄢˋ ㄌㄨˋ
半數	ㄅㄢˋ ㄕㄨˋ
半途而廢	ㄅㄢˋ ㄊㄨˊ ㄦˊ ㄈㄟˋ
半信半疑	ㄅㄢˋ ㄒㄧㄣˋ-ㄅㄢˋ ㄧˊ
半真半假	ㄅㄢˋ ㄓㄣ-ㄅㄢˋ ㄐㄧㄚˇ
伴	ㄅㄢˋ
扮	ㄅㄢˋ
伴侶	ㄅㄢˋ ㄌㄩˇ
伴隨	ㄅㄢˋ ㄙㄨㄟˊ
伴奏	ㄅㄢˋ ㄗㄡˋ
幫手	ㄅㄤ ㄕㄡ˙
綁	ㄅㄤˇ
拌	ㄅㄢˋ
綁架	ㄅㄤˇ ㄐㄧㄚˋ
榜樣	ㄅㄤˇ ㄧㄤˋ
包袱	ㄅㄠ ㄈㄨ˙
棒球	ㄅㄤˋ ㄑㄧㄡˊ
磅	ㄅㄤˋ
包容	ㄅㄠ ㄖㄨㄥˊ
包扎	ㄅㄠ ㄗㄚ
剝	ㄅㄛ
煲	ㄅㄠ
飽和	ㄅㄠˇ ㄏㄜˊ
飽滿	ㄅㄠˇ ㄇㄢˇ
寶藏	ㄅㄠˇ ㄗㄤˋ
保管	ㄅㄠˇ ㄍㄨㄢˇ
保姆	ㄅㄠˇ ㄇㄨˇ
寶庫	ㄅㄠˇ ㄎㄨˋ
保暖	ㄅㄠˇ ㄋㄨㄢˇ
保鮮	ㄅㄠˇ ㄒㄧㄢ
保修	ㄅㄠˇ ㄒㄧㄡ
保佑	ㄅㄠˇ ㄧㄡˋ
保障	ㄅㄠˇ ㄓㄤˋ
保質期	ㄅㄠˇ ㄓˋ ㄑㄧ
保重	ㄅㄠˇ ㄓㄨㄥˋ
報	ㄅㄠˋ
堡壘	ㄅㄠˇ ㄌㄟˇ
報仇	ㄅㄠˋ ㄔㄡˊ
報酬	ㄅㄠˋ ㄔㄡ˙
報廢	ㄅㄠˋ ㄈㄟˋ
報社	ㄅㄠˋ ㄕㄜˋ
報亭	ㄅㄠˋ ㄊㄧㄥˊ
報復	ㄅㄠˋ ㄈㄨ˙
報銷	ㄅㄠˋ ㄒㄧㄠ
抱負	ㄅㄠˋ ㄈㄨˋ
豹	ㄅㄠˋ
暴風驟雨	ㄅㄠˋ ㄈㄥ-ㄓㄡˋ ㄩˇ
暴利	ㄅㄠˋ ㄌㄧˋ
暴躁	ㄅㄠˋ ㄗㄠˋ
曝光	ㄅㄠˋ ㄍㄨㄤ
爆冷門	ㄅㄠˋ ㄌㄥˇ ㄇㄣˊ
爆竹	ㄅㄠˋ ㄓㄨˊ
悲哀	ㄅㄟ ㄞ
爆滿	ㄅㄠˋ ㄇㄢˇ
悲觀	ㄅㄟ ㄍㄨㄢ
悲歡離合	ㄅㄟ ㄏㄨㄢ-ㄌㄧˊ ㄏㄜˊ
卑鄙	ㄅㄟ ㄅㄧˇ
悲痛	ㄅㄟ ㄊㄨㄥˋ
碑	ㄅㄟ
貝殼	ㄅㄟˋ ㄎㄜˊ
備課	ㄅㄟˋ ㄎㄜˋ
備受	ㄅㄟˋ ㄕㄡˋ
背面	ㄅㄟˋ ㄇㄧㄢˋ
備用	ㄅㄟˋ ㄩㄥˋ
背誦	ㄅㄟˋ ㄙㄨㄥˋ
背叛	ㄅㄟˋ ㄆㄢˋ
被捕	ㄅㄟˋ ㄅㄨˇ
奔赴	ㄅㄣ ㄈㄨˋ
奔波	ㄅㄣ ㄅㄛ
本分	ㄅㄣˇ ㄈㄣˋ
本能	ㄅㄣˇ ㄋㄥˊ
本錢	ㄅㄣˇ ㄑㄧㄢˊ
本性	ㄅㄣˇ ㄒㄧㄥˋ
本著	ㄅㄣˇ ㄓㄜ˙
本意	ㄅㄣˇ ㄧˋ
奔	ㄅㄣ
笨蛋	ㄅㄣˋ ㄉㄢˋ
笨重	ㄅㄣˋ ㄓㄨㄥˋ
崩潰	ㄅㄥ ㄎㄨㄟˋ
繃帶	ㄅㄥ ㄉㄞˋ
繃	ㄅㄥˇ
本色	ㄅㄣˇ ㄙㄜˋ
逼近	ㄅㄧ ㄐㄧㄣˋ
蹦	ㄅㄥˋ
逼迫	ㄅㄧ ㄆㄛˋ
比比皆是	ㄅㄧˇ ㄅㄧˇ-ㄐㄧㄝ ㄕˋ
逼真	ㄅㄧ ㄓㄣ
鼻涕	ㄅㄧˊ ㄊㄧˋ
比不上	ㄅㄧˇ ㄅㄨˋ ㄕㄤˋ
比起	ㄅㄧˇ ㄑㄧˇ
比試	ㄅㄧˇ ㄕ˙
比喻	ㄅㄧˇ ㄩˋ
鄙視	ㄅㄧˇ ㄕˋ
必不可少	ㄅㄧˋ ㄅㄨˋ ㄎㄜˇ ㄕㄠˇ
必定	ㄅㄧˋ ㄉㄧㄥˋ
碧綠	ㄅㄧˋ ㄌㄩˋ
弊病	ㄅㄧˋ ㄅㄧㄥˋ
弊端	ㄅㄧˋ ㄉㄨㄢ
避難	ㄅㄧˋ ㄋㄢˋ
壁畫	ㄅㄧˋ ㄏㄨㄚˋ
避暑	ㄅㄧˋ ㄕㄨˇ
邊界	ㄅㄧㄢ ㄐㄧㄝˋ
邊疆	ㄅㄧㄢ ㄐㄧㄤ
邊遠	ㄅㄧㄢ ㄩㄢˇ
編劇	ㄅㄧㄢ ㄐㄩˋ
編號	ㄅㄧㄢ ㄏㄠˋ
編寫	ㄅㄧㄢ ㄒㄧㄝˇ
編造	ㄅㄧㄢ ㄗㄠˋ
編排	ㄅㄧㄢ ㄆㄞˊ
鞭策	ㄅㄧㄢ ㄘㄜˋ
鞭炮	ㄅㄧㄢ ㄆㄠˋ
變革	ㄅㄧㄢˋ ㄍㄜˊ
貶值	ㄅㄧㄢˇ ㄓˊ
變遷	ㄅㄧㄢˋ ㄑㄧㄢ
變異	ㄅㄧㄢˋ ㄧˋ
變幻莫測	ㄅㄧㄢˋ ㄏㄨㄢˋ ㄇㄛˋ ㄘㄜˋ
便道	ㄅㄧㄢˋ ㄉㄠˋ
變質	ㄅㄧㄢˋ ㄓˋ
便飯	ㄅㄧㄢˋ ㄈㄢˋ
便利店	ㄅㄧㄢˋ ㄌㄧˋ ㄉㄧㄢˋ
便捷	ㄅㄧㄢˋ ㄐㄧㄝˊ
辨別	ㄅㄧㄢˋ ㄅㄧㄝˊ
遍布	ㄅㄧㄢˋ ㄅㄨˋ
辨認	ㄅㄧㄢˋ ㄖㄣˋ
辯	ㄅㄧㄢˋ
辯護	ㄅㄧㄢˋ ㄏㄨˋ
辮子	ㄅㄧㄢˋ ㄗ˙
辯解	ㄅㄧㄢˋ ㄐㄧㄝˇ
標榜	ㄅㄧㄠ ㄅㄤˇ
標	ㄅㄧㄠ
標本	ㄅㄧㄠ ㄅㄣˇ
標簽	ㄅㄧㄠ ㄑㄧㄢ
標示	ㄅㄧㄠ ㄕˋ
標語	ㄅㄧㄠ ㄩˇ
飆升	ㄅㄧㄠ ㄕㄥ
標致	ㄅㄧㄠ ㄓ˙
表白	ㄅㄧㄠˇ ㄅㄞˊ
表決	ㄅㄧㄠˇ ㄐㄩㄝˊ
表述	ㄅㄧㄠˇ ㄕㄨˋ
表率	ㄅㄧㄠˇ ㄕㄨㄞˋ
表彰	ㄅㄧㄠˇ ㄓㄤ
憋	ㄅㄧㄝ
別具匠心	ㄅㄧㄝˊ ㄐㄩˋ-ㄐㄧㄤˋ ㄒㄧㄣ
別看	ㄅㄧㄝˊ ㄎㄢˋ
表態	ㄅㄧㄠˇ ㄊㄞˋ
別墅	ㄅㄧㄝˊ ㄕㄨˋ
別說	ㄅㄧㄝˊ ㄕㄨㄛ
別提了	ㄅㄧㄝˊ ㄊㄧˊ ㄌㄜ˙
別扭	ㄅㄧㄝˋ ㄋㄧㄡ˙
別致	ㄅㄧㄝˊ ㄓˋ
彬彬有禮	ㄅㄧㄣ ㄅㄧㄣ-ㄧㄡˇ ㄌㄧˇ
繽紛	ㄅㄧㄣ ㄈㄣ
冰棍兒	ㄅㄧㄥ ㄍㄨㄣˋ ㄦ˙
濱海	ㄅㄧㄣ ㄏㄞˇ
丙	ㄅㄧㄥˇ
秉承	ㄅㄧㄥˇ ㄔㄥˊ
冰山	ㄅㄧㄥ ㄕㄢ
併購	ㄅㄧㄥˋ ㄍㄡˋ
並列	ㄅㄧㄥˋ ㄌㄧㄝˋ
並非	ㄅㄧㄥˋ ㄈㄟ
病床	ㄅㄧㄥˋ ㄔㄨㄤˊ
並行	ㄅㄧㄥˋ ㄒㄧㄥˊ
撥	ㄅㄛ
病癥	ㄅㄧㄥˋ ㄓㄥˋ
撥款	ㄅㄛ ㄎㄨㄢˇ
波及	ㄅㄛ ㄐㄧˊ
撥通	ㄅㄛ ㄊㄨㄥ
波瀾	ㄅㄛ ㄌㄢˊ
波折	ㄅㄛ ㄓㄜˊ
剝奪	ㄅㄛ ㄉㄨㄛˊ
波濤	ㄅㄛ ㄊㄠ
伯伯	ㄅㄛˊ ㄅㄛ˙
剝削	ㄅㄛ ㄒㄩㄝ
伯母	ㄅㄛˊ ㄇㄨˇ
駁回	ㄅㄛˊ ㄏㄨㄟˊ
脖子	ㄅㄛˊ ㄗ˙
伯父	ㄅㄛˊ ㄈㄨˋ
搏鬥	ㄅㄛˊ ㄉㄡˋ
不見得	ㄅㄨˋ ㄐㄧㄢˋ ㄉㄜ˙
不定	ㄅㄨˋ ㄉㄧㄥˋ
不慎	ㄅㄨˋ ㄕㄣˋ
不利於	ㄅㄨˋ ㄌㄧˋ ㄩˊ
不算	ㄅㄨˋ ㄙㄨㄢˋ
不像話	ㄅㄨˋ ㄒㄧㄤˋ ㄏㄨㄚˋ
不屑	ㄅㄨˋ ㄒㄧㄝˋ
不適	ㄅㄨˋ ㄕˋ
不亞於	ㄅㄨˋ ㄧㄚˋ ㄩˊ
不亦樂乎	ㄅㄨˋ ㄧˋ ㄌㄜˋ ㄏㄨ
不懈	ㄅㄨˋ ㄒㄧㄝˋ
不翼而飛	ㄅㄨˋ ㄧˋ ㄦˊ ㄈㄟ
不正之風	ㄅㄨˋ ㄓㄥˋ ㄓ ㄈㄥ
補給	ㄅㄨˇ ㄐㄧˇ
不用說	ㄅㄨˋ ㄩㄥˋ ㄕㄨㄛ
捕捉	ㄅㄨˇ ㄓㄨㄛ
哺育	ㄅㄨˇ ㄩˋ
不恥下問	ㄅㄨˋ ㄔˇ-ㄒㄧㄚˋ ㄨㄣˋ
不辭而別	ㄅㄨˋ ㄘˊ ㄦˊ ㄅㄧㄝˊ
補救	ㄅㄨˇ ㄐㄧㄡˋ
不得而知	ㄅㄨˋ ㄉㄜˊ ㄦˊ ㄓ
不妨	ㄅㄨˋ ㄈㄤˊ
不得已	ㄅㄨˋ ㄉㄜˊ ㄧˇ
不服氣	ㄅㄨˋ ㄈㄨˊ ㄑㄧˋ
不假思索	ㄅㄨˋ ㄐㄧㄚˇ-ㄙ ㄙㄨㄛˇ
不解	ㄅㄨˋ ㄐㄧㄝˇ
不經意	ㄅㄨˋ ㄐㄧㄥ ㄧˋ
不景氣	ㄅㄨˋ ㄐㄧㄥˇ ㄑㄧˋ
不堪	ㄅㄨˋ ㄎㄢ
不服	ㄅㄨˋ ㄈㄨˊ
不可思議	ㄅㄨˋ ㄎㄜˇ-ㄙ ㄧˋ
不可避免	ㄅㄨˋ ㄎㄜˇ ㄅㄧˋ ㄇㄧㄢˇ
不肯	ㄅㄨˋ ㄎㄣˇ
不理	ㄅㄨˋ ㄌㄧˇ
不了了之	ㄅㄨˋ ㄌㄧㄠˇ-ㄌㄧㄠˇ ㄓ
不難	ㄅㄨˋ ㄋㄢˊ
不平	ㄅㄨˋ ㄆㄧㄥˊ
不起眼	ㄅㄨˋ ㄑㄧˇ ㄧㄢˇ
不如說	ㄅㄨˋ ㄖㄨˊ ㄕㄨㄛ
不同尋常	ㄅㄨˋ ㄊㄨㄥˊ ㄒㄩㄣˊ ㄔㄤˊ
不為人知	ㄅㄨˋ ㄨㄟˊ ㄖㄣˊ ㄓ
不惜	ㄅㄨˋ ㄒㄧ
不容	ㄅㄨˋ ㄖㄨㄥˊ
不相上下	ㄅㄨˋ ㄒㄧㄤ ㄕㄤˋ ㄒㄧㄚˋ
不已	ㄅㄨˋ ㄧˇ
不宜	ㄅㄨˋ ㄧˊ
不以為然	ㄅㄨˋ ㄧˇ ㄨㄟˊ ㄖㄢˊ
不由自主	ㄅㄨˋ ㄧㄡˊ-ㄗˋ ㄓㄨˇ
不予	ㄅㄨˋ ㄩˇ
不由得	ㄅㄨˋ ㄧㄡˊ ㄉㄜ˙
不約而同	ㄅㄨˋ ㄩㄝ ㄦˊ ㄊㄨㄥˊ
不知	ㄅㄨˋ ㄓ
不知不覺	ㄅㄨˋ ㄓ-ㄅㄨˋ ㄐㄩㄝˊ
不准	ㄅㄨˋ ㄓㄨㄣˇ
布局	ㄅㄨˋ ㄐㄩˊ
步入	ㄅㄨˋ ㄖㄨˋ
步驟	ㄅㄨˋ ㄓㄡˋ
部件	ㄅㄨˋ ㄐㄧㄢˋ
步伐	ㄅㄨˋ ㄈㄚˊ
部署	ㄅㄨˋ ㄕㄨˇ
猜謎	ㄘㄞ ㄇㄧˊ
猜想	ㄘㄞ ㄒㄧㄤˇ
財經	ㄘㄞˊ ㄐㄧㄥ
財力	ㄘㄞˊ ㄌㄧˋ
財務	ㄘㄞˊ ㄨˋ
才華	ㄘㄞˊ ㄏㄨㄚˊ
財政	ㄘㄞˊ ㄓㄥˋ
裁	ㄘㄞˊ
財物	ㄘㄞˊ ㄨˋ
裁定	ㄘㄞˊ ㄉㄧㄥˋ
採	ㄘㄞˇ
裁決	ㄘㄞˊ ㄐㄩㄝˊ
採礦	ㄘㄞˇ ㄎㄨㄤˋ
彩虹	ㄘㄞˇ ㄏㄨㄥˊ
彩電	ㄘㄞˇ ㄉㄧㄢˋ
彩霞	ㄘㄞˇ ㄒㄧㄚˊ
菜市場	ㄘㄞˋ ㄕˋ ㄔㄤˇ
採集	ㄘㄞˇ ㄐㄧˊ
參見	ㄘㄢ ㄐㄧㄢˋ
參謀	ㄘㄢ ㄇㄡˊ
參軍	ㄘㄢ ㄐㄩㄣ
餐桌	ㄘㄢ ㄓㄨㄛ
參照	ㄘㄢ ㄓㄠˋ
殘留	ㄘㄢˊ ㄌㄧㄡˊ
殘缺	ㄘㄢˊ ㄑㄩㄝ
殘	ㄘㄢˊ
殘忍	ㄘㄢˊ ㄖㄣˇ
慚愧	ㄘㄢˊ ㄎㄨㄟˋ
慘痛	ㄘㄢˇ ㄊㄨㄥˋ
慘重	ㄘㄢˇ ㄓㄨㄥˋ
慘白	ㄘㄢˇ ㄅㄞˊ
蒼蠅	ㄘㄤ ㄧㄥ˙
滄桑	ㄘㄤ ㄙㄤ
艙	ㄘㄤ
燦爛	ㄘㄢˋ ㄌㄢˋ
藏品	ㄘㄤˊ ㄆㄧㄣˇ
藏匿	ㄘㄤˊ ㄋㄧˋ
藏身	ㄘㄤˊ ㄕㄣ
操心	ㄘㄠ ㄒㄧㄣ
操勞	ㄘㄠ ㄌㄠˊ
操控	ㄘㄠ ㄎㄨㄥˋ
槽	ㄘㄠˊ
草案	ㄘㄠˇ ㄢˋ
草坪	ㄘㄠˇ ㄆㄧㄥˊ
側面	ㄘㄜˋ ㄇㄧㄢˋ
側重	ㄘㄜˋ ㄓㄨㄥˋ
測算	ㄘㄜˋ ㄙㄨㄢˋ
測驗	ㄘㄜˋ ㄧㄢˋ
層出不窮	ㄘㄥˊ ㄔㄨ-ㄅㄨˋ ㄑㄩㄥˊ
蹭	ㄘㄥˋ
差錯	ㄔㄚ ㄘㄨㄛˋ
差額	ㄔㄚ ㄜˊ
插手	ㄔㄚ ㄕㄡˇ
插圖	ㄔㄚ ㄊㄨˊ
插嘴	ㄔㄚ ㄗㄨㄟˇ
茶道	ㄔㄚˊ ㄉㄠˋ
茶館兒	ㄔㄚˊ ㄍㄨㄢˇ ㄦ˙
查處	ㄔㄚˊ ㄔㄨˇ
查明	ㄔㄚˊ ㄇㄧㄥˊ
查找	ㄔㄚˊ ㄓㄠˇ
察覺	ㄔㄚˊ ㄐㄩㄝˊ
察看	ㄔㄚˊ ㄎㄢˋ
詫異	ㄔㄚˋ ㄧˋ
摻	ㄘㄢˋ
攙	ㄔㄢ
饞	ㄔㄢˊ
禪杖	ㄔㄢˊ ㄓㄤˋ
纏	ㄔㄢˊ
產	ㄔㄢˇ
產地	ㄔㄢˇ ㄉㄧˋ
產物	ㄔㄢˇ ㄨˋ
產值	ㄔㄢˇ ㄓˊ
铲	ㄔㄢˇ
鏟子	ㄔㄢˇ ㄗ˙
闡述	ㄔㄢˇ ㄕㄨˋ
顫抖	ㄔㄢˋ ㄉㄡˇ
猖狂	ㄔㄤ ㄎㄨㄤˊ
長達	ㄔㄤˊ ㄉㄚˊ
長期以來	ㄔㄤˊ ㄑㄧ ㄧˇ ㄌㄞˊ
長效	ㄔㄤˊ ㄒㄧㄠˋ
長征	ㄔㄤˊ ㄓㄥ
長足	ㄔㄤˊ ㄗㄨˊ
常理	ㄔㄤˊ ㄌㄧˇ
常人	ㄔㄤˊ ㄖㄣˊ
常態	ㄔㄤˊ ㄊㄞˋ
常溫	ㄔㄤˊ ㄨㄣ
償還	ㄔㄤˊ ㄏㄨㄢˊ
嫦娥	ㄔㄢˊ ㄍㄜˊ
廠家	ㄔㄤˇ ㄐㄧㄚ
敞開	ㄔㄤˇ ㄎㄞ
暢談	ㄔㄤˋ ㄊㄢˊ
暢銷	ㄔㄤˋ ㄒㄧㄠ
倡議	ㄔㄤˋ ㄧˋ
抄襲	ㄔㄠ ㄒㄧˊ
鈔票	ㄔㄠ ㄆㄧㄠˋ
超標	ㄔㄠ ㄅㄧㄠ
超車	ㄔㄠ ㄔㄜ
超前	ㄔㄠ ㄑㄧㄢˊ
超速	ㄔㄠ ㄙㄨˋ
朝代	ㄔㄠˊ ㄉㄞˋ
朝著	ㄔㄠˊ ㄓㄜ˙
嘲弄	ㄔㄠˊ ㄋㄨㄥˋ
嘲笑	ㄔㄠˊ ㄒㄧㄠˋ
吵嘴	ㄔㄠˇ ㄗㄨㄟˇ
車道	ㄔㄜ ㄉㄠˋ
車禍	ㄔㄜ ㄏㄨㄛˋ
車間	ㄔㄜ ㄐㄧㄢ
車速	ㄔㄜ ㄙㄨˋ
車輪	ㄔㄜ ㄌㄨㄣˊ
車位	ㄔㄜ ㄨㄟˋ
車廂	ㄔㄜ ㄒㄧㄤ
車型	ㄔㄜ ㄒㄧㄥˊ
車軸	ㄔㄜ ㄓㄡˊ
扯	ㄔㄜˇ
徹夜	ㄔㄜˋ ㄧㄝˋ
撤	ㄔㄜˋ
撤換	ㄔㄜˋ ㄏㄨㄢˋ
沉甸甸	ㄔㄣˊ ㄉㄧㄢˋ ㄉㄧㄢˋ
沉澱	ㄔㄣˊ ㄉㄧㄢˋ
沉浸	ㄔㄣˊ ㄐㄧㄣˋ
沉悶	ㄔㄣˊ ㄇㄣˋ
沉迷	ㄔㄣˊ ㄇㄧˊ
沉思	ㄔㄣˊ ㄙ
沉穩	ㄔㄣˊ ㄨㄣˇ
沉著	ㄔㄣˊ ㄓㄨㄛˊ
陳舊	ㄔㄣˊ ㄐㄧㄡˋ
陳列	ㄔㄣˊ ㄌㄧㄝˋ
陳述	ㄔㄣˊ ㄕㄨˋ
襯托	ㄔㄣˋ ㄊㄨㄛ
趁	ㄔㄣˋ
趁機	ㄔㄣˋ ㄐㄧ
趁早	ㄔㄣˋ ㄗㄠˇ
趁著	ㄔㄣˋ ㄓㄜ˙
稱呼	ㄔㄥ ㄏㄨ˙
稱作	ㄔㄥ ㄗㄨㄛˋ
成才	ㄔㄥˊ ㄘㄞˊ
成家	ㄔㄥˊ ㄐㄧㄚ
成年	ㄔㄥˊ ㄋㄧㄢˊ
成千上萬	ㄔㄥˊ ㄑㄧㄢ-ㄕㄤˋ ㄨㄢˋ
成群結隊	ㄔㄥˊ ㄑㄩㄣˊ-ㄐㄧㄝˊ ㄉㄨㄟˋ
成天	ㄔㄥˊ ㄊㄧㄢ
成問題	ㄔㄥˊ ㄨㄣˋ ㄊㄧˊ
成型	ㄔㄥˊ ㄒㄧㄥˊ
呈現	ㄔㄥˊ ㄒㄧㄢˋ
誠懇	ㄔㄥˊ ㄎㄣˇ
誠心誠意	ㄔㄥˊ ㄒㄧㄣ-ㄔㄥˊ ㄧˋ
誠意	ㄔㄥˊ ㄧˋ
誠摯	ㄔㄥˊ ㄓˋ
承包	ㄔㄥˊ ㄅㄠ
承載	ㄔㄥˊ ㄗㄞˋ
城牆	ㄔㄥˊ ㄑㄧㄤˊ
乘人之危	ㄔㄥˊ ㄖㄣˊ ㄓ ㄨㄟ
盛	ㄕㄥˋ
懲處	ㄔㄥˊ ㄔㄨˇ
懲罰	ㄔㄥˊ ㄈㄚˊ
澄清	ㄔㄥˊ ㄑㄧㄥ
橙汁	ㄔㄥˊ ㄓ
逞能	ㄔㄥˇ ㄋㄥˊ
逞強	ㄔㄥˇ ㄑㄧㄤˊ
秤	ㄔㄥˋ
吃不上	ㄔ ㄅㄨ˙ ㄕㄤˋ
吃喝玩樂	ㄔ ㄏㄜ-ㄨㄢˊ ㄌㄜˋ
吃苦	ㄔ ㄎㄨˇ
吃虧	ㄔ ㄎㄨㄟ
痴呆	ㄔ ㄉㄞ
痴迷	ㄔ ㄇㄧˊ
痴心	ㄔ ㄒㄧㄣ
池塘	ㄔˊ ㄊㄤˊ
馳名	ㄔˊ ㄇㄧㄥˊ
遲遲	ㄔˊ ㄔˊ
遲疑	ㄔˊ ㄧˊ
遲早	ㄔˊ ㄗㄠˇ
持	ㄔˊ
持久	ㄔˊ ㄐㄧㄡˇ
持之以恆	ㄔˊ ㄓ ㄧˇ ㄏㄥˊ
尺度	ㄔˇ ㄉㄨˋ
恥辱	ㄔˇ ㄖㄨˇ
恥笑	ㄔˇ ㄒㄧㄠˋ
赤字	ㄔˋ ㄗˋ
翅膀	ㄔˋ ㄅㄤˇ
衝刺	ㄔㄨㄥ ㄘˋ
衝浪	ㄔㄨㄥ ㄌㄤˋ
沖洗	ㄔㄨㄥ ㄒㄧˇ
衝撞	ㄔㄨㄥ ㄓㄨㄤˋ
充	ㄔㄨㄥ
充當	ㄔㄨㄥ ㄉㄤ
充沛	ㄔㄨㄥ ㄆㄟˋ
充實	ㄔㄨㄥ ㄕˊ
重播	ㄔㄨㄥˊ ㄅㄛ
重疊	ㄔㄨㄥˊ ㄉㄧㄝˊ
重返	ㄔㄨㄥˊ ㄈㄢˇ
重申	ㄔㄨㄥˊ ㄕㄣ
重現	ㄔㄨㄥˊ ㄒㄧㄢˋ
重合	ㄔㄨㄥˊ ㄏㄜˊ
崇高	ㄔㄨㄥˊ ㄍㄠ
崇尚	ㄔㄨㄥˊ ㄕㄤˋ
寵	ㄔㄨㄥˇ
寵愛	ㄔㄨㄥˊ ㄞˋ
抽簽	ㄔㄡ ㄑㄧㄢ
抽屜	ㄔㄡ ㄊㄧ˙
抽象	ㄔㄡ ㄒㄧㄤˋ
仇	ㄔㄡˊ
仇恨	ㄔㄡˊ ㄏㄣˋ
仇人	ㄔㄡˊ ㄖㄣˊ
稠	ㄔㄡˊ
稠密	ㄔㄡˊ ㄇㄧˋ
愁眉苦臉	ㄔㄡˊ ㄇㄟˊ-ㄎㄨˇ ㄌㄧㄢˇ
籌	ㄔㄡˊ
籌辦	ㄔㄡˊ ㄅㄢˋ
籌措	ㄔㄡˊ ㄘㄨㄛˋ
籌劃	ㄔㄡˊ ㄏㄨㄚˋ
籌碼	ㄔㄡˊ ㄇㄚˇ
籌備	ㄔㄡˊ ㄅㄟˋ
籌集	ㄔㄡˊ ㄐㄧˊ
醜惡	ㄔㄡˇ ㄜˋ
醜陋	ㄔㄡˇ ㄌㄡˋ
醜聞	ㄔㄡˇ ㄨㄣˊ
瞅	ㄔㄡˇ
出版社	ㄔㄨ ㄅㄢˇ ㄕㄜˋ
出廠	ㄔㄨ ㄔㄤˇ
出醜	ㄔㄨ ㄔㄡˇ
出道	ㄔㄨ ㄉㄠˋ
出發點	ㄔㄨ ㄈㄚ ㄉㄧㄢˇ
出風頭	ㄔㄨ ㄈㄥ ㄊㄡ˙
出境	ㄔㄨ ㄐㄧㄥˋ
出局	ㄔㄨ ㄐㄩˊ
出具	ㄔㄨ ㄐㄩˋ
出口成章	ㄔㄨ ㄎㄡˇ-ㄔㄥˊ ㄓㄤ
出賣	ㄔㄨ ㄇㄞˋ
出毛病	ㄔㄨ ㄇㄠˊ ㄅㄧㄥ˙
出難題	ㄔㄨ ㄋㄢˊ ㄊㄧˊ
出人意料	ㄔㄨ ㄖㄣˊ ㄧˋ ㄌㄧㄠˋ
出任	ㄔㄨ ㄖㄣˋ
出山	ㄔㄨ ㄕㄢ
出身	ㄔㄨ ㄕㄣ
出示	ㄔㄨ ㄕˋ
出手	ㄔㄨ ㄕㄡˇ
出頭	ㄔㄨ ㄊㄡˊ
出土	ㄔㄨ ㄊㄨˇ
出息	ㄔㄨ ㄒㄧ˙
出血	ㄔㄨ ㄒㄧㄝˇ
出演	ㄔㄨ ㄧㄢˇ
出洋相	ㄔㄨ ㄧㄤˊ ㄒㄧㄤˋ
出遊	ㄔㄨ ㄧㄡˊ
出眾	ㄔㄨ ㄓㄨㄥˋ
出主意	ㄔㄨ ㄓㄨˇ ㄧˋ
出資	ㄔㄨ ㄗ
出自	ㄔㄨ ㄗˋ
初次	ㄔㄨ ㄘˋ
出走	ㄔㄨ ㄗㄡˇ
初衷	ㄔㄨ ㄓㄨㄥ
除此之外	ㄔㄨˊ ㄘˇ ㄓ ㄨㄞˋ
除去	ㄔㄨˊ ㄑㄩˋ
除外	ㄔㄨˊ ㄨㄞˋ
處方	ㄔㄨˇ ㄈㄤ
處境	ㄔㄨˇ ㄐㄧㄥˋ
處置	ㄔㄨˇ ㄓˋ
儲備	ㄔㄨˇ ㄅㄟˋ
儲蓄	ㄔㄨˇ ㄒㄩˋ
觸動	ㄔㄨˋ ㄉㄨㄥˋ
觸犯	ㄔㄨˋ ㄈㄢˋ
觸覺	ㄔㄨˋ ㄐㄩㄝˊ
觸摸	ㄔㄨˋ ㄇㄛ
觸目驚心	ㄔㄨˋ ㄇㄨˋ-ㄐㄧㄥ ㄒㄧㄣ
揣	ㄔㄨㄞ
揣測	ㄔㄨㄞˇ ㄘㄜˋ
揣摩	ㄔㄨㄞˇ ㄇㄛˊ
踹	ㄔㄨㄞˋ
川流不息	ㄔㄨㄢ ㄌㄧㄡˊ-ㄅㄨˋ ㄒㄧ
穿過	ㄔㄨㄢ ㄍㄨㄛˋ
穿小鞋	ㄔㄨㄢ ㄒㄧㄠˇ ㄒㄧㄝˊ
穿越	ㄔㄨㄢ ㄩㄝˋ
穿著	ㄔㄨㄢ ㄓㄨㄛˊ
傳承	ㄔㄨㄢˊ ㄔㄥˊ
傳奇	ㄔㄨㄢˊ ㄑㄧˊ
傳染	ㄔㄨㄢˊ ㄖㄢˇ
傳染病	ㄔㄨㄢˊ ㄖㄢˇ ㄅㄧㄥˋ
傳人	ㄔㄨㄢˊ ㄖㄣˊ
傳授	ㄔㄨㄢˊ ㄕㄡˋ
傳聞	ㄔㄨㄢˊ ㄨㄣˊ
船舶	ㄔㄨㄢˊ ㄅㄛˊ
船槳	ㄔㄨㄢˊ ㄐㄧㄤˇ
喘	ㄔㄨㄢˇ
喘息	ㄔㄨㄢˇ ㄒㄧ
串門	ㄔㄨㄢˋ ㄇㄣˊ
創傷	ㄔㄨㄤ ㄕㄤ
床位	ㄔㄨㄤˊ ㄨㄟˋ
創	ㄔㄨㄤˋ
創始人	ㄔㄨㄤˋ ㄕˇ ㄖㄣˊ
吹了	ㄔㄨㄟ ㄌㄜ˙
吹牛	ㄔㄨㄟ ㄋㄧㄡˊ
吹捧	ㄔㄨㄟ ㄆㄥˇ
垂	ㄔㄨㄟˊ
垂頭喪氣	ㄔㄨㄟˊ ㄊㄡˊ-ㄙㄤˋ ㄑㄧˋ
捶	ㄔㄨㄟˊ
錘子	ㄔㄨㄟˊ ㄗ˙
純粹	ㄔㄨㄣˊ ㄘㄨㄟˋ
純潔	ㄔㄨㄣˊ ㄐㄧㄝˊ
純樸	ㄔㄨㄣˊ ㄆㄨˇ
醇厚	ㄔㄨㄣˊ ㄏㄡˋ
蠢	ㄔㄨㄣˇ
戳	ㄔㄨㄛ
綽號	ㄔㄨㄛˋ ㄏㄠˋ
瓷	ㄘˊ
瓷器	ㄘˊ ㄑㄧˋ
辭	ㄘˊ
辭呈	ㄘˊ ㄔㄥˊ
辭去	ㄘˊ ㄑㄩˋ
辭退	ㄘˊ ㄊㄨㄟˋ
慈善	ㄘˊ ㄕㄢˋ
慈祥	ㄘˊ ㄒㄧㄤˊ
磁帶	ㄘˊ ㄉㄞˋ
磁卡	ㄘˊ ㄎㄚˇ
磁盤	ㄘˊ ㄆㄢˊ
此起彼伏	ㄘˇ ㄑㄧˇ-ㄅㄧˇ ㄈㄨˊ
次日	ㄘˋ ㄖˋ
伺候	ㄘˋ ㄏㄡ˙
刺耳	ㄘˋ ㄦˇ
刺骨	ㄘˋ ㄍㄨˇ
刺繡	ㄘˋ ㄒㄧㄡˋ
賜	ㄘˋ
賜教	ㄘˋ ㄐㄧㄠˋ
匆匆	ㄘㄨㄥ ㄘㄨㄥ
匆忙	ㄘㄨㄥ ㄇㄤˊ
蔥	ㄘㄨㄥ
從今以後	ㄘㄨㄥˊ ㄐㄧㄣ ㄧˇ ㄏㄡˋ
從來不	ㄘㄨㄥˊ ㄌㄞˊ ㄅㄨˋ
從容	ㄘㄨㄥˊ ㄖㄨㄥˊ
從容不迫	ㄘㄨㄥˊ ㄖㄨㄥˊ-ㄅㄨˋ ㄆㄛˋ
從頭	ㄘㄨㄥˊ ㄊㄡˊ
從未	ㄘㄨㄥˊ ㄨㄟˋ
從業	ㄘㄨㄥˊ ㄧㄝˋ
從早到晚	ㄘㄨㄥˊ ㄗㄠˇ ㄉㄠˋ ㄨㄢˇ
叢林	ㄘㄨㄥˊ ㄌㄧㄣˊ
湊	ㄘㄡˋ
湊合	ㄘㄡˋ ㄏㄜ˙
湊巧	ㄘㄡˋ ㄑㄧㄠˇ
粗暴	ㄘㄨ ㄅㄠˋ
粗糙	ㄘㄨ ㄘㄠ
粗魯	ㄘㄨ ㄌㄨ˙
粗略	ㄘㄨ ㄌㄩㄝˋ
粗心大意	ㄘㄨ ㄒㄧㄣ-ㄉㄚˋ ㄧˋ
促成	ㄘㄨˋ ㄔㄥˊ
簇擁	ㄘㄨˋ ㄩㄥ
竄	ㄘㄨㄢˋ
催	ㄘㄨㄟ
催促	ㄘㄨㄟ ㄘㄨˋ
催眠	ㄘㄨㄟ ㄇㄧㄢˊ
摧毀	ㄘㄨㄟ ㄏㄨㄟˇ
脆弱	ㄘㄨㄟˋ ㄖㄨㄛˋ
翠綠	ㄘㄨㄟˋ ㄌㄩˋ
存放	ㄘㄨㄣˊ ㄈㄤˋ
存心	ㄘㄨㄣˊ ㄒㄧㄣ
存折	ㄘㄨㄣˊ ㄓㄜˊ
搓	ㄘㄨㄛ
磋商	ㄘㄨㄛ ㄕㄤ
挫折	ㄘㄨㄛˋ ㄓㄜˊ
措手不及	ㄘㄨㄛˋ ㄕㄡˇ-ㄅㄨˋ ㄐㄧˊ
錯覺	ㄘㄨㄛˋ ㄐㄩㄝˊ
錯位	ㄘㄨㄛˋ ㄨㄟˋ
錯綜複雜	ㄘㄨㄛˋ ㄗㄨㄥ-ㄈㄨˋ ㄗㄚˊ
錯別字	ㄘㄨㄛˋ ㄅㄧㄝˊ ㄗˋ
搭乘	ㄉㄚ ㄔㄥˊ
搭建	ㄉㄚ ㄐㄧㄢˋ
達標	ㄉㄚˊ ㄅㄧㄠ
答辯	ㄉㄚˊ ㄅㄧㄢˋ
打岔	ㄉㄚˇ ㄔㄚˋ
打倒	ㄉㄚˇ ㄉㄠˇ
打盹兒	ㄉㄚˇ ㄉㄨㄣˇ ㄦ˙
打交道	ㄉㄚˇ ㄐㄧㄠ ㄉㄠ˙
打攪	ㄉㄚˇ ㄐㄧㄠˇ
打撈	ㄉㄚˇ ㄌㄠ
打量	ㄉㄚˇ ㄌㄧㄤ˙
打獵	ㄉㄚˇ ㄌㄧㄝˋ
打磨	ㄉㄚˇ ㄇㄛ˙
打通	ㄉㄚˇ ㄊㄨㄥ
打仗	ㄉㄚˇ ㄓㄤˋ
打招呼	ㄉㄚˇ ㄓㄠ ㄏㄨ˙
大包大攬	ㄉㄚˋ ㄅㄠ ㄉㄚˋ ㄌㄢˇ
大筆	ㄉㄚˋ ㄅㄧˇ
大臣	ㄉㄚˋ ㄔㄣˊ
大吃一驚	ㄉㄚˋ ㄔ-ㄧ ㄐㄧㄥ
大大咧咧	ㄉㄚˋ ㄉㄚ˙-ㄌㄧㄝ ㄌㄧㄝ
大地	ㄉㄚˋ ㄉㄧˋ
大隊	ㄉㄚˋ ㄉㄨㄟˋ
大幅度	ㄉㄚˋ ㄈㄨˊ ㄉㄨˋ
大公無私	ㄉㄚˋ ㄍㄨㄥ-ㄨˊ ㄙ
大家庭	ㄉㄚˋ ㄐㄧㄚ ㄊㄧㄥˊ
大街小巷	ㄉㄚˋ ㄐㄧㄝ-ㄒㄧㄠˇ ㄒㄧㄤˋ
大驚小怪	ㄉㄚˋ ㄐㄧㄥ-ㄒㄧㄠˇ ㄍㄨㄞˋ
大局	ㄉㄚˋ ㄐㄩˊ
大款	ㄉㄚˋ ㄎㄨㄢˇ
大面積	ㄉㄚˋ ㄇㄧㄢˋ ㄐㄧ
大名鼎鼎	ㄉㄚˋ ㄇㄧㄥˊ-ㄉㄧㄥˇ ㄉㄧㄥˇ
大模大樣	ㄉㄚˋ ㄇㄨˊ-ㄉㄚˋ ㄧㄤˋ
大棚	ㄉㄚˋ ㄆㄥˊ
大片	ㄉㄚˋ ㄆㄧㄢˋ
大氣	ㄉㄚˋ ㄑㄧˋ
大廈	ㄉㄚˋ ㄕㄚˋ
大數據	ㄉㄚˋ ㄕㄨˋ ㄐㄩˋ
大肆	ㄉㄚˋ ㄙˋ
大體	ㄉㄚˋ ㄊㄧˇ
大體上	ㄉㄚˋ ㄊㄧˇ ㄕㄤˋ
大同小異	ㄉㄚˋ ㄊㄨㄥˊ-ㄒㄧㄠˇ ㄧˋ
大腕兒	ㄉㄚˋ ㄨㄢˋ ㄦ˙
大選	ㄉㄚˋ ㄒㄩㄢˇ
大雁	ㄉㄚˋ ㄧㄢˋ
大意	ㄉㄚˋ ㄧ˙
大有可為	ㄉㄚˋ ㄧㄡˇ-ㄎㄜˇ ㄨㄟˊ
大宗	ㄉㄚˋ ㄗㄨㄥ
歹徒	ㄉㄞˇ ㄊㄨˊ
逮	ㄉㄞˇ
代號	ㄉㄞˋ ㄏㄠˋ
代理人	ㄉㄞˋ ㄌㄧˇ ㄖㄣˊ
代言人	ㄉㄞˋ ㄧㄢˊ ㄖㄣˊ
帶隊	ㄉㄞˋ ㄉㄨㄟˋ
帶路	ㄉㄞˋ ㄌㄨˋ
帶頭	ㄉㄞˋ ㄊㄡˊ
帶頭人	ㄉㄞˋ ㄊㄡˊ ㄖㄣˊ
待	ㄉㄞˋ
怠工	ㄉㄞˋ ㄍㄨㄥ
怠慢	ㄉㄞˋ ㄇㄢˋ
逮捕	ㄉㄞˋ ㄅㄨˇ
擔	ㄉㄢ
擔當	ㄉㄢ ㄉㄤ
擔負	ㄉㄢ ㄈㄨˋ
單邊	ㄉㄢ ㄅㄧㄢ
單薄	ㄉㄢ ㄅㄛˊ
單方面	ㄉㄢ ㄈㄤ ㄇㄧㄢˋ
單身	ㄉㄢ ㄕㄣ
耽擱	ㄉㄢ ㄍㄜ˙
耽誤	ㄉㄢ ㄨ˙
膽怯	ㄉㄢˇ ㄑㄧㄝˋ
膽子	ㄉㄢˇ ㄗ˙
但願	ㄉㄢˋ ㄩㄢˋ
擔子	ㄉㄢˋ ㄗ˙
誕辰	ㄉㄢˋ ㄔㄣˊ
淡化	ㄉㄢˋ ㄏㄨㄚˋ
淡季	ㄉㄢˋ ㄐㄧˋ
蛋白質	ㄉㄢˋ ㄅㄞˊ ㄓˋ
當即	ㄉㄤ ㄐㄧˊ
當今	ㄉㄤ ㄐㄧㄣ
當面	ㄉㄤ ㄇㄧㄢˋ
當日	ㄉㄤ ㄖˋ
當事人	ㄉㄤ ㄕˋ ㄖㄣˊ
當務之急	ㄉㄤ ㄨˋ ㄓ ㄐㄧˊ
當下	ㄉㄤ ㄒㄧㄚˋ
當心	ㄉㄤ ㄒㄧㄣ
當著	ㄉㄤ ㄓㄜ˙
當之無愧	ㄉㄤ ㄓ-ㄨˊ ㄎㄨㄟˋ
當眾	ㄉㄤ ㄓㄨㄥˋ
當晚	ㄉㄤˋ ㄨㄢˇ
當真	ㄉㄤˋ ㄓㄣ
蕩漾	ㄉㄤˋ ㄧㄤˋ
檔次	ㄉㄤˋ ㄘˋ
導彈	ㄉㄠˇ ㄉㄢˋ
導航	ㄉㄠˇ ㄏㄤˊ
導火索	ㄉㄠˇ ㄏㄨㄛˇ ㄙㄨㄛˇ
導師	ㄉㄠˇ ㄕ
導向	ㄉㄠˇ ㄒㄧㄤˋ
島嶼	ㄉㄠˇ ㄩˇ
搗亂	ㄉㄠˇ ㄌㄨㄢˋ
倒賣	ㄉㄠˇ ㄇㄞˋ
倒霉	ㄉㄠˇ ㄇㄟˊ
倒塌	ㄉㄠˇ ㄊㄚ
倒下	ㄉㄠˇ ㄒㄧㄚˋ
到頭來	ㄉㄠˋ ㄊㄡˊ ㄌㄞˊ
到位	ㄉㄠˋ ㄨㄟˋ
倒計時	ㄉㄠˋ ㄐㄧˋ ㄕˊ
倒數	ㄉㄠˋ ㄕㄨˇ
盜	ㄉㄠˋ
盜竊	ㄉㄠˋ ㄑㄧㄝˋ
悼念	ㄉㄠˋ ㄋㄧㄢˋ
道具	ㄉㄠˋ ㄐㄩˋ
稻草	ㄉㄠˋ ㄘㄠˇ
得不償失	ㄉㄜˊ ㄅㄨˋ ㄔㄤˊ ㄕ
得當	ㄉㄜˊ ㄉㄤˋ
得力	ㄉㄜˊ ㄌㄧˋ
得失	ㄉㄜˊ ㄕ
得手	ㄉㄜˊ ㄕㄡˇ
得體	ㄉㄜˊ ㄊㄧˇ
得天獨厚	ㄉㄜˊ ㄊㄧㄢ-ㄉㄨˊ ㄏㄡˋ
得益於	ㄉㄜˊ ㄧˋ ㄩˊ
得意揚揚	ㄉㄜˊ ㄧˋ-ㄧㄤˊ ㄧㄤˊ
得知	ㄉㄜˊ ㄓ
得罪	ㄉㄜˊ ㄗㄨㄟ˙
德	ㄉㄜˊ
燈籠	ㄉㄥ ㄌㄨㄥ˙
燈泡	ㄉㄥ ㄆㄠˋ
登機	ㄉㄥ ㄐㄧ
登陸	ㄉㄥ ㄌㄨˋ
蹬	ㄉㄥ
凳子	ㄉㄥˋ ㄗ˙
瞪	ㄉㄥˋ
低調	ㄉㄧ ㄉㄧㄠˋ
低估	ㄉㄧ ㄍㄨ
低谷	ㄉㄧ ㄍㄨˇ
低價	ㄉㄧ ㄐㄧㄚˋ
低迷	ㄉㄧ ㄇㄧˊ
低碳	ㄉㄧ ㄊㄢˋ
低下	ㄉㄧ ㄒㄧㄚˋ
堤	ㄉㄧ
堤壩	ㄉㄧ ㄅㄚˋ
提防	ㄉㄧ ㄈㄤ˙
笛子	ㄉㄧˊ ㄗ˙
抵觸	ㄉㄧˇ ㄔㄨˋ
抵擋	ㄉㄧˇ ㄉㄤˇ
抵消	ㄉㄧˇ ㄒㄧㄠ
抵押	ㄉㄧˇ ㄧㄚ
抵禦	ㄉㄧˇ ㄩˋ
抵制	ㄉㄧˇ ㄓˋ
底層	ㄉㄧˇ ㄘㄥˊ
底線	ㄉㄧˇ ㄒㄧㄢˋ
底蘊	ㄉㄧˇ ㄩㄣˋ
底子	ㄉㄧˇ ㄗ˙
地步	ㄉㄧˋ ㄅㄨˋ
地道	ㄉㄧˋ ㄉㄠ˙
地段	ㄉㄧˋ ㄉㄨㄢˋ
地毯	ㄉㄧˋ ㄊㄢˇ
地理	ㄉㄧˋ ㄌㄧˇ
地下水	ㄉㄧˋ ㄒㄧㄚˋ ㄕㄨㄟˇ
地獄	ㄉㄧˋ ㄩˋ
地域	ㄉㄧˋ ㄩˋ
地質	ㄉㄧˋ ㄓˋ
弟子	ㄉㄧˋ ㄗˇ
帝國	ㄉㄧˋ ㄍㄨㄛˊ
帝國主義	ㄉㄧˋ ㄍㄨㄛˊ ㄓㄨˇ ㄧˋ
遞交	ㄉㄧˋ ㄐㄧㄠ
第一手	ㄉㄧˋ ㄧ ㄕㄡˇ
第一線	ㄉㄧˋ ㄧ ㄒㄧㄢˋ
顛倒	ㄉㄧㄢ ㄉㄠˇ
顛覆	ㄉㄧㄢ ㄈㄨˋ
巔峰	ㄉㄧㄢ ㄈㄥ
點火	ㄉㄧㄢˇ ㄏㄨㄛˇ
點擊率	ㄉㄧㄢˇ ㄐㄧ ㄌㄩˋ
典範	ㄉㄧㄢˇ ㄈㄢˋ
點評	ㄉㄧㄢˇ ㄆㄧㄥˊ
點心	ㄉㄧㄢˇ ㄒㄧㄣ˙
點綴	ㄉㄧㄢˇ ㄓㄨㄟˋ
點子	ㄉㄧㄢˇ ㄗ˙
電報	ㄉㄧㄢˋ ㄅㄠˋ
電線	ㄉㄧㄢˋ ㄒㄧㄢˋ
電網	ㄉㄧㄢˋ ㄨㄤˇ
電鈴	ㄉㄧㄢˋ ㄌㄧㄥˊ
電信	ㄉㄧㄢˋ ㄒㄧㄣˋ
電訊	ㄉㄧㄢˋ ㄒㄩㄣˋ
墊	ㄉㄧㄢˋ
墊底	ㄉㄧㄢˋ ㄉㄧˇ
墊子	ㄉㄧㄢˋ ㄗ˙
澱粉	ㄉㄧㄢˋ ㄈㄣˇ
惦記	ㄉㄧㄢˋ ㄐㄧ˙
奠定	ㄉㄧㄢˋ ㄉㄧㄥˋ
殿堂	ㄉㄧㄢˋ ㄊㄤˊ
刁難	ㄉㄧㄠ ㄋㄢˋ
叼	ㄉㄧㄠ
雕	ㄉㄧㄠ
雕刻	ㄉㄧㄠ ㄎㄜˋ
雕塑	ㄉㄧㄠ ㄙㄨˋ
吊銷	ㄉㄧㄠˋ ㄒㄧㄠ
釣魚	ㄉㄧㄠˋ ㄩˊ
調度	ㄉㄧㄠˋ ㄉㄨˋ
掉隊	ㄉㄧㄠˋ ㄉㄨㄟˋ
掉頭	ㄉㄧㄠˋ ㄊㄡˊ
爹	ㄉㄧㄝ
迭起	ㄉㄧㄝˊ ㄑㄧˇ
疊	ㄉㄧㄝˊ
丁	ㄉㄧㄥ
叮囑	ㄉㄧㄥ ㄓㄨˇ
釘子	ㄉㄧㄥ ㄗ˙
盯	ㄉㄧㄥ
頂多	ㄉㄧㄥˇ ㄉㄨㄛ
頂級	ㄉㄧㄥˇ ㄐㄧˊ
頂尖	ㄉㄧㄥˇ ㄐㄧㄢ
訂單	ㄉㄧㄥˋ ㄉㄢ
訂購	ㄉㄧㄥˋ ㄍㄡˋ
訂婚	ㄉㄧㄥˋ ㄏㄨㄣ
訂立	ㄉㄧㄥˋ ㄌㄧˋ
釘	ㄉㄧㄥ
定金	ㄉㄧㄥˋ ㄐㄧㄣ
定居	ㄉㄧㄥˋ ㄐㄩ
定論	ㄉㄧㄥˋ ㄌㄨㄣˋ
定為	ㄉㄧㄥˋ ㄨㄟˋ
定向	ㄉㄧㄥˋ ㄒㄧㄤˋ
定心丸	ㄉㄧㄥˋ ㄒㄧㄣ ㄨㄢˊ
定做	ㄉㄧㄥˋ ㄗㄨㄛˋ
丟掉	ㄉㄧㄡ ㄉㄧㄠˋ
定義	ㄉㄧㄥˋ ㄧˋ
丟臉	ㄉㄧㄡ ㄌㄧㄢˇ
丟棄	ㄉㄧㄡ ㄑㄧˋ
丟人	ㄉㄧㄡ ㄖㄣˊ
丟失	ㄉㄧㄡ ㄕ
東奔西走	ㄉㄨㄥ ㄅㄣ ㄒㄧ ㄗㄡˇ
東道主	ㄉㄨㄥ ㄉㄠˋ ㄓㄨˇ
東張西望	ㄉㄨㄥ ㄓㄤ-ㄒㄧ ㄨㄤˋ
董事	ㄉㄨㄥˇ ㄕˋ
董事會	ㄉㄨㄥˇ ㄕˋ ㄏㄨㄟˋ
董事長	ㄉㄨㄥˇ ㄕˋ ㄓㄤˇ
懂事	ㄉㄨㄥˇ ㄕˋ
動不動	ㄉㄨㄥˋ ㄅㄨ˙ ㄉㄨㄥˋ
動蕩	ㄉㄨㄥˋ ㄉㄤˋ
動感	ㄉㄨㄥˋ ㄍㄢˇ
動工	ㄉㄨㄥˋ ㄍㄨㄥ
動靜	ㄉㄨㄥˋ ㄐㄧㄥ˙
動脈	ㄉㄨㄥˋ ㄇㄞˋ
動身	ㄉㄨㄥˋ ㄕㄣ
動彈	ㄉㄨㄥˋ ㄊㄢ˙
動聽	ㄉㄨㄥˋ ㄊㄧㄥ
動向	ㄉㄨㄥˋ ㄒㄧㄤˋ
動用	ㄉㄨㄥˋ ㄩㄥˋ
凍結	ㄉㄨㄥˋ ㄐㄧㄝˊ
棟	ㄉㄨㄥˋ
棟梁	ㄉㄨㄥˋ ㄌㄧㄤˊ
兜	ㄉㄡ
兜兒	ㄉㄡ ㄦ˙
兜售	ㄉㄡ ㄕㄡˋ
陡	ㄉㄡˇ
抖	ㄉㄡˇ
鬥	ㄉㄡˋ
鬥志	ㄉㄡˋ ㄓˋ
豆漿	ㄉㄡˋ ㄐㄧㄤ
豆子	ㄉㄡˋ ㄗ˙
逗	ㄉㄡˋ
都會	ㄉㄨ ㄏㄨㄟˋ
督促	ㄉㄨ ㄘㄨˋ
獨	ㄉㄨˊ
獨唱	ㄉㄨˊ ㄔㄤˋ
獨家	ㄉㄨˊ ㄐㄧㄚ
獨立自主	ㄉㄨˊ ㄌㄧˋ-ㄗˋ ㄓㄨˇ
獨身	ㄉㄨˊ ㄕㄣ
獨一無二	ㄉㄨˊ ㄧ-ㄨˊ ㄦˋ
堵塞	ㄉㄨˇ ㄙㄜˋ
杜絕	ㄉㄨˋ ㄐㄩㄝˊ
妒忌	ㄉㄨˋ ㄐㄧˋ
度	ㄉㄨˋ
度假	ㄉㄨˋ ㄐㄧㄚˋ
渡過	ㄉㄨˋ ㄍㄨㄛˋ
端正	ㄉㄨㄢ ㄓㄥˋ
短缺	ㄉㄨㄢˇ ㄑㄩㄝ
短暫	ㄉㄨㄢˇ ㄗㄢˋ
段落	ㄉㄨㄢˋ ㄌㄨㄛˋ
斷斷續續	ㄉㄨㄢˋ ㄉㄨㄢˋ-ㄒㄩˋ ㄒㄩˋ
斷定	ㄉㄨㄢˋ ㄉㄧㄥˋ
斷裂	ㄉㄨㄢˋ ㄌㄧㄝˋ
堆砌	ㄉㄨㄟ ㄑㄧˋ
隊形	ㄉㄨㄟˋ ㄒㄧㄥˊ
對白	ㄉㄨㄟˋ ㄅㄞˊ
對策	ㄉㄨㄟˋ ㄘㄜˋ
對稱	ㄉㄨㄟˋ ㄔㄣˋ
對得起	ㄉㄨㄟˋ ㄉㄜ˙ ㄑㄧˇ
對聯	ㄉㄨㄟˋ ㄌㄧㄢˊ
對弈	ㄉㄨㄟˋ ㄧˋ
對照	ㄉㄨㄟˋ ㄓㄠˋ
對峙	ㄉㄨㄟˋ ㄓˋ
對準	ㄉㄨㄟˋ ㄓㄨㄣˇ
兌換	ㄉㄨㄟˋ ㄏㄨㄢˋ
兌現	ㄉㄨㄟˋ ㄒㄧㄢˋ
敦厚	ㄉㄨㄣ ㄏㄡˋ
敦促	ㄉㄨㄣ ㄘㄨˋ
頓時	ㄉㄨㄣˋ ㄕˊ
多邊	ㄉㄨㄛ ㄅㄧㄢ
炖	ㄉㄨㄣˋ
多功能	ㄉㄨㄛ ㄍㄨㄥ ㄋㄥˊ
多勞多得	ㄉㄨㄛ ㄌㄠˊ-ㄉㄨㄛ ㄉㄜˊ
多年來	ㄉㄨㄛ ㄋㄧㄢˊ ㄌㄞˊ
多心	ㄉㄨㄛ ㄒㄧㄣ
多虧	ㄉㄨㄛ ㄎㄨㄟ
多元	ㄉㄨㄛ ㄩㄢˊ
哆嗦	ㄉㄨㄛ ㄙㄨㄛ˙
多餘	ㄉㄨㄛ ㄩˊ
奪魁	ㄉㄨㄛˊ ㄎㄨㄟˊ
奪冠	ㄉㄨㄛˊ ㄍㄨㄢˋ
躲藏	ㄉㄨㄛˇ ㄘㄤˊ
舵手	ㄉㄨㄛˋ ㄕㄡˇ
躲避	ㄉㄨㄛˇ ㄅㄧˋ
墮落	ㄉㄨㄛˋ ㄌㄨㄛˋ
俄語	ㄜˊ ㄩˇ
訛詐	ㄜˊ ㄓㄚˋ
鵝	ㄜˊ
額外	ㄜˊ ㄨㄞˋ
惡	ㄜˋ
厄運	ㄜˋ ㄩㄣˋ
惡劣	ㄜˋ ㄌㄧㄝˋ
惡化	ㄜˋ ㄏㄨㄚˋ
惡性	ㄜˋ ㄒㄧㄥˋ
惡意	ㄜˋ ㄧˋ
遏制	ㄜˋ ㄓˋ
鱷魚	ㄜˋ ㄩˊ
恩賜	ㄣ ㄘˋ
恩惠	ㄣ ㄏㄨㄟˋ
恩情	ㄣ ㄑㄧㄥˊ
而已	ㄦˊ ㄧˇ
耳光	ㄦˇ ㄍㄨㄤ
恩怨	ㄣ ㄩㄢˋ
耳目一新	ㄦˇ ㄇㄨˋ-ㄧ ㄒㄧㄣ
耳熟能詳	ㄦˇ ㄕㄨˊ-ㄋㄥˊ ㄒㄧㄤˊ
耳聞目睹	ㄦˇ ㄨㄣˊ-ㄇㄨˋ ㄉㄨˇ
二手車	ㄦˋ ㄕㄡˇ ㄔㄜ
二氧化碳	ㄦˋ ㄧㄤˇ ㄏㄨㄚˋ ㄊㄢˋ
發佈會	ㄈㄚ ㄅㄨˋ ㄏㄨㄟˋ
發財	ㄈㄚ ㄘㄞˊ
發愁	ㄈㄚ ㄔㄡˊ
發電機	ㄈㄚ ㄉㄧㄢˋ ㄐㄧ
發抖	ㄈㄚ ㄉㄡˇ
發光	ㄈㄚ ㄍㄨㄤ
發憤圖強	ㄈㄚ ㄈㄣˋ-ㄊㄨˊ ㄑㄧㄤˊ
發酵	ㄈㄚ ㄐㄧㄠˋ
發掘	ㄈㄚ ㄐㄩㄝˊ
發火	ㄈㄚ ㄏㄨㄛˇ
發脾氣	ㄈㄚ ㄆㄧˊ ㄑㄧ˙
發起人	ㄈㄚ ㄑㄧˇ ㄖㄣˊ
發熱	ㄈㄚ ㄖㄜˋ
發誓	ㄈㄚ ㄕˋ
發愣	ㄈㄚ ㄌㄥˋ
發揚	ㄈㄚ ㄧㄤˊ
發揚光大	ㄈㄚ ㄧㄤˊ-ㄍㄨㄤ ㄉㄚˋ
發育	ㄈㄚ ㄩˋ
發源地	ㄈㄚ ㄩㄢˊ ㄉㄧˋ
發泄	ㄈㄚ ㄒㄧㄝˋ
發作	ㄈㄚ ㄗㄨㄛˋ
閥門	ㄈㄚˊ ㄇㄣˊ
髮型	ㄈㄚˋ ㄒㄧㄥˊ
帆	ㄈㄢ
帆船	ㄈㄢ ㄔㄨㄢˊ
翻番	ㄈㄢ ㄈㄢ
翻來覆去	ㄈㄢ ㄌㄞˊ-ㄈㄨˋ ㄑㄩˋ
翻天覆地	ㄈㄢ ㄊㄧㄢ-ㄈㄨˋ ㄉㄧˋ
凡	ㄈㄢˊ
煩悶	ㄈㄢˊ ㄇㄣˋ
煩惱	ㄈㄢˊ ㄋㄠˇ
煩躁	ㄈㄢˊ ㄗㄠˋ
繁華	ㄈㄢˊ ㄏㄨㄚˊ
繁忙	ㄈㄢˊ ㄇㄤˊ
繁體字	ㄈㄢˊ ㄊㄧˇ ㄗˋ
繁重	ㄈㄢˊ ㄓㄨㄥˋ
反駁	ㄈㄢˇ ㄅㄛˊ
反差	ㄈㄢˇ ㄔㄚ
反常	ㄈㄢˇ ㄔㄤˊ
反倒	ㄈㄢˇ ㄉㄠˋ
反感	ㄈㄢˇ ㄍㄢˇ
反過來	ㄈㄢˇ ㄍㄨㄛ˙ ㄌㄞ˙
反擊	ㄈㄢˇ ㄐㄧ
反饋	ㄈㄢˇ ㄎㄨㄟˋ
反面	ㄈㄢˇ ㄇㄧㄢˋ
反思	ㄈㄢˇ ㄙ
反彈	ㄈㄢˇ ㄊㄢˊ
反省	ㄈㄢˇ ㄒㄧㄥˇ
返還	ㄈㄢˇ ㄏㄨㄢˊ
犯愁	ㄈㄢˋ ㄔㄡˊ
飯碗	ㄈㄢˋ ㄨㄢˇ
泛濫	ㄈㄢˋ ㄌㄢˋ
範疇	ㄈㄢˋ ㄔㄡˊ
販賣	ㄈㄢˋ ㄇㄞˋ
方方面面	ㄈㄤ ㄈㄤ-ㄇㄧㄢˋ ㄇㄧㄢˋ
方向盤	ㄈㄤ ㄒㄧㄤˋ ㄆㄢˊ
方言	ㄈㄤ ㄧㄢˊ
防盜	ㄈㄤˊ ㄉㄠˋ
防盜門	ㄈㄤˊ ㄉㄠˋ ㄇㄣˊ
防護	ㄈㄤˊ ㄏㄨˋ
防火牆	ㄈㄤˊ ㄏㄨㄛˇ ㄑㄧㄤˊ
防衛	ㄈㄤˊ ㄨㄟˋ
防汛	ㄈㄤˊ ㄒㄩㄣˋ
防疫	ㄈㄤˊ ㄧˋ
防禦	ㄈㄤˊ ㄩˋ
妨礙	ㄈㄢˊ ㄍㄞˋ
房地產	ㄈㄤˊ ㄉㄧˋ ㄔㄢˇ
妨害	ㄈㄤˊ ㄏㄞˋ
仿	ㄈㄤˇ
仿製	ㄈㄤˇ ㄓˋ
訪談	ㄈㄤˇ ㄊㄢˊ
紡織	ㄈㄤˇ ㄓ
放過	ㄈㄤˋ ㄍㄨㄛˋ
放水	ㄈㄤˋ ㄕㄨㄟˇ
放肆	ㄈㄤˋ ㄙˋ
放映	ㄈㄤˋ ㄧㄥˋ
放置	ㄈㄤˋ ㄓˋ
放縱	ㄈㄤˋ ㄗㄨㄥˋ
飛速	ㄈㄟ ㄙㄨˋ
飛往	ㄈㄟ ㄨㄤˇ
飛翔	ㄈㄟ ㄒㄧㄤˊ
飛躍	ㄈㄟ ㄩㄝˋ
非	ㄈㄟ
非得	ㄈㄟ ㄉㄟˇ
非法	ㄈㄟ ㄈㄚˇ
肥料	ㄈㄟˊ ㄌㄧㄠˋ
非凡	ㄈㄟ ㄈㄢˊ
肥胖	ㄈㄟˊ ㄆㄤˋ
緋聞	ㄈㄟ ㄨㄣˊ
肥沃	ㄈㄟˊ ㄨㄛˋ
肥皂	ㄈㄟˊ ㄗㄠˋ
誹謗	ㄈㄟˇ ㄅㄤˋ
廢	ㄈㄟˋ
廢除	ㄈㄟˋ ㄔㄨˊ
廢話	ㄈㄟˋ ㄏㄨㄚˋ
廢品	ㄈㄟˋ ㄆㄧㄣˇ
廢寢忘食	ㄈㄟˋ ㄑㄧㄣˇ-ㄨㄤˋ ㄕˊ
廢物	ㄈㄟˋ ㄨ˙
廢墟	ㄈㄟˋ ㄒㄩ
沸沸揚揚	ㄈㄟˋ ㄈㄟˋ-ㄧㄤˊ ㄧㄤˊ
沸騰	ㄈㄟˋ ㄊㄥˊ
分辨	ㄈㄣ ㄅㄧㄢˋ
費勁	ㄈㄟˋ ㄐㄧㄣˋ
分寸	ㄈㄣ ㄘㄨㄣ˙
分擔	ㄈㄣ ㄉㄢ
分割	ㄈㄣ ㄍㄜ
分紅	ㄈㄣ ㄏㄨㄥˊ
分化	ㄈㄣ ㄏㄨㄚˋ
分泌	ㄈㄣ ㄇㄧˋ
分明	ㄈㄣ ㄇㄧㄥˊ
分歧	ㄈㄣ ㄑㄧˊ
分贓	ㄈㄣ ㄗㄤ
分支	ㄈㄣ ㄓ
芬芳	ㄈㄣ ㄈㄤ
氛圍	ㄈㄣ ㄨㄟˊ
吩咐	ㄈㄣ ㄈㄨ˙
墳	ㄈㄣˊ
墳墓	ㄈㄣˊ ㄇㄨˋ
焚燒	ㄈㄣˊ ㄕㄠ
粉	ㄈㄣˇ
粉絲	ㄈㄣˇ ㄙ
粉碎	ㄈㄣˇ ㄙㄨㄟˋ
分量	ㄈㄣˋ ㄌㄧㄤ˙
分外	ㄈㄣˋ ㄨㄞˋ
份額	ㄈㄣˋ ㄜˊ
奮力	ㄈㄣˋ ㄌㄧˋ
奮勇	ㄈㄣˋ ㄩㄥˇ
糞	ㄈㄣˋ
糞便	ㄈㄣˋ ㄅㄧㄢˋ
豐富多彩	ㄈㄥ ㄈㄨˋ-ㄉㄨㄛ ㄘㄞˇ
豐厚	ㄈㄥ ㄏㄡˋ
豐滿	ㄈㄥ ㄇㄢˇ
豐碩	ㄈㄥ ㄕㄨㄛˋ
豐盛	ㄈㄥ ㄕㄥˋ
風波	ㄈㄥ ㄅㄛ
風采	ㄈㄥ ㄘㄞˇ
風餐露宿	ㄈㄥ ㄘㄢ-ㄌㄨˋ ㄙㄨˋ
風和日麗	ㄈㄥ ㄏㄜˊ-ㄖˋ ㄌㄧˋ
風風雨雨	ㄈㄥ ㄈㄥ-ㄩˇ ㄩˇ
風浪	ㄈㄥ ㄌㄤˋ
風力	ㄈㄥ ㄌㄧˋ
風範	ㄈㄥ ㄈㄢˋ
風流	ㄈㄥ ㄌㄧㄡˊ
風貌	ㄈㄥ ㄇㄠˋ
風氣	ㄈㄥ ㄑㄧˋ
風情	ㄈㄥ ㄑㄧㄥˊ
風尚	ㄈㄥ ㄕㄤˋ
風趣	ㄈㄥ ㄑㄩˋ
風沙	ㄈㄥ ㄕㄚ
風水	ㄈㄥ ㄕㄨㄟ˙
風味	ㄈㄥ ㄨㄟˋ
風雨	ㄈㄥ ㄩˇ
風雲	ㄈㄥ ㄩㄣˊ
風箏	ㄈㄥ ㄓㄥ˙
封頂	ㄈㄥ ㄉㄧㄥˇ
封面	ㄈㄥ ㄇㄧㄢˋ
封建	ㄈㄥ ㄐㄧㄢˋ
封鎖	ㄈㄥ ㄙㄨㄛˇ
峰迴路轉	ㄈㄥ ㄏㄨㄟˊ-ㄌㄨˋ ㄓㄨㄢˇ
瘋子	ㄈㄥ ㄗ˙
蜂蜜	ㄈㄥ ㄇㄧˋ
逢	ㄈㄥˊ
縫	ㄈㄥˋ
縫合	ㄈㄥˊ ㄏㄜˊ
諷刺	ㄈㄥˇ ㄘˋ
鳳凰	ㄈㄥˋ ㄏㄨㄤˊ
孵化	ㄈㄨ ㄏㄨㄚˋ
否決	ㄈㄡˇ ㄐㄩㄝˊ
扶持	ㄈㄨˊ ㄔˊ
敷	ㄈㄨ
服飾	ㄈㄨˊ ㄕˋ
服務器	ㄈㄨˊ ㄨˋ ㄑㄧˋ
服用	ㄈㄨˊ ㄩㄥˋ
俘獲	ㄈㄨˊ ㄏㄨㄛˋ
俘虜	ㄈㄨˊ ㄌㄨˇ
浮力	ㄈㄨˊ ㄌㄧˋ
浮現	ㄈㄨˊ ㄒㄧㄢˋ
浮躁	ㄈㄨˊ ㄗㄠˋ
輻射	ㄈㄨˊ ㄕㄜˋ
福氣	ㄈㄨˊ ㄑㄧ˙
撫摸	ㄈㄨˇ ㄇㄛ
撫恤	ㄈㄨˇ ㄒㄩˋ
撫養	ㄈㄨˇ ㄧㄤˇ
撫養費	ㄈㄨˇ ㄧㄤˇ ㄈㄟˋ
斧子	ㄈㄨˇ ㄗ˙
俯首	ㄈㄨˇ ㄕㄡˇ
輔導	ㄈㄨˇ ㄉㄠˇ
腐敗	ㄈㄨˇ ㄅㄞˋ
腐化	ㄈㄨˇ ㄏㄨㄚˋ
腐爛	ㄈㄨˇ ㄌㄢˋ
腐蝕	ㄈㄨˇ ㄕˊ
腐朽	ㄈㄨˇ ㄒㄧㄡˇ
付費	ㄈㄨˋ ㄈㄟˋ
負面	ㄈㄨˋ ㄇㄧㄢˋ
付款	ㄈㄨˋ ㄎㄨㄢˇ
負有	ㄈㄨˋ ㄧㄡˇ
附	ㄈㄨˋ
附帶	ㄈㄨˋ ㄉㄞˋ
附和	ㄈㄨˋ ㄏㄜˋ
附加	ㄈㄨˋ ㄐㄧㄚ
附屬	ㄈㄨˋ ㄕㄨˇ
復查	ㄈㄨˋ ㄔㄚˊ
赴	ㄈㄨˋ
復發	ㄈㄨˋ ㄈㄚ
複合	ㄈㄨˋ ㄏㄜˊ
復活	ㄈㄨˋ ㄏㄨㄛˊ
復興	ㄈㄨˋ ㄒㄧㄥ
復原	ㄈㄨˋ ㄩㄢˊ
副作用	ㄈㄨˋ ㄗㄨㄛˋ ㄩㄥˋ
富含	ㄈㄨˋ ㄏㄢˊ
賦予	ㄈㄨˋ ㄩˇ
富豪	ㄈㄨˋ ㄏㄠˊ
富強	ㄈㄨˋ ㄑㄧㄤˊ
富翁	ㄈㄨˋ ㄨㄥ
富裕	ㄈㄨˋ ㄩˋ
腹部	ㄈㄨˋ ㄅㄨˋ
腹瀉	ㄈㄨˋ ㄒㄧㄝˋ
富足	ㄈㄨˋ ㄗㄨˊ
覆蓋	ㄈㄨˋ ㄍㄞˋ
該	ㄍㄞ
改版	ㄍㄞˇ ㄅㄢˇ
改編	ㄍㄞˇ ㄅㄧㄢ
改革開放	ㄍㄞˇ ㄍㄜˊ-ㄎㄞ ㄈㄤˋ
改動	ㄍㄞˇ ㄉㄨㄥˋ
改良	ㄍㄞˇ ㄌㄧㄤˊ
改名	ㄍㄞˇ ㄇㄧㄥˊ
改日	ㄍㄞˇ ㄖˋ
改為	ㄍㄞˇ ㄨㄟˊ
改邪歸正	ㄍㄞˇ ㄒㄧㄝˊ-ㄍㄨㄟ ㄓㄥˋ
鈣	ㄍㄞˋ
蓋子	ㄍㄞˋ ㄗ˙
概況	ㄍㄞˋ ㄎㄨㄤˋ
概率	ㄍㄞˋ ㄌㄩˋ
概論	ㄍㄞˋ ㄌㄨㄣˋ
干戈	ㄍㄢ ㄍㄜ
乾旱	ㄍㄢ ㄏㄢˋ
乾燥	ㄍㄢ ㄗㄠˋ
甘心	ㄍㄢ ㄒㄧㄣ
尷尬	ㄍㄢ ㄍㄚˋ
肝臟	ㄍㄢ ㄗㄤˋ
趕赴	ㄍㄢˇ ㄈㄨˋ
趕往	ㄍㄢˇ ㄨㄤˇ
敢情	ㄍㄢˇ ㄑㄧㄥ˙
感	ㄍㄢˇ
感觸	ㄍㄢˇ ㄔㄨˋ
感恩	ㄍㄚˇ ㄋㄣ
感激	ㄍㄢˇ ㄐㄧ
感慨	ㄍㄢˇ ㄎㄞˇ
感染	ㄍㄢˇ ㄖㄢˇ
感染力	ㄍㄢˇ ㄖㄢˇ ㄌㄧˋ
感嘆	ㄍㄢˇ ㄊㄢˋ
感性	ㄍㄢˇ ㄒㄧㄥˋ
幹部	ㄍㄢˋ ㄅㄨˋ
幹事	ㄍㄢˋ ㄕ˙
綱領	ㄍㄤ ㄌㄧㄥˇ
剛毅	ㄍㄤ ㄧˋ
綱要	ㄍㄤ ㄧㄠˋ
鋼	ㄍㄤ
缸	ㄍㄤ
杠鈴	ㄍㄤˋ ㄌㄧㄥˊ
港	ㄍㄤˇ
高昂	ㄍㄠ ㄤˊ
高傲	ㄍㄠ ㄠˋ
高超	ㄍㄠ ㄔㄠ
高低	ㄍㄠ ㄉㄧ
高調	ㄍㄠ ㄉㄧㄠˋ
高額	ㄍㄠ ㄜˊ
高爾夫球	ㄍㄠ ㄦˇ ㄈㄨ ㄑㄧㄡˊ
高貴	ㄍㄠ ㄍㄨㄟˋ
高峰期	ㄍㄠ ㄈㄥ ㄑㄧ
高空	ㄍㄠ ㄎㄨㄥ
高齡	ㄍㄠ ㄌㄧㄥˊ
高明	ㄍㄠ ㄇㄧㄥˊ
高山	ㄍㄠ ㄕㄢ
高效	ㄍㄠ ㄒㄧㄠˋ
高新技術	ㄍㄠ ㄒㄧㄣ ㄐㄧˋ ㄕㄨˋ
高血壓	ㄍㄠ ㄒㄩㄝˋ ㄧㄚ
高壓	ㄍㄠ ㄧㄚ
高雅	ㄍㄠ ㄧㄚˇ
高漲	ㄍㄠ ㄓㄤˋ
搞鬼	ㄍㄠˇ ㄍㄨㄟˇ
搞笑	ㄍㄠˇ ㄒㄧㄠˋ
告	ㄍㄠˋ
告辭	ㄍㄠˋ ㄘˊ
告誡	ㄍㄠˋ ㄐㄧㄝˋ
告示	ㄍㄠˋ ㄕ˙
告知	ㄍㄠˋ ㄓ
告狀	ㄍㄠˋ ㄓㄨㄤˋ
戈壁	ㄍㄜ ㄅㄧˋ
胳膊	ㄍㄜ ㄅㄛ˙
鴿子	ㄍㄜ ㄗ˙
擱	ㄍㄜ
擱置	ㄍㄜ ㄓˋ
擱淺	ㄍㄜ ㄑㄧㄢˇ
割	ㄍㄜ
歌劇	ㄍㄜ ㄐㄩˋ
歌頌	ㄍㄜ ㄙㄨㄥˋ
歌舞	ㄍㄜ ㄨˇ
歌詠	ㄍㄜ ㄩㄥˇ
革命	ㄍㄜˊ ㄇㄧㄥˋ
格	ㄍㄜˊ
格格不入	ㄍㄜˊ ㄍㄜˊ-ㄅㄨˋ ㄖㄨˋ
格局	ㄍㄜˊ ㄐㄩˊ
格式	ㄍㄜˊ ㄕ˙
隔閡	ㄍㄜˊ ㄏㄜˊ
隔離	ㄍㄜˊ ㄌㄧˊ
個頭兒	ㄍㄜˋ ㄊㄡˊ ㄦ˙
個案	ㄍㄜˋ ㄢˋ
各奔前程	ㄍㄜˋ ㄅㄣˋ-ㄑㄧㄢˊ ㄔㄥˊ
各式各樣	ㄍㄜˋ ㄕˋ-ㄍㄜˋ ㄧㄤˋ
根深蒂固	ㄍㄣ ㄕㄣ-ㄉㄧˋ ㄍㄨˋ
根源	ㄍㄣ ㄩㄢˊ
根基	ㄍㄣ ㄐㄧ
根治	ㄍㄣ ㄓˋ
跟上	ㄍㄣ ㄕㄤˋ
跟蹤	ㄍㄣ ㄗㄨㄥ
跟不上	ㄍㄣ ㄅㄨ˙ ㄕㄤˋ
更衣室	ㄍㄥ ㄧ ㄕˋ
更改	ㄍㄥ ㄍㄞˇ
耕地	ㄍㄥ ㄉㄧˋ
耿直	ㄍㄥˇ ㄓˊ
工地	ㄍㄨㄥ ㄉㄧˋ
工會	ㄍㄨㄥ ㄏㄨㄟˋ
工商界	ㄍㄨㄥ ㄕㄤ ㄐㄧㄝˋ
工科	ㄍㄨㄥ ㄎㄜ
工序	ㄍㄨㄥ ㄒㄩˋ
工整	ㄍㄨㄥ ㄓㄥˇ
工作量	ㄍㄨㄥ ㄗㄨㄛˋ ㄌㄧㄤˋ
公車	ㄍㄨㄥ ㄔㄜ
公安局	ㄍㄨㄥ ㄢ ㄐㄩˊ
公道	ㄍㄨㄥ ㄉㄠ˙
公費	ㄍㄨㄥ ㄈㄟˋ
公共場所	ㄍㄨㄥ ㄍㄨㄥˋ ㄔㄤˇ ㄙㄨㄛˇ
公關	ㄍㄨㄥ ㄍㄨㄢ
弓	ㄍㄨㄥ
公函	ㄍㄨㄥ ㄏㄢˊ
公積金	ㄍㄨㄥ ㄐㄧ ㄐㄧㄣ
公開信	ㄍㄨㄥ ㄎㄞ ㄒㄧㄣˋ
公墓	ㄍㄨㄥ ㄇㄨˋ
公款	ㄍㄨㄥ ㄎㄨㄢˇ
公僕	ㄍㄨㄥ ㄆㄨˊ
公頃	ㄍㄨㄥ ㄑㄧㄥˇ
公然	ㄍㄨㄥ ㄖㄢˊ
公示	ㄍㄨㄥ ㄕˋ
公事	ㄍㄨㄥ ㄕˋ
公益	ㄍㄨㄥ ㄧˋ
公務	ㄍㄨㄥ ㄨˋ
公益性	ㄍㄨㄥ ㄧˋ ㄒㄧㄥˋ
公立	ㄍㄨㄥ ㄌㄧˋ
公寓	ㄍㄨㄥ ㄩˋ
公約	ㄍㄨㄥ ㄩㄝ
公用	ㄍㄨㄥ ㄩㄥˋ
公證	ㄍㄨㄥ ㄓㄥˋ
功	ㄍㄨㄥ
功臣	ㄍㄨㄥ ㄔㄣˊ
功底	ㄍㄨㄥ ㄉㄧˇ
公職	ㄍㄨㄥ ㄓˊ
功力	ㄍㄨㄥ ㄌㄧˋ
功勞	ㄍㄨㄥ ㄌㄠˊ
功效	ㄍㄨㄥ ㄒㄧㄠˋ
攻讀	ㄍㄨㄥ ㄉㄨˊ
攻	ㄍㄨㄥ
攻關	ㄍㄨㄥ ㄍㄨㄢ
功率	ㄍㄨㄥ ㄌㄩˋ
供不應求	ㄍㄨㄥ ㄅㄨˋ ㄧㄥˋ ㄑㄧㄡˊ
供	ㄍㄨㄥ
供暖	ㄍㄨㄥ ㄋㄨㄢˇ
宮殿	ㄍㄨㄥ ㄉㄧㄢˋ
供求	ㄍㄨㄥ ㄑㄧㄡˊ
宮廷	ㄍㄨㄥ ㄊㄧㄥˊ
恭維	ㄍㄨㄥ ㄨㄟ˙
恭喜	ㄍㄨㄥ ㄒㄧˇ
拱	ㄍㄨㄥˇ
共鳴	ㄍㄨㄥˋ ㄇㄧㄥˊ
共識	ㄍㄨㄥˋ ㄕˊ
共性	ㄍㄨㄥˋ ㄒㄧㄥˋ
供奉	ㄍㄨㄥˋ ㄈㄥˋ
共同體	ㄍㄨㄥˋ ㄊㄨㄥˊ ㄊㄧˇ
勾畫	ㄍㄡ ㄏㄨㄚˋ
勾	ㄍㄡ
勾結	ㄍㄡ ㄐㄧㄝˊ
鉤	ㄍㄡ
鉤子	ㄍㄡ ㄗ˙
構思	ㄍㄡˋ ㄙ
構想	ㄍㄡˋ ㄒㄧㄤˇ
購	ㄍㄡˋ
夠嗆	ㄍㄡˋ ㄑㄧㄤˋ
估算	ㄍㄨ ㄙㄨㄢˋ
沽名釣譽	ㄍㄨ ㄇㄧㄥˊ-ㄉㄧㄠˋ ㄩˋ
孤單	ㄍㄨ ㄉㄢ
孤立	ㄍㄨ ㄌㄧˋ
孤零零	ㄍㄨ ㄌㄧㄥˊ ㄌㄧㄥˊ
孤陋寡聞	ㄍㄨ ㄌㄡˋ-ㄍㄨㄚˇ ㄨㄣˊ
辜負	ㄍㄨ ㄈㄨˋ
古董	ㄍㄨˇ ㄉㄨㄥˇ
古怪	ㄍㄨˇ ㄍㄨㄞˋ
古跡	ㄍㄨˇ ㄐㄧˋ
古今中外	ㄍㄨˇ ㄐㄧㄣ-ㄓㄨㄥ ㄨㄞˋ
古樸	ㄍㄨˇ ㄆㄨˇ
古人	ㄍㄨˇ ㄖㄣˊ
股份	ㄍㄨˇ ㄈㄣˋ
股民	ㄍㄨˇ ㄇㄧㄣˊ
股市	ㄍㄨˇ ㄕˋ
骨幹	ㄍㄨˇ ㄍㄢˋ
骨折	ㄍㄨˇ ㄓㄜˊ
骨氣	ㄍㄨˇ ㄑㄧˋ
鼓舞	ㄍㄨˇ ㄨˇ
鼓動	ㄍㄨˇ ㄉㄨㄥˋ
固然	ㄍㄨˋ ㄖㄢˊ
固執	ㄍㄨˋ ㄓ˙
故	ㄍㄨˋ
顧不得	ㄍㄨˋ ㄅㄨ˙ ㄉㄜ˙
顧不上	ㄍㄨˋ ㄅㄨ˙ ㄕㄤˋ
顧及	ㄍㄨˋ ㄐㄧˊ
顧慮	ㄍㄨˋ ㄌㄩˋ
雇	ㄍㄨˋ
顧全大局	ㄍㄨˋ ㄑㄩㄢˊ ㄉㄚˋ ㄐㄩˊ
雇傭	ㄍㄨˋ ㄩㄥ
雇員	ㄍㄨˋ ㄩㄢˊ
雇主	ㄍㄨˋ ㄓㄨˇ
瓜分	ㄍㄨㄚ ㄈㄣ
瓜子	ㄍㄨㄚ ㄗˇ
寡婦	ㄍㄨㄚˇ ㄈㄨ˙
颳風	ㄍㄨㄚ ㄈㄥ
掛鉤	ㄍㄨㄚˋ ㄍㄡ
掛號	ㄍㄨㄚˋ ㄏㄠˋ
掛念	ㄍㄨㄚˋ ㄋㄧㄢˋ
掛失	ㄍㄨㄚˋ ㄕ
乖	ㄍㄨㄞ
乖巧	ㄍㄨㄞ ㄑㄧㄠˇ
拐彎	ㄍㄨㄞˇ ㄨㄢ
拐杖	ㄍㄨㄞˇ ㄓㄤˋ
怪不得	ㄍㄨㄞˋ ㄅㄨ˙ ㄉㄜ˙
怪物	ㄍㄨㄞˋ ㄨ˙
怪異	ㄍㄨㄞˋ ㄧˋ
關掉	ㄍㄨㄢ ㄉㄧㄠˋ
關節	ㄍㄨㄢ ㄐㄧㄝˊ
關稅	ㄍㄨㄢ ㄕㄨㄟˋ
關頭	ㄍㄨㄢ ㄊㄡˊ
關照	ㄍㄨㄢ ㄓㄠˋ
觀測	ㄍㄨㄢ ㄘㄜˋ
觀感	ㄍㄨㄢ ㄍㄢˇ
觀摩	ㄍㄨㄢ ㄇㄛˊ
觀賞	ㄍㄨㄢ ㄕㄤˇ
觀望	ㄍㄨㄢ ㄨㄤˋ
官兵	ㄍㄨㄢ ㄅㄧㄥ
官吏	ㄍㄨㄢ ㄌㄧˋ
官僚	ㄍㄨㄢ ㄌㄧㄠˊ
官僚主義	ㄍㄨㄢ ㄌㄧㄠˊ ㄓㄨˇ ㄧˋ
官員	ㄍㄨㄢ ㄩㄢˊ
棺材	ㄍㄨㄢ ㄘㄞ˙
管家	ㄍㄨㄢˇ ㄐㄧㄚ
管教	ㄍㄨㄢˇ ㄐㄧㄠˋ
管理費	ㄍㄨㄢˇ ㄌㄧˇ ㄈㄟˋ
管轄	ㄍㄨㄢˇ ㄒㄧㄚˊ
管用	ㄍㄨㄢˇ ㄩㄥˋ
管子	ㄍㄨㄢˇ ㄗ˙
貫徹	ㄍㄨㄢˋ ㄔㄜˋ
貫穿	ㄍㄨㄢˋ ㄔㄨㄢ
貫通	ㄍㄨㄢˋ ㄊㄨㄥ
慣	ㄍㄨㄢˋ
慣例	ㄍㄨㄢˋ ㄌㄧˋ
慣性	ㄍㄨㄢˋ ㄒㄧㄥˋ
灌	ㄍㄨㄢˋ
灌溉	ㄍㄨㄢˋ ㄍㄞˋ
灌輸	ㄍㄨㄢˋ ㄕㄨ
罐	ㄍㄨㄢˋ
罐頭	ㄍㄨㄢˋ ㄊㄡ˙
光彩	ㄍㄨㄤ ㄘㄞˇ
光碟	ㄍㄨㄤ ㄉㄧㄝˊ
光顧	ㄍㄨㄤ ㄍㄨˋ
光滑	ㄍㄨㄤ ㄏㄨㄚ˙
光環	ㄍㄨㄤ ㄏㄨㄢˊ
光纜	ㄍㄨㄤ ㄌㄢˇ
光芒	ㄍㄨㄤ ㄇㄤˊ
光明磊落	ㄍㄨㄤ ㄇㄧㄥˊ-ㄌㄟˇ ㄌㄨㄛˋ
光澤	ㄍㄨㄤ ㄗㄜˊ
廣義	ㄍㄨㄤˇ ㄧˋ
歸根到底	ㄍㄨㄟ ㄍㄣ ㄉㄠˋ ㄉㄧˇ
歸還	ㄍㄨㄟ ㄏㄨㄢˊ
歸結	ㄍㄨㄟ ㄐㄧㄝˊ
歸來	ㄍㄨㄟ ㄌㄞˊ
歸納	ㄍㄨㄟ ㄋㄚˋ
歸屬	ㄍㄨㄟ ㄕㄨˇ
歸宿	ㄍㄨㄟ ㄙㄨˋ
龜	ㄍㄨㄟ
規格	ㄍㄨㄟ ㄍㄜˊ
規矩	ㄍㄨㄟ ㄐㄩ˙
閨女	ㄍㄨㄟ ㄋㄩ˙
瑰寶	ㄍㄨㄟ ㄅㄠˇ
軌跡	ㄍㄨㄟˇ ㄐㄧˋ
櫃檯	ㄍㄨㄟˋ ㄊㄞˊ
貴賓	ㄍㄨㄟˋ ㄅㄧㄣ
貴重	ㄍㄨㄟˋ ㄓㄨㄥˋ
貴族	ㄍㄨㄟˋ ㄗㄨˊ
桂花	ㄍㄨㄟˋ ㄏㄨㄚ
滾動	ㄍㄨㄣˇ ㄉㄨㄥˋ
棍	ㄍㄨㄣˋ
棍子	ㄍㄨㄣˋ ㄗ˙
國寶	ㄍㄨㄛˊ ㄅㄠˇ
國防	ㄍㄨㄛˊ ㄈㄤˊ
國畫	ㄍㄨㄛˊ ㄏㄨㄚˋ
國徽	ㄍㄨㄛˊ ㄏㄨㄟ
國情	ㄍㄨㄛˊ ㄑㄧㄥˊ
國土	ㄍㄨㄛˊ ㄊㄨˇ
國學	ㄍㄨㄛˊ ㄒㄩㄝˊ
國有	ㄍㄨㄛˊ ㄧㄡˇ
果斷	ㄍㄨㄛˇ ㄉㄨㄢˋ
果園	ㄍㄨㄛˇ ㄩㄢˊ
果真	ㄍㄨㄛˇ ㄓㄣ
裹	ㄍㄨㄛˇ
過半	ㄍㄨㄛˋ ㄅㄢˋ
過不去	ㄍㄨㄛˋ ㄅㄨ˙ ㄑㄩˋ
過錯	ㄍㄨㄛˋ ㄘㄨㄛˋ
過關	ㄍㄨㄛˋ ㄍㄨㄢ
過道	ㄍㄨㄛˋ ㄉㄠˋ
過獎	ㄍㄨㄛˋ ㄐㄧㄤˇ
過節	ㄍㄨㄛˋ ㄐㄧㄝˊ
過境	ㄍㄨㄛˋ ㄐㄧㄥˋ
過濾	ㄍㄨㄛˋ ㄌㄩˋ
過期	ㄍㄨㄛˋ ㄑㄧ
過剩	ㄍㄨㄛˋ ㄕㄥˋ
過失	ㄍㄨㄛˋ ㄕ
過日子	ㄍㄨㄛˋ ㄖˋ ㄗ˙
過頭	ㄍㄨㄛˋ ㄊㄡˊ
過往	ㄍㄨㄛˋ ㄨㄤˇ
過意不去	ㄍㄨㄛˋ ㄧˋ ㄅㄨˋ ㄑㄩˋ
過癮	ㄍㄨㄛˋ ㄧㄣˇ
過硬	ㄍㄨㄛˋ ㄧㄥˋ
過早	ㄍㄨㄛˋ ㄗㄠˇ
海岸	ㄏㄞˇ ㄢˋ
海拔	ㄏㄞˇ ㄅㄚˊ
海濱	ㄏㄞˇ ㄅㄧㄣ
海盜	ㄏㄞˇ ㄉㄠˋ
海量	ㄏㄞˇ ㄌㄧㄤˋ
海綿	ㄏㄞˇ ㄇㄧㄢˊ
海面	ㄏㄞˇ ㄇㄧㄢˋ
海內外	ㄏㄞˇ ㄋㄟˋ ㄨㄞˋ
海灘	ㄏㄞˇ ㄊㄢ
海峽	ㄏㄞˇ ㄒㄧㄚˊ
海嘯	ㄏㄞˇ ㄒㄧㄠˋ
海域	ㄏㄞˇ ㄩˋ
海運	ㄏㄞˇ ㄩㄣˋ
海藻	ㄏㄞˇ ㄗㄠˇ
駭人聽聞	ㄏㄞˋ ㄖㄣˊ-ㄊㄧㄥ ㄨㄣˊ
害蟲	ㄏㄞˋ ㄔㄨㄥˊ
害臊	ㄏㄞˋ ㄙㄠˋ
害羞	ㄏㄞˋ ㄒㄧㄡ
酣暢	ㄏㄢ ㄔㄤˋ
酣睡	ㄏㄢ ㄕㄨㄟˋ
含糊	ㄏㄢˊ ㄏㄨ˙
含蓄	ㄏㄢˊ ㄒㄩˋ
函授	ㄏㄢˊ ㄕㄡˋ
涵蓋	ㄏㄢˊ ㄍㄞˋ
涵義	ㄏㄢˊ ㄧˋ
罕見	ㄏㄢˇ ㄐㄧㄢˋ
汗水	ㄏㄢˋ ㄕㄨㄟˇ
旱	ㄏㄢˋ
旱災	ㄏㄢˋ ㄗㄞ
焊	ㄏㄢˋ
捍衛	ㄏㄢˋ ㄨㄟˋ
行家	ㄏㄤˊ ㄐㄧㄚ˙
行列	ㄏㄤˊ ㄌㄧㄝˋ
行情	ㄏㄤˊ ㄑㄧㄥˊ
航海	ㄏㄤˊ ㄏㄞˇ
航天	ㄏㄤˊ ㄊㄧㄢ
航天員	ㄏㄤˊ ㄊㄧㄢ ㄩㄢˊ
航運	ㄏㄤˊ ㄩㄣˋ
航行	ㄏㄤˊ ㄒㄧㄥˊ
毫不	ㄏㄠˋ ㄅㄨˋ
毫不猶豫	ㄏㄠˊ ㄅㄨˋ ㄧㄡˊ ㄩˋ
毫無	ㄏㄠˊ ㄨˊ
豪華	ㄏㄠˊ ㄏㄨㄚˊ
好歹	ㄏㄠˇ ㄉㄞˇ
好比	ㄏㄠˇ ㄅㄧˇ
好感	ㄏㄠˇ ㄍㄢˇ
好壞	ㄏㄠˇ-ㄏㄨㄞˋ
好家伙	ㄏㄠˇ ㄐㄧㄚ ㄏㄨㄛ˙
好評	ㄏㄠˇ ㄆㄧㄥˊ
好說	ㄏㄠˇ ㄕㄨㄛ
好笑	ㄏㄠˇ ㄒㄧㄠˋ
好心	ㄏㄠˇ ㄒㄧㄣ
好心人	ㄏㄠˇ ㄒㄧㄣ ㄖㄣˊ
好意	ㄏㄠˇ ㄧˋ
好在	ㄏㄠˇ ㄗㄞˋ
號稱	ㄏㄠˋ ㄔㄥ
好客	ㄏㄠˋ ㄎㄜˋ
好奇心	ㄏㄠˋ ㄑㄧˊ ㄒㄧㄣ
耗	ㄏㄠˋ
耗費	ㄏㄠˋ ㄈㄟˋ
耗時	ㄏㄠˋ ㄕˊ
浩劫	ㄏㄠˋ ㄐㄧㄝˊ
呵護	ㄏㄜ ㄏㄨˋ
禾苗	ㄏㄜˊ ㄇㄧㄠˊ
合唱	ㄏㄜˊ ㄔㄤˋ
合伙	ㄏㄜˊ ㄏㄨㄛˇ
合乎	ㄏㄜˊ ㄏㄨ
合計	ㄏㄜˊ ㄐㄧ˙
合情合理	ㄏㄜˊ ㄑㄧㄥˊ-ㄏㄜˊ ㄌㄧˇ
合影	ㄏㄜˊ ㄧㄥˇ
合資	ㄏㄜˊ ㄗ
合作社	ㄏㄜˊ ㄗㄨㄛˋ ㄕㄜˋ
何必	ㄏㄜˊ ㄅㄧˋ
何處	ㄏㄜˊ ㄔㄨˋ
何苦	ㄏㄜˊ ㄎㄨˇ
何況	ㄏㄜˊ ㄎㄨㄤˋ
何時	ㄏㄜˊ ㄕˊ
和藹	ㄏㄜˊ ㄞˇ
和解	ㄏㄜˊ ㄐㄧㄝˇ
和睦	ㄏㄜˊ ㄇㄨˋ
和平共處	ㄏㄜˊ ㄆㄧㄥˊ ㄍㄨㄥˋ ㄔㄨˇ
和氣	ㄏㄜˊ ㄑㄧ˙
和尚	ㄏㄜˊ ㄕㄤ˙
河流	ㄏㄜˊ ㄌㄧㄡˊ
河畔	ㄏㄜˊ ㄆㄢˋ
荷花	ㄏㄜˊ ㄏㄨㄚ
核	ㄏㄜˊ
核電站	ㄏㄜˊ ㄉㄧㄢˋ ㄓㄢˋ
核對	ㄏㄜˊ ㄉㄨㄟˋ
核能	ㄏㄜˊ ㄋㄥˊ
核桃	ㄏㄜˊ ㄊㄠ˙
核實	ㄏㄜˊ ㄕˊ
核武器	ㄏㄜˊ ㄨˇ ㄑㄧˋ
賀信	ㄏㄜˋ ㄒㄧㄣˋ
賀電	ㄏㄜˋ ㄉㄧㄢˋ
喝彩	ㄏㄜˋ ㄘㄞˇ
赫然	ㄏㄜˋ ㄖㄢˊ
鶴立雞群	ㄏㄜˋ ㄌㄧˋ-ㄐㄧ ㄑㄩㄣˊ
黑客	ㄏㄟ ㄎㄜˋ
黑馬	ㄏㄟ ㄇㄚˇ
黑白	ㄏㄟ ㄅㄞˊ
黑手	ㄏㄟ ㄕㄡˇ
黑心	ㄏㄟ ㄒㄧㄣ
嘿	ㄏㄟ
痕跡	ㄏㄣˊ ㄐㄧˋ
恨不得	ㄏㄣˋ ㄅㄨ˙ ㄉㄜ˙
哼	ㄏㄥ
橫七豎八	ㄏㄥˊ ㄑㄧ-ㄕㄨˋ ㄅㄚ
橫向	ㄏㄥˊ ㄒㄧㄤˋ
橫	ㄏㄥˊ
轟	ㄏㄨㄥ
轟動	ㄏㄨㄥ ㄉㄨㄥˋ
轟炸	ㄏㄨㄥ ㄓㄚˋ
哄	ㄏㄨㄥ
哄堂大笑	ㄏㄨㄥ ㄊㄤˊ-ㄉㄚˋ ㄒㄧㄠˋ
烘乾	ㄏㄨㄥ ㄍㄢ
烘托	ㄏㄨㄥ ㄊㄨㄛ
弘揚	ㄏㄨㄥˊ ㄧㄤˊ
紅燈	ㄏㄨㄥˊ ㄉㄥ
紅火	ㄏㄨㄥˊ ㄏㄨㄛ˙
紅撲撲	ㄏㄨㄥˊ ㄆㄨ ㄆㄨ
紅潤	ㄏㄨㄥˊ ㄖㄨㄣˋ
紅薯	ㄏㄨㄥˊ ㄕㄨˇ
紅眼	ㄏㄨㄥˊ ㄧㄢˇ
宏觀	ㄏㄨㄥˊ ㄍㄨㄢ
宏偉	ㄏㄨㄥˊ ㄨㄟˇ
洪亮	ㄏㄨㄥˊ ㄌㄧㄤˋ
喉嚨	ㄏㄡˊ ㄌㄨㄥ˙
吼	ㄏㄡˇ
後備	ㄏㄡˋ ㄅㄟˋ
後備箱	ㄏㄡˋ ㄅㄟˋ ㄒㄧㄤ
後代	ㄏㄡˋ ㄉㄞˋ
後盾	ㄏㄡˋ ㄉㄨㄣˋ
後顧之憂	ㄏㄡˋ ㄍㄨˋ ㄓ ㄧㄡ
後期	ㄏㄡˋ ㄑㄧ
後勤	ㄏㄡˋ ㄑㄧㄣˊ
後人	ㄏㄡˋ ㄖㄣˊ
後臺	ㄏㄡˋ ㄊㄞˊ
後退	ㄏㄡˋ ㄊㄨㄟˋ
後續	ㄏㄡˋ ㄒㄩˋ
後遺癥	ㄏㄡˋ ㄧˊ ㄓㄥˋ
後裔	ㄏㄡˋ ㄧˋ
後者	ㄏㄡˋ ㄓㄜˇ
厚道	ㄏㄡˋ ㄉㄠ˙
厚度	ㄏㄡˋ ㄉㄨˋ
候選人	ㄏㄡˋ ㄒㄩㄢˇ ㄖㄣˊ
呼風喚雨	ㄏㄨ ㄈㄥ-ㄏㄨㄢˋ ㄩˇ
呼喚	ㄏㄨ ㄏㄨㄢˋ
呼救	ㄏㄨ ㄐㄧㄡˋ
呼聲	ㄏㄨ ㄕㄥ
呼應	ㄏㄨ ㄧㄥˋ
呼吁	ㄏㄨ ㄩˋ
忽高忽低	ㄏㄨ ㄍㄠ ㄏㄨ ㄉㄧ
忽悠	ㄏㄨ ㄧㄡ˙
胡鬧	ㄏㄨˊ ㄋㄠˋ
胡說	ㄏㄨˊ ㄕㄨㄛ
胡思亂想	ㄏㄨˊ ㄙ-ㄌㄨㄢˋ ㄒㄧㄤˇ
湖泊	ㄏㄨˊ ㄆㄛ
糊	ㄏㄨ
糊塗	ㄏㄨˊ ㄊㄨ˙
互補	ㄏㄨˋ ㄅㄨˇ
互訪	ㄏㄨˋ ㄈㄤˇ
互信	ㄏㄨˋ ㄒㄧㄣˋ
互助	ㄏㄨˋ ㄓㄨˋ
護理	ㄏㄨˋ ㄌㄧˇ
花瓣	ㄏㄨㄚ ㄅㄢˋ
花卉	ㄏㄨㄚ ㄏㄨㄟˋ
花紋	ㄏㄨㄚ ㄨㄣˊ
花樣	ㄏㄨㄚ ㄧㄤˋ
華麗	ㄏㄨㄚˊ ㄌㄧˋ
划算	ㄏㄨㄚˊ ㄙㄨㄢˋ
華僑	ㄏㄨㄚˊ ㄑㄧㄠˊ
華裔	ㄏㄨㄚˊ ㄧˋ
嘩變	ㄏㄨㄚˊ ㄅㄧㄢˋ
嘩然	ㄏㄨㄚˊ ㄖㄢˊ
滑冰	ㄏㄨㄚˊ ㄅㄧㄥ
滑稽	ㄏㄨㄚˊ ㄐㄧ˙
滑梯	ㄏㄨㄚˊ ㄊㄧ
滑雪	ㄏㄨㄚˊ ㄒㄩㄝˇ
化肥	ㄏㄨㄚˋ ㄈㄟˊ
化身	ㄏㄨㄚˋ ㄕㄣ
化纖	ㄏㄨㄚˋ ㄒㄧㄢ
化險為夷	ㄏㄨㄚˋ ㄒㄧㄢˇ-ㄨㄟˊ ㄧˊ
化驗	ㄏㄨㄚˋ ㄧㄢˋ
化妝	ㄏㄨㄚˋ ㄓㄨㄤ
劃時代	ㄏㄨㄚˋ ㄕˊ ㄉㄞˋ
畫冊	ㄏㄨㄚˋ ㄘㄜˋ
畫龍點睛	ㄏㄨㄚˋ ㄌㄨㄥˊ-ㄉㄧㄢˇ ㄐㄧㄥ
畫蛇添足	ㄏㄨㄚˋ ㄕㄜˊ-ㄊㄧㄢ ㄗㄨˊ
畫展	ㄏㄨㄚˋ ㄓㄢˇ
話費	ㄏㄨㄚˋ ㄈㄟˋ
話筒	ㄏㄨㄚˋ ㄊㄨㄥˇ
話語	ㄏㄨㄚˋ ㄩˇ
懷抱	ㄏㄨㄞˊ ㄅㄠˋ
懷舊	ㄏㄨㄞˊ ㄐㄧㄡˋ
懷裡	ㄏㄨㄞˊ ㄌㄧˇ
懷孕	ㄏㄨㄞˊ ㄩㄣˋ
懷著	ㄏㄨㄞˊ ㄓㄜ˙
槐樹	ㄏㄨㄞˊ ㄕㄨˋ
壞事	ㄏㄨㄞˋ ㄕˋ
歡呼	ㄏㄨㄢ ㄏㄨ
歡聚	ㄏㄨㄢ ㄐㄩˋ
歡快	ㄏㄨㄢ ㄎㄨㄞˋ
歡聲笑語	ㄏㄨㄢ ㄕㄥ-ㄒㄧㄠˋ ㄩˇ
還款	ㄏㄨㄢˊ ㄎㄨㄢˇ
還原	ㄏㄨㄢˊ ㄩㄢˊ
環球	ㄏㄨㄢˊ ㄑㄧㄡˊ
環繞	ㄏㄨㄢˊ ㄖㄠˋ
緩	ㄏㄨㄢˇ
緩和	ㄏㄨㄢˇ ㄏㄜˊ
緩緩	ㄏㄨㄢˇ ㄏㄨㄢˇ
幻覺	ㄏㄨㄢˋ ㄐㄩㄝˊ
幻影	ㄏㄨㄢˋ ㄧㄥˇ
換成	ㄏㄨㄢˋ ㄔㄥˊ
緩慢	ㄏㄨㄢˇ ㄇㄢˋ
換位	ㄏㄨㄢˋ ㄨㄟˋ
換言之	ㄏㄨㄢˋ ㄧㄢˊ ㄓ
換取	ㄏㄨㄢˋ ㄑㄩˇ
患	ㄏㄨㄢˋ
喚起	ㄏㄨㄢˋ ㄑㄧˇ
患病	ㄏㄨㄢˋ ㄅㄧㄥˋ
患有	ㄏㄨㄢˋ ㄧㄡˇ
煥發	ㄏㄨㄢˋ ㄈㄚ
荒誕	ㄏㄨㄤ ㄉㄢˋ
荒	ㄏㄨㄤ
荒涼	ㄏㄨㄤ ㄌㄧㄤˊ
慌亂	ㄏㄨㄤ ㄌㄨㄢˋ
荒謬	ㄏㄨㄤ ㄇㄧㄡˋ
慌張	ㄏㄨㄤ ㄓㄤ˙
皇宮	ㄏㄨㄤˊ ㄍㄨㄥ
皇室	ㄏㄨㄤˊ ㄕˋ
皇上	ㄏㄨㄤˊ ㄕㄤ˙
皇后	ㄏㄨㄤˊ ㄏㄡˋ
恍然大悟	ㄏㄨㄤˇ ㄖㄢˊ-ㄉㄚˋ ㄨˋ
晃	ㄏㄨㄤˇ
黃昏	ㄏㄨㄤˊ ㄏㄨㄣ
謊言	ㄏㄨㄤˇ ㄧㄢˊ
謊話	ㄏㄨㄤˇ ㄏㄨㄚˋ
灰	ㄏㄨㄟ
灰塵	ㄏㄨㄟ ㄔㄣˊ
晃蕩	ㄏㄨㄤˋ ㄉㄤ˙
揮	ㄏㄨㄟ
灰心	ㄏㄨㄟ ㄒㄧㄣ
輝煌	ㄏㄨㄟ ㄏㄨㄤˊ
回扣	ㄏㄨㄟˊ ㄎㄡˋ
回饋	ㄏㄨㄟˊ ㄎㄨㄟˋ
回落	ㄏㄨㄟˊ ㄌㄨㄛˋ
迴首	ㄏㄨㄟˊ ㄕㄡˇ
回升	ㄏㄨㄟˊ ㄕㄥ
回味	ㄏㄨㄟˊ ㄨㄟˋ
回歸	ㄏㄨㄟˊ ㄍㄨㄟ
回想	ㄏㄨㄟˊ ㄒㄧㄤˇ
回憶錄	ㄏㄨㄟˊ ㄧˋ ㄌㄨˋ
悔恨	ㄏㄨㄟˇ ㄏㄣˋ
毀壞	ㄏㄨㄟˇ ㄏㄨㄞˋ
匯合	ㄏㄨㄟˋ ㄏㄜˊ
彙集	ㄏㄨㄟˋ ㄐㄧˊ
毀滅	ㄏㄨㄟˇ ㄇㄧㄝˋ
會場	ㄏㄨㄟˋ ㄔㄤˇ
會面	ㄏㄨㄟˋ ㄇㄧㄢˋ
會聚	ㄏㄨㄟˋ ㄐㄩˋ
會晤	ㄏㄨㄟˋ ㄨˋ
會意	ㄏㄨㄟˋ ㄧˋ
會診	ㄏㄨㄟˋ ㄓㄣˇ
繪聲繪色	ㄏㄨㄟˋ ㄕㄥ-ㄏㄨㄟˋ ㄙㄜˋ
賄賂	ㄏㄨㄟˋ ㄌㄨˋ
婚紗	ㄏㄨㄣ ㄕㄚ
婚姻	ㄏㄨㄣ ㄧㄣ
渾身	ㄏㄨㄣˊ ㄕㄣ
魂	ㄏㄨㄣˊ
昏迷	ㄏㄨㄣ ㄇㄧˊ
混凝土	ㄏㄨㄣˋ ㄋㄧㄥˊ ㄊㄨˇ
混淆	ㄏㄨㄣˋ ㄒㄧㄠˊ
混濁	ㄏㄨㄣˋ ㄓㄨㄛˊ
豁	ㄏㄨㄛ
豁出去	ㄏㄨㄛ ㄔㄨ˙ ㄑㄩ˙
活該	ㄏㄨㄛˊ ㄍㄞ
活期	ㄏㄨㄛˊ ㄑㄧ
活兒	ㄏㄨㄛˊ ㄦ˙
火暴	ㄏㄨㄛˇ ㄅㄠˋ
火鍋	ㄏㄨㄛˇ ㄍㄨㄛ
火候	ㄏㄨㄛˇ ㄏㄡ˙
火花	ㄏㄨㄛˇ ㄏㄨㄚ
火炬	ㄏㄨㄛˇ ㄐㄩˋ
火辣辣	ㄏㄨㄛˇ ㄌㄚˋ ㄌㄚˋ
火熱	ㄏㄨㄛˇ ㄖㄜˋ
火山	ㄏㄨㄛˇ ㄕㄢ
火速	ㄏㄨㄛˇ ㄙㄨˋ
火焰	ㄏㄨㄛˇ ㄧㄢˋ
火藥	ㄏㄨㄛˇ ㄧㄠˋ
伙食	ㄏㄨㄛˇ ㄕ˙
或多或少	ㄏㄨㄛˋ ㄉㄨㄛ ㄏㄨㄛˋ ㄕㄠˇ
貨幣	ㄏㄨㄛˋ ㄅㄧˋ
貨車	ㄏㄨㄛˋ ㄔㄜ
貨物	ㄏㄨㄛˋ ㄨˋ
貨運	ㄏㄨㄛˋ ㄩㄣˋ
獲勝	ㄏㄨㄛˋ ㄕㄥˋ
獲悉	ㄏㄨㄛˋ ㄒㄧ
禍害	ㄏㄨㄛˋ ㄏㄞ˙
霍亂	ㄏㄨㄛˋ ㄌㄨㄢˋ
豁達	ㄏㄨㄛˋ ㄉㄚˊ
譏笑	ㄐㄧ ㄒㄧㄠˋ
飢餓	ㄐㄧ ㄜˋ
幾率	ㄐㄧ ㄌㄩˋ
機艙	ㄐㄧ ㄘㄤ
機動	ㄐㄧ ㄉㄨㄥˋ
機密	ㄐㄧ ㄇㄧˋ
機靈	ㄐㄧ ㄌㄧㄥ˙
機智	ㄐㄧ ㄓˋ
肌膚	ㄐㄧ ㄈㄨ
積	ㄐㄧ
積澱	ㄐㄧ ㄉㄧㄢˋ
積蓄	ㄐㄧ ㄒㄩˋ
基本功	ㄐㄧ ㄅㄣˇ ㄍㄨㄥ
基層	ㄐㄧ ㄘㄥˊ
基因	ㄐㄧ ㄧㄣ
基準	ㄐㄧ ㄓㄨㄣˇ
基於	ㄐㄧ ㄩˊ
畸形	ㄐㄧ ㄒㄧㄥˊ
激發	ㄐㄧ ㄈㄚ
激光	ㄐㄧ ㄍㄨㄤ
激化	ㄐㄧ ㄏㄨㄚˋ
激活	ㄐㄧ ㄏㄨㄛˊ
激勵	ㄐㄧ ㄌㄧˋ
激起	ㄐㄧ ㄑㄧˇ
及	ㄐㄧˊ
及其	ㄐㄧˊ ㄑㄧˊ
激素	ㄐㄧ ㄙㄨˋ
及早	ㄐㄧˊ ㄗㄠˇ
吉普	ㄐㄧˊ ㄆㄨˇ
吉他	ㄐㄧˊ ㄊㄚ
吉祥物	ㄐㄧˊ ㄒㄧㄤˊ ㄨˋ
級別	ㄐㄧˊ ㄅㄧㄝˊ
極度	ㄐㄧˊ ㄉㄨˋ
極力	ㄐㄧˊ ㄌㄧˋ
極少數	ㄐㄧˊ ㄕㄠˇ ㄕㄨˋ
極為	ㄐㄧˊ ㄨㄟˊ
極限	ㄐㄧˊ ㄒㄧㄢˋ
即	ㄐㄧˊ
即便	ㄐㄧˊ ㄅㄧㄢˋ
即可	ㄐㄧˊ ㄎㄜˇ
急劇	ㄐㄧˊ ㄐㄩˋ
急迫	ㄐㄧˊ ㄆㄛˋ
急性	ㄐㄧˊ ㄒㄧㄥˋ
急於	ㄐㄧˊ ㄩˊ
急診	ㄐㄧˊ ㄓㄣˇ
急轉彎	ㄐㄧˊ ㄓㄨㄢˇ ㄨㄢ
急需	ㄐㄧˊ ㄒㄩ
棘手	ㄐㄧˊ ㄕㄡˇ
集結	ㄐㄧˊ ㄐㄧㄝˊ
集郵	ㄐㄧˊ ㄧㄡˊ
集裝箱	ㄐㄧˊ ㄓㄨㄤ ㄒㄧㄤ
集會	ㄐㄧˊ ㄏㄨㄟˋ
嫉妒	ㄐㄧˊ ㄉㄨˋ
脊梁	ㄐㄧˇ ㄌㄧㄤ˙
集資	ㄐㄧˊ ㄗ
計	ㄐㄧˋ
擠壓	ㄐㄧˇ ㄧㄚ
計較	ㄐㄧˋ ㄐㄧㄠˋ
記號	ㄐㄧˋ ㄏㄠ˙
計時	ㄐㄧˋ ㄕˊ
記憶猶新	ㄐㄧˋ ㄧˋ-ㄧㄡˊ ㄒㄧㄣ
紀錄片	ㄐㄧˋ ㄌㄨˋ ㄆㄧㄢˋ
紀念碑	ㄐㄧˋ ㄋㄧㄢˋ ㄅㄟ
紀念館	ㄐㄧˋ ㄋㄧㄢˋ ㄍㄨㄢˇ
紀念日	ㄐㄧˋ ㄋㄧㄢˋ ㄖˋ
紀實	ㄐㄧˋ ㄕˊ
計策	ㄐㄧˋ ㄘㄜˋ
技藝	ㄐㄧˋ ㄧˋ
忌	ㄐㄧˋ
忌諱	ㄐㄧˋ ㄏㄨㄟ˙
忌口	ㄐㄧˋ ㄎㄡˇ
劑	ㄐㄧˋ
跡象	ㄐㄧˋ ㄒㄧㄤˋ
繼	ㄐㄧˋ
繼而	ㄐㄧˋ ㄦˊ
繼父	ㄐㄧˋ ㄈㄨˋ
繼母	ㄐㄧˋ ㄇㄨˇ
祭	ㄐㄧˋ
祭奠	ㄐㄧˋ ㄉㄧㄢˋ
祭祀	ㄐㄧˋ ㄙ˙
寄託	ㄐㄧˋ ㄊㄨㄛ
寂靜	ㄐㄧˋ ㄐㄧㄥˋ
寂寞	ㄐㄧˋ ㄇㄛˋ
加緊	ㄐㄧㄚ ㄐㄧㄣˇ
加劇	ㄐㄧㄚ ㄐㄩˋ
加深	ㄐㄧㄚ ㄕㄣ
加重	ㄐㄧㄚ ㄓㄨㄥˋ
佳節	ㄐㄧㄚ ㄐㄧㄝˊ
家伙	ㄐㄧㄚ ㄏㄨㄛ˙
家家戶戶	ㄐㄧㄚ ㄐㄧㄚ-ㄏㄨˋ ㄏㄨˋ
家教	ㄐㄧㄚ ㄐㄧㄠˋ
家境	ㄐㄧㄚ ㄐㄧㄥˋ
家用	ㄐㄧㄚ ㄩㄥˋ
家禽	ㄐㄧㄚ ㄑㄧㄣˊ
家喻戶曉	ㄐㄧㄚ ㄩˋ-ㄏㄨˋ ㄒㄧㄠˇ
家政	ㄐㄧㄚ ㄓㄥˋ
家族	ㄐㄧㄚ ㄗㄨˊ
嘉年華	ㄐㄧㄚ ㄋㄧㄢˊ ㄏㄨㄚˊ
假冒	ㄐㄧㄚˇ ㄇㄠˋ
假設	ㄐㄧㄚˇ ㄕㄜˋ
假定	ㄐㄧㄚˇ ㄉㄧㄥˋ
價位	ㄐㄧㄚˋ ㄨㄟˋ
假裝	ㄐㄧㄚˇ ㄓㄨㄤ
價值觀	ㄐㄧㄚˋ ㄓˊ ㄍㄨㄢ
假使	ㄐㄧㄚˇ ㄕˇ
駕車	ㄐㄧㄚˋ ㄔㄜ
駕馭	ㄐㄧㄚˋ ㄩˋ
駕	ㄐㄧㄚˋ
架勢	ㄐㄧㄚˋ ㄕ˙
嫁	ㄐㄧㄚˋ
架子	ㄐㄧㄚˋ ㄗ˙
嫁妝	ㄐㄧㄚˋ ㄓㄨㄤ˙
尖端	ㄐㄧㄢ ㄉㄨㄢ
尖銳	ㄐㄧㄢ ㄖㄨㄟˋ
奸詐	ㄐㄧㄢ ㄓㄚˋ
堅持不懈	ㄐㄧㄢ ㄔˊ-ㄅㄨˋ ㄒㄧㄝˋ
堅韌	ㄐㄧㄢ ㄖㄣˋ
殲滅	ㄐㄧㄢ ㄇㄧㄝˋ
堅實	ㄐㄧㄢ ㄕˊ
堅守	ㄐㄧㄢ ㄕㄡˇ
堅信	ㄐㄧㄢ ㄒㄧㄣˋ
堅硬	ㄐㄧㄢ ㄧㄥˋ
肩膀	ㄐㄧㄢ ㄅㄤˇ
肩負	ㄐㄧㄢ ㄈㄨˋ
艱巨	ㄐㄧㄢ ㄐㄩˋ
艱苦奮鬥	ㄐㄧㄢ ㄎㄨˇ-ㄈㄣˋ ㄉㄡˋ
艱險	ㄐㄧㄢ ㄒㄧㄢˇ
艱辛	ㄐㄧㄢ ㄒㄧㄣ
監察	ㄐㄧㄢ ㄔㄚˊ
監管	ㄐㄧㄢ ㄍㄨㄢˇ
監護	ㄐㄧㄢ ㄏㄨˋ
監控	ㄐㄧㄢ ㄎㄨㄥˋ
監視	ㄐㄧㄢ ㄕˋ
監獄	ㄐㄧㄢ ㄩˋ
兼	ㄐㄧㄢ
兼顧	ㄐㄧㄢ ㄍㄨˋ
兼任	ㄐㄧㄢ ㄖㄣˋ
兼容	ㄐㄧㄢ ㄖㄨㄥˊ
兼職	ㄐㄧㄢ ㄓˊ
煎	ㄐㄧㄢ
揀	ㄐㄧㄢˇ
檢察	ㄐㄧㄢˇ ㄔㄚˊ
檢討	ㄐㄧㄢˇ ㄊㄠˇ
減免	ㄐㄧㄢˇ ㄇㄧㄢˇ
減弱	ㄐㄧㄢˇ ㄖㄨㄛˋ
減速	ㄐㄧㄢˇ ㄙㄨˋ
減壓	ㄐㄧㄢˇ ㄧㄚ
簡稱	ㄐㄧㄢˇ ㄔㄥ
簡短	ㄐㄧㄢˇ ㄉㄨㄢˇ
簡化	ㄐㄧㄢˇ ㄏㄨㄚˋ
簡潔	ㄐㄧㄢˇ ㄐㄧㄝˊ
簡陋	ㄐㄧㄢˇ ㄌㄡˋ
簡體字	ㄐㄧㄢˇ ㄊㄧˇ ㄗˋ
簡要	ㄐㄧㄢˇ ㄧㄠˋ
簡易	ㄐㄧㄢˇ ㄧˋ
見錢眼開	ㄐㄧㄢˋ ㄑㄧㄢˊ-ㄧㄢˇ ㄎㄞ
見解	ㄐㄧㄢˋ ㄐㄧㄝˇ
見仁見智	ㄐㄧㄢˋ ㄖㄣˊ-ㄐㄧㄢˋ ㄓˋ
見識	ㄐㄧㄢˋ ㄕ˙
見外	ㄐㄧㄢˋ ㄨㄞˋ
見效	ㄐㄧㄢˋ ㄒㄧㄠˋ
見義勇為	ㄐㄧㄢˋ ㄧˋ-ㄩㄥˇ ㄨㄟˊ
見證	ㄐㄧㄢˋ ㄓㄥˋ
間諜	ㄐㄧㄢˋ ㄉㄧㄝˊ
間斷	ㄐㄧㄢˋ ㄉㄨㄢˋ
間隔	ㄐㄧㄢˋ ㄍㄜˊ
間隙	ㄐㄧㄢˋ ㄒㄧˋ
建交	ㄐㄧㄢˋ ㄐㄧㄠ
建樹	ㄐㄧㄢˋ ㄕㄨˋ
建築師	ㄐㄧㄢˋ ㄓㄨˋ ㄕ
建築物	ㄐㄧㄢˋ ㄓㄨˋ ㄨˋ
健美	ㄐㄧㄢˋ ㄇㄟˇ
賤	ㄐㄧㄢˋ
健壯	ㄐㄧㄢˋ ㄓㄨㄤˋ
濺	ㄐㄧㄢˋ
鑒別	ㄐㄧㄢˋ ㄅㄧㄝˊ
鑒賞	ㄐㄧㄢˋ ㄕㄤˇ
姜	ㄐㄧㄤ
鑒於	ㄐㄧㄢˋ ㄩˊ
僵	ㄐㄧㄤ
僵化	ㄐㄧㄤ ㄏㄨㄚˋ
僵局	ㄐㄧㄤ ㄐㄩˊ
講解	ㄐㄧㄤˇ ㄐㄧㄝˇ
講述	ㄐㄧㄤˇ ㄕㄨˋ
講學	ㄐㄧㄤˇ ㄒㄩㄝˊ
獎杯	ㄐㄧㄤˇ ㄅㄟ
獎牌	ㄐㄧㄤˇ ㄆㄞˊ
獎品	ㄐㄧㄤˇ ㄆㄧㄣˇ
獎項	ㄐㄧㄤˇ ㄒㄧㄤˋ
降臨	ㄐㄧㄤˋ ㄌㄧㄣˊ
交叉	ㄐㄧㄠ ㄔㄚ
交鋒	ㄐㄧㄠ ㄈㄥ
交付	ㄐㄧㄠ ㄈㄨˋ
交集	ㄐㄧㄠ ㄐㄧˊ
交接	ㄐㄧㄠ ㄐㄧㄝ
交界	ㄐㄧㄠ ㄐㄧㄝˋ
交情	ㄐㄧㄠ ㄑㄧㄥ˙
交納	ㄐㄧㄠ ㄋㄚˋ
交涉	ㄐㄧㄠ ㄕㄜˋ
交談	ㄐㄧㄠ ㄊㄢˊ
交替	ㄐㄧㄠ ㄊㄧˋ
交頭接耳	ㄐㄧㄠ ㄊㄡˊ-ㄐㄧㄝ ㄦˇ
交響樂	ㄐㄧㄠ ㄒㄧㄤˇ ㄩㄝˋ
郊遊	ㄐㄧㄠ ㄧㄡˊ
郊外	ㄐㄧㄠ ㄨㄞˋ
澆	ㄐㄧㄠ
嬌慣	ㄐㄧㄠ ㄍㄨㄢˋ
嬌氣	ㄐㄧㄠ ㄑㄧ˙
膠囊	ㄐㄧㄠ ㄋㄤˊ
膠片	ㄐㄧㄠ ㄆㄧㄢˋ
焦	ㄐㄧㄠ
焦距	ㄐㄧㄠ ㄐㄩˋ
焦急	ㄐㄧㄠ ㄐㄧˊ
焦慮	ㄐㄧㄠ ㄌㄩˋ
焦躁	ㄐㄧㄠ ㄗㄠˋ
嚼	ㄐㄩㄝˊ
礁石	ㄐㄧㄠ ㄕˊ
絞	ㄐㄧㄠˇ
狡猾	ㄐㄧㄠˇ ㄏㄨㄚˊ
角落	ㄐㄧㄠˇ ㄌㄨㄛˋ
矯正	ㄐㄧㄠˇ ㄓㄥˋ
攪拌	ㄐㄧㄠˇ ㄅㄢˋ
攪	ㄐㄧㄠˇ
繳	ㄐㄧㄠˇ
繳費	ㄐㄧㄠˇ ㄈㄟˋ
繳納	ㄐㄧㄠˇ ㄋㄚˋ
叫板	ㄐㄧㄠˋ ㄅㄢˇ
叫好	ㄐㄧㄠˋ ㄏㄠˇ
轎車	ㄐㄧㄠˋ ㄔㄜ
較勁	ㄐㄧㄠˋ ㄐㄧㄣˋ
較量	ㄐㄧㄠˋ ㄌㄧㄤˋ
教條	ㄐㄧㄠˋ ㄊㄧㄠˊ
教科書	ㄐㄧㄠˋ ㄎㄜ ㄕㄨ
教養	ㄐㄧㄠˋ ㄧㄤˇ
階層	ㄐㄧㄝ ㄘㄥˊ
階級	ㄐㄧㄝ ㄐㄧˊ
皆	ㄐㄧㄝ
階梯	ㄐㄧㄝ ㄊㄧ
結	ㄐㄧㄝˊ
結果	ㄐㄧㄝ ㄍㄨㄛˇ
接班人	ㄐㄧㄝ ㄅㄢ ㄖㄣˊ
接班	ㄐㄧㄝ ㄅㄢ
接軌	ㄐㄧㄝ ㄍㄨㄟˇ
接二連三	ㄐㄧㄝ ㄦˋ-ㄌㄧㄢˊ ㄙㄢ
接濟	ㄐㄧㄝ ㄐㄧˋ
接見	ㄐㄧㄝ ㄐㄧㄢˋ
接力	ㄐㄧㄝ ㄌㄧˋ
接納	ㄐㄧㄝ ㄋㄚˋ
接手	ㄐㄧㄝ ㄕㄡˇ
接送	ㄐㄧㄝ ㄙㄨㄥˋ
接聽	ㄐㄧㄝ ㄊㄧㄥ
接通	ㄐㄧㄝ ㄊㄨㄥ
揭發	ㄐㄧㄝ ㄈㄚ
接替	ㄐㄧㄝ ㄊㄧˋ
揭露	ㄐㄧㄝ ㄌㄨˋ
揭曉	ㄐㄧㄝ ㄒㄧㄠˇ
揭示	ㄐㄧㄝ ㄕˋ
節儉	ㄐㄧㄝˊ ㄐㄧㄢˇ
節水	ㄐㄧㄝˊ ㄕㄨㄟˇ
節衣縮食	ㄐㄧㄝˊ ㄧ-ㄙㄨㄛ ㄕˊ
節氣	ㄐㄧㄝˊ ㄑㄧ˙
劫	ㄐㄧㄝˊ
劫持	ㄐㄧㄝˊ ㄔˊ
潔淨	ㄐㄧㄝˊ ㄐㄧㄥˋ
結冰	ㄐㄧㄝˊ ㄅㄧㄥ
結晶	ㄐㄧㄝˊ ㄐㄧㄥ
結局	ㄐㄧㄝˊ ㄐㄩˊ
結識	ㄐㄧㄝˊ ㄕˊ
結尾	ㄐㄧㄝˊ ㄨㄟˇ
截	ㄐㄧㄝˊ
截然不同	ㄐㄧㄝˊ ㄖㄢˊ-ㄅㄨˋ ㄊㄨㄥˊ
竭盡全力	ㄐㄧㄝˊ ㄐㄧㄣˋ-ㄑㄩㄢˊ ㄌㄧˋ
竭力	ㄐㄧㄝˊ ㄌㄧˋ
解答	ㄐㄧㄝˇ ㄉㄚˊ
解讀	ㄐㄧㄝˇ ㄉㄨˊ
解救	ㄐㄧㄝˇ ㄐㄧㄡˋ
解剖	ㄐㄧㄝˇ ㄆㄡ
解雇	ㄐㄧㄝˇ ㄍㄨˋ
解散	ㄐㄧㄝˇ ㄙㄢˋ
解脫	ㄐㄧㄝˇ ㄊㄨㄛ
解體	ㄐㄧㄝˇ ㄊㄧˇ
解圍	ㄐㄧㄝˇ ㄨㄟˊ
解析	ㄐㄧㄝˇ ㄒㄧ
介入	ㄐㄧㄝˋ ㄖㄨˋ
介意	ㄐㄧㄝˋ ㄧˋ
戒備	ㄐㄧㄝˋ ㄅㄟˋ
戒煙	ㄐㄧㄝˋ ㄧㄢ
介於	ㄐㄧㄝˋ ㄩˊ
界定	ㄐㄧㄝˋ ㄉㄧㄥˋ
戒指	ㄐㄧㄝˋ ㄓ˙
屆時	ㄐㄧㄝˋ ㄕˊ
界線	ㄐㄧㄝˋ ㄒㄧㄢˋ
藉口	ㄐㄧㄝˋ ㄎㄡˇ
界限	ㄐㄧㄝˋ ㄒㄧㄢˋ
借條	ㄐㄧㄝˋ ㄊㄧㄠˊ
借助	ㄐㄧㄝˋ ㄓㄨˋ
借用	ㄐㄧㄝˋ ㄩㄥˋ
金字塔	ㄐㄧㄣ ㄗˋ ㄊㄚˇ
金屬	ㄐㄧㄣ ㄕㄨˇ
金子	ㄐㄧㄣ ㄗ˙
津貼	ㄐㄧㄣ ㄊㄧㄝ
津津有味	ㄐㄧㄣ ㄐㄧㄣ-ㄧㄡˇ ㄨㄟˋ
筋	ㄐㄧㄣ
禁不住	ㄐㄧㄣ ㄅㄨ˙ ㄓㄨˋ
僅次於	ㄐㄧㄣˇ ㄘˋ ㄩˊ
儘	ㄐㄧㄣˇ
盡早	ㄐㄧㄣˇ ㄗㄠˇ
緊迫	ㄐㄧㄣˇ ㄆㄛˋ
緊接著	ㄐㄧㄣˇ ㄐㄧㄝ ㄓㄜ˙
緊湊	ㄐㄧㄣˇ ㄘㄡˋ
緊缺	ㄐㄧㄣˇ ㄑㄩㄝ
緊縮	ㄐㄧㄣˇ ㄙㄨㄛ
錦旗	ㄐㄧㄣˇ ㄑㄧˊ
盡情	ㄐㄧㄣˋ ㄑㄧㄥˊ
盡頭	ㄐㄧㄣˋ ㄊㄡˊ
謹慎	ㄐㄧㄣˇ ㄕㄣˋ
進程	ㄐㄧㄣˋ ㄔㄥˊ
進場	ㄐㄧㄣˋ ㄔㄤˇ
進出	ㄐㄧㄣˋ ㄔㄨ
進度	ㄐㄧㄣˋ ㄉㄨˋ
進出口	ㄐㄧㄣˋ ㄔㄨ ㄎㄡˇ
進而	ㄐㄧˋ ㄋㄜˊ ㄦ˙
進修	ㄐㄧㄣˋ ㄒㄧㄡ
近年來	ㄐㄧㄣˋ ㄋㄧㄢˊ ㄌㄞˊ
勁頭	ㄐㄧㄣˋ ㄊㄡˊ
晉升	ㄐㄧㄣˋ ㄕㄥ
浸泡	ㄐㄧㄣˋ ㄆㄠˋ
禁忌	ㄐㄧㄣˋ ㄐㄧˋ
禁區	ㄐㄧㄣˋ ㄑㄩ
莖	ㄐㄧㄥ
經	ㄐㄧㄥ
經度	ㄐㄧㄥ ㄉㄨˋ
經久不息	ㄐㄧㄥ ㄐㄧㄡˇ-ㄅㄨˋ ㄒㄧ
經貿	ㄐㄧㄥ ㄇㄠˋ
經商	ㄐㄧㄥ ㄕㄤ
經受	ㄐㄧㄥ ㄕㄡˋ
荊棘	ㄐㄧㄥ ㄐㄧˊ
驚	ㄐㄧㄥ
驚詫	ㄐㄧㄥ ㄔㄚˋ
驚慌	ㄐㄧㄥ ㄏㄨㄤ
驚慌失措	ㄐㄧㄥ ㄏㄨㄤ-ㄕ ㄘㄨㄛˋ
驚奇	ㄐㄧㄥ ㄑㄧˊ
驚嘆	ㄐㄧㄥ ㄊㄢˋ
驚天動地	ㄐㄧㄥ ㄊㄧㄢ-ㄉㄨㄥˋ ㄉㄧˋ
驚險	ㄐㄧㄥ ㄒㄧㄢˇ
驚心動魄	ㄐㄧㄥ ㄒㄧㄣ-ㄉㄨㄥˋ ㄆㄛˋ
驚醒	ㄐㄧㄥ ㄒㄧㄥ˙
驚訝	ㄐㄧㄥ ㄧㄚˋ
晶瑩	ㄐㄧㄥ ㄧㄥˊ
兢兢業業	ㄐㄧㄥ ㄐㄧㄥ-ㄧㄝˋ ㄧㄝˋ
精打細算	ㄐㄧㄥ ㄉㄚˇ-ㄒㄧˋ ㄙㄨㄢˋ
精華	ㄐㄧㄥ ㄏㄨㄚˊ
精簡	ㄐㄧㄥ ㄐㄧㄢˇ
精練	ㄐㄧㄥ ㄌㄧㄢˋ
精妙	ㄐㄧㄥ ㄇㄧㄠˋ
精明	ㄐㄧㄥ ㄇㄧㄥˊ
精疲力竭	ㄐㄧㄥ ㄆㄧˊ-ㄌㄧˋ ㄐㄧㄝˊ
精確	ㄐㄧㄥ ㄑㄩㄝˋ
精神病	ㄐㄧㄥ ㄕㄣˊ ㄅㄧㄥˋ
精髓	ㄐㄧㄥ ㄙㄨㄟˇ
精細	ㄐㄧㄥ ㄒㄧˋ
精通	ㄐㄧㄥ ㄊㄨㄥ
精心	ㄐㄧㄥ ㄒㄧㄣ
精益求精	ㄐㄧㄥ ㄧˋ ㄑㄧㄡˊ ㄐㄧㄥ
精英	ㄐㄧㄥ ㄧㄥ
精緻	ㄐㄧㄥ ㄓˋ
景觀	ㄐㄧㄥˇ ㄍㄨㄢ
頸部	ㄐㄧㄥˇ ㄅㄨˋ
景區	ㄐㄧㄥˇ ㄑㄩ
警車	ㄐㄧㄥˇ ㄔㄜ
警官	ㄐㄧㄥˇ ㄍㄨㄢ
警惕	ㄐㄧㄥˇ ㄊㄧˋ
警鐘	ㄐㄧㄥˇ ㄓㄨㄥ
淨化	ㄐㄧㄥˋ ㄏㄨㄚˋ
競技	ㄐㄧㄥˋ ㄐㄧˋ
競選	ㄐㄧㄥˋ ㄒㄩㄢˇ
競相	ㄐㄧㄥˋ ㄒㄧㄤ
竟敢	ㄐㄧㄥˋ ㄍㄢˇ
竟	ㄐㄧㄥˋ
敬	ㄐㄧㄥˋ
敬愛	ㄐㄧㄣˋ ㄍㄞˋ
敬而遠之	ㄐㄧㄣˋ ㄍㄜˊ ㄦ˙ ㄩㄢˇ ㄓ
敬酒	ㄐㄧㄥˋ ㄐㄧㄡˇ
敬禮	ㄐㄧㄥˋ ㄌㄧˇ
敬佩	ㄐㄧㄥˋ ㄆㄟˋ
敬請	ㄐㄧㄥˋ ㄑㄧㄥˇ
敬業	ㄐㄧㄥˋ ㄧㄝˋ
敬意	ㄐㄧㄥˋ ㄧˋ
敬重	ㄐㄧㄥˋ ㄓㄨㄥˋ
靜止	ㄐㄧㄥˋ ㄓˇ
境地	ㄐㄧㄥˋ ㄉㄧˋ
境界	ㄐㄧㄥˋ ㄐㄧㄝˋ
境內	ㄐㄧㄥˋ ㄋㄟˋ
境外	ㄐㄧㄥˋ ㄨㄞˋ
境遇	ㄐㄧㄥˋ ㄩˋ
窘迫	ㄐㄩㄥˇ ㄆㄛˋ
糾纏	ㄐㄧㄡ ㄔㄢˊ
揪	ㄐㄧㄡ
久違	ㄐㄧㄡˇ ㄨㄟˊ
久仰	ㄐㄧㄡˇ ㄧㄤˇ
酒精	ㄐㄧㄡˇ ㄐㄧㄥ
酒樓	ㄐㄧㄡˇ ㄌㄡˊ
救護車	ㄐㄧㄡˋ ㄏㄨˋ ㄔㄜ
救濟	ㄐㄧㄡˋ ㄐㄧˋ
救治	ㄐㄧㄡˋ ㄓˋ
就餐	ㄐㄧㄡˋ ㄘㄢ
就地	ㄐㄧㄡˋ ㄉㄧˋ
就讀	ㄐㄧㄡˋ ㄉㄨˊ
就近	ㄐㄧㄡˋ ㄐㄧㄣˋ
就任	ㄐㄧㄡˋ ㄖㄣˋ
就醫	ㄐㄧㄡˋ ㄧ
就診	ㄐㄧㄡˋ ㄓㄣˇ
就職	ㄐㄧㄡˋ ㄓˊ
就座	ㄐㄧㄡˋ ㄗㄨㄛˋ
舅舅	ㄐㄧㄡˋ ㄐㄧㄡ˙
拘留	ㄐㄩ ㄌㄧㄡˊ
拘束	ㄐㄩ ㄕㄨˋ
居高臨下	ㄐㄩ ㄍㄠ-ㄌㄧㄣˊ ㄒㄧㄚˋ
居民樓	ㄐㄩ ㄇㄧㄣˊ ㄌㄡˊ
鞠躬	ㄐㄩ ㄍㄨㄥ
局部	ㄐㄩˊ ㄅㄨˋ
局勢	ㄐㄩˊ ㄕˋ
局限	ㄐㄩˊ ㄒㄧㄢˋ
菊花	ㄐㄩˊ ㄏㄨㄚ
橘子	ㄐㄩˊ ㄗ˙
沮喪	ㄐㄩˇ ㄙㄤˋ
舉報	ㄐㄩˇ ㄅㄠˋ
舉措	ㄐㄩˇ ㄘㄨㄛˋ
舉例	ㄐㄩˇ ㄌㄧˋ
舉世聞名	ㄐㄩˇ ㄕˋ-ㄨㄣˊ ㄇㄧㄥˊ
舉世無雙	ㄐㄩˇ ㄕˋ-ㄨˊ ㄕㄨㄤ
舉世矚目	ㄐㄩˇ ㄕˋ-ㄓㄨˇ ㄇㄨˋ
舉一反三	ㄐㄩˇ ㄧ-ㄈㄢˇ ㄙㄢ
舉止	ㄐㄩˇ ㄓˇ
舉重	ㄐㄩˇ ㄓㄨㄥˋ
巨額	ㄐㄩˋ ㄜˊ
巨人	ㄐㄩˋ ㄖㄣˊ
巨頭	ㄐㄩˋ ㄊㄡˊ
巨星	ㄐㄩˋ ㄒㄧㄥ
巨型	ㄐㄩˋ ㄒㄧㄥˊ
劇烈	ㄐㄩˋ ㄌㄧㄝˋ
劇目	ㄐㄩˋ ㄇㄨˋ
劇情	ㄐㄩˋ ㄑㄧㄥˊ
劇團	ㄐㄩˋ ㄊㄨㄢˊ
劇院	ㄐㄩˋ ㄩㄢˋ
據此	ㄐㄩˋ ㄘˇ
劇組	ㄐㄩˋ ㄗㄨˇ
據悉	ㄐㄩˋ ㄒㄧ
距	ㄐㄩˋ
鋸	ㄐㄩˋ
聚集	ㄐㄩˋ ㄐㄧˊ
聚精會神	ㄐㄩˋ ㄐㄧㄥ-ㄏㄨㄟˋ ㄕㄣˊ
捐獻	ㄐㄩㄢ ㄒㄧㄢˋ
捲入	ㄐㄩㄢˇ ㄖㄨˋ
卷子	ㄐㄩㄢˇ ㄗ˙
圈	ㄑㄩㄢ
決議	ㄐㄩㄝˊ ㄧˋ
訣別	ㄐㄩㄝˊ ㄅㄧㄝˊ
訣竅	ㄐㄩㄝˊ ㄑㄧㄠˋ
角逐	ㄐㄩㄝˊ ㄓㄨˊ
覺醒	ㄐㄩㄝˊ ㄒㄧㄥˇ
絕技	ㄐㄩㄝˊ ㄐㄧˋ
絕緣	ㄐㄩㄝˊ ㄩㄢˊ
絕招	ㄐㄩㄝˊ ㄓㄠ
崛起	ㄐㄩㄝˊ ㄑㄧˇ
倔強	ㄐㄩㄝˊ ㄐㄧㄤˋ
倔	ㄐㄩㄝˊ
爵士	ㄐㄩㄝˊ ㄕˋ
軍官	ㄐㄩㄣ ㄍㄨㄢ
均衡	ㄐㄩㄣ ㄏㄥˊ
均勻	ㄐㄩㄣ ㄩㄣˊ
君子	ㄐㄩㄣ ㄗˇ
俊	ㄐㄩㄣˋ
俊俏	ㄐㄩㄣˋ ㄑㄧㄠˋ
駿馬	ㄐㄩㄣˋ ㄇㄚˇ
竣工	ㄐㄩㄣˋ ㄍㄨㄥ
卡車	ㄎㄚˇ ㄔㄜ
卡片	ㄎㄚˇ ㄆㄧㄢˋ
卡通	ㄎㄚˇ ㄊㄨㄥ
開辦	ㄎㄞ ㄅㄢˋ
開采	ㄎㄞ ㄘㄞˇ
開場	ㄎㄞ ㄔㄤˇ
開場白	ㄎㄞ ㄔㄤˇ ㄅㄞˊ
開動	ㄎㄞ ㄉㄨㄥˋ
開除	ㄎㄞ ㄔㄨˊ
開發區	ㄎㄞ ㄈㄚ ㄑㄩ
開發商	ㄎㄞ ㄈㄚ ㄕㄤ
開工	ㄎㄞ ㄍㄨㄥ
開墾	ㄎㄞ ㄎㄣˇ
開口	ㄎㄞ ㄎㄡˇ
開闊	ㄎㄞ ㄎㄨㄛˋ
開朗	ㄎㄞ ㄌㄤˇ
開辟	ㄎㄞ ㄆㄧˋ
開啟	ㄎㄞ ㄑㄧˇ
開槍	ㄎㄞ ㄑㄧㄤ
開天辟地	ㄎㄞ ㄊㄧㄢ-ㄆㄧˋ ㄉㄧˋ
開拓	ㄎㄞ ㄊㄨㄛˋ
開銷	ㄎㄞ ㄒㄧㄠ˙
開張	ㄎㄞ ㄓㄤ
開支	ㄎㄞ ㄓ
凱歌	ㄎㄞˇ ㄍㄜ
楷模	ㄎㄞˇ ㄇㄛˊ
刊登	ㄎㄢ ㄉㄥ
刊物	ㄎㄢ ㄨˋ
勘探	ㄎㄢ ㄊㄢˋ
看護	ㄎㄢ ㄏㄨˋ
堪稱	ㄎㄢ ㄔㄥ
砍	ㄎㄢˇ
侃大山	ㄎㄢˇ ㄉㄚˋ ㄕㄢ
看得出	ㄎㄢˋ ㄉㄜ˙ ㄔㄨ
看似	ㄎㄢˋ ㄙˋ
看熱鬧	ㄎㄢˋ ㄖㄜˋ ㄋㄠ˙
看臺	ㄎㄢˋ ㄊㄞˊ
看樣子	ㄎㄢˋ ㄧㄤˋ ㄗ˙
看中	ㄎㄢˋ ㄓㄨㄥˋ
慷慨	ㄎㄤ ㄎㄞˇ
看重	ㄎㄢˋ ㄓㄨㄥˋ
扛	ㄎㄤˊ
抗衡	ㄎㄤˋ ㄏㄥˊ
抗拒	ㄎㄤˋ ㄐㄩˋ
抗爭	ㄎㄤˋ ㄓㄥ
抗生素	ㄎㄤˋ ㄕㄥ ㄙㄨˋ
考量	ㄎㄠˇ ㄌㄧㄤ˙
烤	ㄎㄠˇ
靠攏	ㄎㄠˋ ㄌㄨㄥˇ
苛刻	ㄎㄜ ㄎㄜˋ
科幻	ㄎㄜ ㄏㄨㄢˋ
科目	ㄎㄜ ㄇㄨˋ
科普	ㄎㄜ ㄆㄨˇ
磕	ㄎㄜ
殼	ㄎㄜˊ
咳嗽	ㄎㄜˊ ㄙㄡ˙
可悲	ㄎㄜˇ ㄅㄟ
可不是	ㄎㄜˇ ㄅㄨ˙ ㄕˋ
可乘之機	ㄎㄜˇ ㄔㄥˊ ㄓ ㄐㄧ
可恥	ㄎㄜˇ ㄔˇ
可歌可泣	ㄎㄜˇ ㄍㄜ-ㄎㄜˇ ㄑㄧˋ
可觀	ㄎㄜˇ ㄍㄨㄢ
可貴	ㄎㄜˇ ㄍㄨㄟˋ
可口	ㄎㄜˇ ㄎㄡˇ
可謂	ㄎㄜˇ ㄨㄟˋ
可惡	ㄎㄜˇ ㄨˋ
可想而知	ㄎㄜˇ ㄒㄧㄢˇ ㄍㄜˊ ㄦ˙ ㄓ
可笑	ㄎㄜˇ ㄒㄧㄠˋ
可信	ㄎㄜˇ ㄒㄧㄣˋ
可行	ㄎㄜˇ ㄒㄧㄥˊ
可疑	ㄎㄜˇ ㄧˊ
克隆	ㄎㄜˋ ㄌㄨㄥˊ
克制	ㄎㄜˋ ㄓˋ
刻意	ㄎㄜˋ ㄧˋ
刻苦	ㄎㄜˋ ㄎㄨˇ
客房	ㄎㄜˋ ㄈㄤˊ
刻舟求劍	ㄎㄜˋ ㄓㄡ-ㄑㄧㄡˊ ㄐㄧㄢˋ
客機	ㄎㄜˋ ㄐㄧ
客流	ㄎㄜˋ ㄌㄧㄡˊ
客運	ㄎㄜˋ ㄩㄣˋ
懇求	ㄎㄣˇ ㄑㄧㄡˊ
啃	ㄎㄣˇ
坑	ㄎㄥ
空難	ㄎㄨㄥ ㄋㄢˋ
空蕩蕩	ㄎㄨㄥ ㄉㄤˋ ㄉㄤˋ
空前	ㄎㄨㄥ ㄑㄧㄢˊ
空想	ㄎㄨㄥ ㄒㄧㄤˇ
空虛	ㄎㄨㄥ ㄒㄩ
恐怖	ㄎㄨㄥˇ ㄅㄨˋ
恐嚇	ㄎㄨㄥˇ ㄏㄜˋ
恐慌	ㄎㄨㄥˇ ㄏㄨㄤ
恐懼	ㄎㄨㄥˇ ㄐㄩˋ
恐龍	ㄎㄨㄥˇ ㄌㄨㄥˊ
空白	ㄎㄨㄥˋ ㄅㄞˊ
空地	ㄎㄨㄥ-ㄉㄧˋ
空隙	ㄎㄨㄥˋ ㄒㄧˋ
控告	ㄎㄨㄥˋ ㄍㄠˋ
摳	ㄎㄡ
口碑	ㄎㄡˇ ㄅㄟ
口才	ㄎㄡˇ ㄘㄞˊ
口吃	ㄎㄡˇ ㄔ
口感	ㄎㄡˇ ㄍㄢˇ
口徑	ㄎㄡˇ ㄐㄧㄥˋ
口令	ㄎㄡˇ ㄌㄧㄥˋ
口腔	ㄎㄡˇ ㄑㄧㄤ
口氣	ㄎㄡˇ ㄑㄧ˙
口哨	ㄎㄡˇ ㄕㄠˋ
口水	ㄎㄡˇ ㄕㄨㄟˇ
口頭	ㄎㄡˇ ㄊㄡ˙
口味	ㄎㄡˇ ㄨㄟˋ
口香糖	ㄎㄡˇ ㄒㄧㄤ ㄊㄤˊ
口音	ㄎㄡˇ ㄧㄣ
口罩	ㄎㄡˇ ㄓㄠˋ
口子	ㄎㄡˇ ㄗ˙
扣除	ㄎㄡˋ ㄔㄨˊ
扣人心弦	ㄎㄡˋ ㄖㄣˊ ㄒㄧㄣ ㄒㄧㄢˊ
扣留	ㄎㄡˋ ㄌㄧㄡˊ
扣押	ㄎㄡˋ ㄧㄚ
枯燥	ㄎㄨ ㄗㄠˋ
哭泣	ㄎㄨ ㄑㄧˋ
哭笑不得	ㄎㄨ ㄒㄧㄠˋ-ㄅㄨˋ ㄉㄜˊ
窟窿	ㄎㄨ ㄌㄨㄥ˙
苦力	ㄎㄨˇ ㄌㄧˋ
苦練	ㄎㄨˇ ㄌㄧㄢˋ
苦難	ㄎㄨˇ ㄋㄢˋ
苦笑	ㄎㄨˇ ㄒㄧㄠˋ
苦惱	ㄎㄨˇ ㄋㄠˇ
苦心	ㄎㄨˇ ㄒㄧㄣ
酷似	ㄎㄨˋ ㄙˋ
誇	ㄎㄨㄚ
誇大	ㄎㄨㄚ ㄉㄚˋ
誇獎	ㄎㄨㄚ ㄐㄧㄤˇ
誇誇其談	ㄎㄨㄚ ㄎㄨㄚ-ㄑㄧˊ ㄊㄢˊ
誇耀	ㄎㄨㄚ ㄧㄠˋ
誇張	ㄎㄨㄚ ㄓㄤ
垮	ㄎㄨㄚˇ
挎	ㄎㄨㄚˋ
跨國	ㄎㄨㄚˋ ㄍㄨㄛˊ
跨越	ㄎㄨㄚˋ ㄩㄝˋ
快捷	ㄎㄨㄞˋ ㄐㄧㄝˊ
寬敞	ㄎㄨㄢ ㄔㄤ˙
寬泛	ㄎㄨㄢ ㄈㄢˋ
寬厚	ㄎㄨㄢ ㄏㄡˋ
寬容	ㄎㄨㄢ ㄖㄨㄥˊ
寬鬆	ㄎㄨㄢ ㄙㄨㄥ˙
款式	ㄎㄨㄢˇ ㄕˋ
寬恕	ㄎㄨㄢ ㄕㄨˋ
款項	ㄎㄨㄢˇ ㄒㄧㄤˋ
筐	ㄎㄨㄤ
狂歡	ㄎㄨㄤˊ ㄏㄨㄢ
狂歡節	ㄎㄨㄤˊ ㄏㄨㄢ ㄐㄧㄝˊ
狂熱	ㄎㄨㄤˊ ㄖㄜˋ
曠課	ㄎㄨㄤˋ ㄎㄜˋ
況且	ㄎㄨㄤˋ ㄑㄧㄝˇ
礦藏	ㄎㄨㄤˋ ㄘㄤˊ
框	ㄎㄨㄤˋ
框架	ㄎㄨㄤˋ ㄐㄧㄚˋ
虧本	ㄎㄨㄟ ㄅㄣˇ
虧損	ㄎㄨㄟ ㄙㄨㄣˇ
昆蟲	ㄎㄨㄣ ㄔㄨㄥˊ
捆	ㄎㄨㄣˇ
困惑	ㄎㄨㄣˋ ㄏㄨㄛˋ
困境	ㄎㄨㄣˋ ㄐㄧㄥˋ
擴	ㄎㄨㄛˋ
擴建	ㄎㄨㄛˋ ㄐㄧㄢˋ
擴散	ㄎㄨㄛˋ ㄙㄢˋ
擴張	ㄎㄨㄛˋ ㄓㄤ
括弧	ㄎㄨㄛˋ ㄏㄨˊ
闊綽	ㄎㄨㄛˋ ㄔㄨㄛˋ
拉動	ㄌㄚ ㄉㄨㄥˋ
拉攏	ㄌㄚ ㄌㄨㄥ˙
拉鎖	ㄌㄚ ㄙㄨㄛˇ
啦啦隊	ㄌㄚ ㄌㄚ ㄉㄨㄟˋ
喇叭	ㄌㄚˇ ㄅㄚ˙
臘月	ㄌㄚˋ ㄩㄝˋ
蠟	ㄌㄚˋ
蠟燭	ㄌㄚˋ ㄓㄨˊ
辣椒	ㄌㄚˋ ㄐㄧㄠ
來賓	ㄌㄞˊ ㄅㄧㄣ
來電	ㄌㄞˊ ㄉㄧㄢˋ
來訪	ㄌㄞˊ ㄈㄤˇ
來回	ㄌㄞˊ ㄏㄨㄟˊ
來歷	ㄌㄞˊ ㄌㄧˋ
來臨	ㄌㄞˊ ㄌㄧㄣˊ
來龍去脈	ㄌㄞˊ ㄌㄨㄥˊ-ㄑㄩˋ ㄇㄞˋ
來年	ㄌㄞˊ ㄋㄧㄢˊ
來源於	ㄌㄞˊ ㄩㄢˊ ㄩˊ
攔	ㄌㄢˊ
欄	ㄌㄢˊ
欄杆	ㄌㄢˊ ㄍㄢ
藍圖	ㄌㄢˊ ㄊㄨˊ
攬	ㄌㄢˇ
纜車	ㄌㄢˇ ㄔㄜ
懶得	ㄌㄢˇ ㄉㄜ˙
懶惰	ㄌㄢˇ ㄉㄨㄛˋ
濫用	ㄌㄢˋ ㄩㄥˋ
狼	ㄌㄤˊ
狼狽	ㄌㄤˊ ㄅㄟˋ
朗誦	ㄌㄤˇ ㄙㄨㄥˋ
浪	ㄌㄤˋ
撈	ㄌㄠ
勞動力	ㄌㄠˊ ㄉㄨㄥˋ ㄌㄧˋ
勞累	ㄌㄠˊ ㄌㄟˋ
勞務	ㄌㄠˊ ㄨˋ
牢固	ㄌㄠˊ ㄍㄨˋ
牢牢	ㄌㄠˊ ㄌㄠˊ
嘮叨	ㄌㄠˊ ㄉㄠ˙
牢記	ㄌㄠˊ ㄐㄧˋ
老伴兒	ㄌㄠˇ ㄅㄢˋ ㄦ˙
老大	ㄌㄠˇ ㄉㄚˋ
老漢	ㄌㄠˇ ㄏㄢˋ
老化	ㄌㄠˇ ㄏㄨㄚˋ
老人家	ㄌㄠˇ ㄖㄣ˙ ㄐㄧㄚ˙
老實說	ㄌㄠˇ ㄕˊ ㄕㄨㄛ
老遠	ㄌㄠˇ ㄩㄢˇ
老字號	ㄌㄠˇ ㄗˋ ㄏㄠ˙
姥姥	ㄌㄠˇ ㄌㄠ˙
姥爺	ㄌㄠˇ ㄧㄝ˙
澇	ㄌㄠˋ
樂意	ㄌㄜˋ ㄧˋ
樂園	ㄌㄜˋ ㄩㄢˊ
勒	ㄌㄟ
雷同	ㄌㄟˊ ㄊㄨㄥˊ
累積	ㄌㄟˇ ㄐㄧ
累計	ㄌㄟˇ ㄐㄧˋ
類別	ㄌㄟˋ ㄅㄧㄝˊ
棱角	ㄌㄥˊ ㄐㄧㄠˇ
冷淡	ㄌㄥˇ ㄉㄢˋ
冷凍	ㄌㄥˇ ㄉㄨㄥˋ
冷酷	ㄌㄥˇ ㄎㄨˋ
冷酷無情	ㄌㄥˇ ㄎㄨˋ-ㄨˊ ㄑㄧㄥˊ
冷落	ㄌㄥˇ ㄌㄨㄛˋ
冷門	ㄌㄥˇ ㄇㄣˊ
冷漠	ㄌㄥˇ ㄇㄛˋ
冷戰	ㄌㄥˇ ㄓㄢ˙
冷笑	ㄌㄥˇ ㄒㄧㄠˋ
離譜兒	ㄌㄧˊ ㄆㄨˇ ㄦ˙
愣	ㄌㄥˋ
離奇	ㄌㄧˊ ㄑㄧˊ
離職	ㄌㄧˊ ㄓˊ
黎明	ㄌㄧˊ ㄇㄧㄥˊ
禮服	ㄌㄧˇ ㄈㄨˊ
禮品	ㄌㄧˇ ㄆㄧㄣˇ
禮儀	ㄌㄧˇ ㄧˊ
里程碑	ㄌㄧˇ ㄔㄥˊ ㄅㄟ
理睬	ㄌㄧˇ ㄘㄞˇ
理會	ㄌㄧˇ ㄏㄨㄟˋ
理科	ㄌㄧˇ ㄎㄜ
理念	ㄌㄧˇ ㄋㄧㄢˋ
理事	ㄌㄧˇ ㄕˋ
理所當然	ㄌㄧˇ ㄙㄨㄛˇ ㄉㄤ ㄖㄢˊ
理性	ㄌㄧˇ ㄒㄧㄥˋ
理直氣壯	ㄌㄧˇ ㄓˊ-ㄑㄧˋ ㄓㄨㄤˋ
力不從心	ㄌㄧˋ ㄅㄨˋ ㄘㄨㄥˊ ㄒㄧㄣ
力求	ㄌㄧˋ ㄑㄧㄡˊ
力度	ㄌㄧˋ ㄉㄨˋ
力所能及	ㄌㄧˋ ㄙㄨㄛˇ ㄋㄥˊ ㄐㄧˊ
力爭	ㄌㄧˋ ㄓㄥ
歷屆	ㄌㄧˋ ㄐㄧㄝˋ
歷程	ㄌㄧˋ ㄔㄥˊ
歷經	ㄌㄧˋ ㄐㄧㄥ
歷來	ㄌㄧˋ ㄌㄞˊ
立方米	ㄌㄧˋ ㄈㄤ ㄇㄧˇ
立方	ㄌㄧˋ ㄈㄤ
立功	ㄌㄧˋ ㄍㄨㄥ
歷時	ㄌㄧˋ ㄕˊ
立交橋	ㄌㄧˋ ㄐㄧㄠ ㄑㄧㄠˊ
立足	ㄌㄧˋ ㄗㄨˊ
立體	ㄌㄧˋ ㄊㄧˇ
利率	ㄌㄧˋ ㄌㄩˋ
勵志	ㄌㄧˋ ㄓˋ
粒	ㄌㄧˋ
利害	ㄌㄧˋ ㄏㄞ˙
連綿	ㄌㄧㄢˊ ㄇㄧㄢˊ
連滾帶爬	ㄌㄧㄢˊ ㄍㄨㄣˇ ㄉㄞˋ ㄆㄚˊ
利索	ㄌㄧˋ ㄙㄨㄛ˙
連鎖	ㄌㄧㄢˊ ㄙㄨㄛˇ
連任	ㄌㄧㄢˊ ㄖㄣˋ
連鎖店	ㄌㄧㄢˊ ㄙㄨㄛˇ ㄉㄧㄢˋ
憐惜	ㄌㄧㄢˊ ㄒㄧ
簾子	ㄌㄧㄢˊ ㄗ˙
連夜	ㄌㄧㄢˊ ㄧㄝˋ
蓮子	ㄌㄧㄢˊ ㄗˇ
聯邦	ㄌㄧㄢˊ ㄅㄤ
聯歡	ㄌㄧㄢˊ ㄏㄨㄢ
聯網	ㄌㄧㄢˊ ㄨㄤˇ
廉價	ㄌㄧㄢˊ ㄐㄧㄚˋ
廉正	ㄌㄧㄢˊ ㄓㄥˋ
廉潔	ㄌㄧㄢˊ ㄐㄧㄝˊ
廉政	ㄌㄧㄢˊ ㄓㄥˋ
煉	ㄌㄧㄢˋ
臉頰	ㄌㄧㄢˇ ㄐㄧㄚˊ
戀戀不捨	ㄌㄧㄢˋ ㄌㄧㄢˋ-ㄅㄨˋ ㄕㄜˇ
良	ㄌㄧㄤˊ
良心	ㄌㄧㄤˊ ㄒㄧㄣ
良性	ㄌㄧㄤˊ ㄒㄧㄥˋ
涼爽	ㄌㄧㄤˊ ㄕㄨㄤˇ
兩口子	ㄌㄧㄤˇ ㄎㄡˇ ㄗ˙
兩棲	ㄌㄧㄤˇ ㄑㄧ
亮點	ㄌㄧㄤˋ ㄉㄧㄢˇ
亮麗	ㄌㄧㄤˋ ㄌㄧˋ
亮相	ㄌㄧㄤˋ ㄒㄧㄤˋ
遼闊	ㄌㄧㄠˊ ㄎㄨㄛˋ
諒解	ㄌㄧㄤˋ ㄐㄧㄝˇ
療法	ㄌㄧㄠˊ ㄈㄚˇ
療效	ㄌㄧㄠˊ ㄒㄧㄠˋ
潦草	ㄌㄧㄠˊ ㄘㄠˇ
寥寥無幾	ㄌㄧㄠˊ ㄌㄧㄠˊ-ㄨˊ ㄐㄧˇ
了卻	ㄌㄧㄠˇ ㄑㄩㄝˋ
料到	ㄌㄧㄠˋ ㄉㄠˋ
了結	ㄌㄧㄠˇ ㄐㄧㄝˊ
咧嘴	ㄌㄧㄝˇ ㄗㄨㄟˇ
料理	ㄌㄧㄠˋ ㄌㄧˇ
列舉	ㄌㄧㄝˋ ㄐㄩˇ
劣勢	ㄌㄧㄝˋ ㄕˋ
劣質	ㄌㄧㄝˋ ㄓˋ
獵犬	ㄌㄧㄝˋ ㄑㄩㄢˇ
獵人	ㄌㄧㄝˋ ㄖㄣˊ
烈士	ㄌㄧㄝˋ ㄕˋ
裂縫	ㄌㄧㄝˋ ㄈㄥˋ
裂痕	ㄌㄧㄝˋ ㄏㄣˊ
鄰國	ㄌㄧㄣˊ ㄍㄨㄛˊ
臨	ㄌㄧㄣˊ
臨街	ㄌㄧㄣˊ ㄐㄧㄝ
臨近	ㄌㄧㄣˊ ㄐㄧㄣˋ
臨床	ㄌㄧㄣˊ ㄔㄨㄤˊ
靈	ㄌㄧㄥˊ
拎	ㄌㄧㄣ
淋	ㄌㄧㄣˊ
靈感	ㄌㄧㄥˊ ㄍㄢˇ
靈魂	ㄌㄧㄥˊ ㄏㄨㄣˊ
靈機一動	ㄌㄧㄥˊ ㄐㄧ ㄧ ㄉㄨㄥˋ
靈敏	ㄌㄧㄥˊ ㄇㄧㄣˇ
靈巧	ㄌㄧㄥˊ ㄑㄧㄠˇ
凌晨	ㄌㄧㄥˊ ㄔㄣˊ
零花錢	ㄌㄧㄥˊ ㄏㄨㄚ ㄑㄧㄢˊ
零件	ㄌㄧㄥˊ ㄐㄧㄢˋ
零錢	ㄌㄧㄥˊ ㄑㄧㄢˊ
零售	ㄌㄧㄥˊ ㄕㄡˋ
靈通	ㄌㄧㄥˊ ㄊㄨㄥ
領會	ㄌㄧㄥˇ ㄏㄨㄟˋ
領軍	ㄌㄧㄥˇ ㄐㄩㄣ
領略	ㄌㄧㄥˇ ㄌㄩㄝˋ
領事	ㄌㄧㄥˇ ㄕˋ
領事館	ㄌㄧㄥˇ ㄕˋ ㄍㄨㄢˇ
領隊	ㄌㄧㄥˇ ㄉㄨㄟˋ
領土	ㄌㄧㄥˇ ㄊㄨˇ
領悟	ㄌㄧㄥˇ ㄨˋ
領養	ㄌㄧㄥˇ ㄧㄤˇ
溜達	ㄌㄧㄡ ㄉㄚ˙
領域	ㄌㄧㄥˇ ㄩˋ
瀏覽器	ㄌㄧㄡˊ ㄌㄢˇ ㄑㄧˋ
留戀	ㄌㄧㄡˊ ㄌㄧㄢˋ
溜	ㄌㄧㄡ
瀏覽	ㄌㄧㄡˊ ㄌㄢˇ
留念	ㄌㄧㄡˊ ㄋㄧㄢˋ
留心	ㄌㄧㄡˊ ㄒㄧㄣ
留神	ㄌㄧㄡˊ ㄕㄣˊ
留意	ㄌㄧㄡˊ ㄧˋ
流暢	ㄌㄧㄡˊ ㄔㄤˋ
流程	ㄌㄧㄡˊ ㄔㄥˊ
流浪	ㄌㄧㄡˊ ㄌㄤˋ
流淚	ㄌㄧㄡˊ ㄌㄟˋ
流量	ㄌㄧㄡˊ ㄌㄧㄤˋ
流露	ㄌㄧㄡˊ ㄌㄨˋ
流氓	ㄌㄧㄡˊ ㄇㄤˊ
流入	ㄌㄧㄡˊ ㄖㄨˋ
流失	ㄌㄧㄡˊ ㄕ
流水	ㄌㄧㄡˊ ㄕㄨㄟˇ
流向	ㄌㄧㄡˊ ㄒㄧㄤˋ
流淌	ㄌㄧㄡˊ ㄊㄤˇ
流血	ㄌㄧㄡˊ ㄒㄩㄝˋ
流轉	ㄌㄧㄡˊ ㄓㄨㄢˇ
柳樹	ㄌㄧㄡˇ ㄕㄨˋ
遛	ㄌㄧㄡˋ
流域	ㄌㄧㄡˊ ㄩˋ
龍舟	ㄌㄨㄥˊ ㄓㄡ
聾人	ㄌㄨㄥˊ ㄖㄣˊ
籠子	ㄌㄨㄥˊ ㄗ˙
聾	ㄌㄨㄥˊ
隆重	ㄌㄨㄥˊ ㄓㄨㄥˋ
壟斷	ㄌㄨㄥˇ ㄉㄨㄢˋ
籠罩	ㄌㄨㄥˇ ㄓㄠˋ
籠統	ㄌㄨㄥˇ ㄊㄨㄥˇ
摟	ㄌㄡˇ
露面	ㄌㄡˋ ㄇㄧㄢˋ
蘆花	ㄌㄨˊ ㄏㄨㄚ
爐灶	ㄌㄨˊ ㄗㄠˋ
鹵味	ㄌㄨˇ ㄨㄟˋ
魯莽	ㄌㄨˇ ㄇㄤˇ
爐子	ㄌㄨˊ ㄗ˙
錄製	ㄌㄨˋ ㄓˋ
路程	ㄌㄨˋ ㄔㄥˊ
鹿	ㄌㄨˋ
路段	ㄌㄨˋ ㄉㄨㄢˋ
路況	ㄌㄨˋ ㄎㄨㄤˋ
路面	ㄌㄨˋ ㄇㄧㄢˋ
路人	ㄌㄨˋ ㄖㄣˊ
路燈	ㄌㄨˋ ㄉㄥ
路途	ㄌㄨˋ ㄊㄨˊ
露天	ㄌㄨˋ ㄊㄧㄢ
旅程	ㄌㄩˇ ㄔㄥˊ
旅途	ㄌㄩˇ ㄊㄨˊ
路子	ㄌㄨˋ ㄗ˙
鋁	ㄌㄩˇ
屢次	ㄌㄩˇ ㄘˋ
縷	ㄌㄩˇ
屢	ㄌㄩˇ
履行	ㄌㄩˇ ㄒㄧㄥˊ
率	ㄌㄩˋ
綠燈	ㄌㄩˋ ㄉㄥ
孿生	ㄌㄨㄢˊ ㄕㄥ
綠地	ㄌㄩˋ ㄉㄧˋ
卵	ㄌㄨㄢˇ
掠奪	ㄌㄩㄝˋ ㄉㄨㄛˊ
亂七八糟	ㄌㄨㄢˋ ㄑㄧ ㄅㄚ ㄗㄠ
略微	ㄌㄩㄝˋ ㄨㄟ
掄	ㄌㄨㄣ
略	ㄌㄩㄝˋ
倫理	ㄌㄨㄣˊ ㄌㄧˇ
輪換	ㄌㄨㄣˊ ㄏㄨㄢˋ
輪流	ㄌㄨㄣˊ ㄌㄧㄡˊ
輪胎	ㄌㄨㄣˊ ㄊㄞ
輪廓	ㄌㄨㄣˊ ㄎㄨㄛˋ
論壇	ㄌㄨㄣˋ ㄊㄢˊ
論證	ㄌㄨㄣˋ ㄓㄥˋ
羅	ㄌㄨㄛˊ
論述	ㄌㄨㄣˋ ㄕㄨˋ
蘿卜	ㄌㄨㄛˊ ㄅㄛ˙
螺絲	ㄌㄨㄛˊ ㄙ
絡繹不絕	ㄌㄨㄛˋ ㄧˋ-ㄅㄨˋ ㄐㄩㄝˊ
裸露	ㄌㄨㄛˇ ㄌㄨˋ
落差	ㄌㄨㄛˋ ㄔㄚ
落地	ㄌㄨㄛˋ ㄉㄧˋ
裸	ㄌㄨㄛˇ
落戶	ㄌㄨㄛˋ ㄏㄨˋ
落下	ㄌㄨㄛˋ ㄒㄧㄚˋ
麻	ㄇㄚˊ
麻痹	ㄇㄚˊ ㄅㄧˋ
麻木	ㄇㄚˊ ㄇㄨˋ
麻將	ㄇㄚˊ ㄐㄧㄤˋ
馬後炮	ㄇㄚˇ ㄏㄡˋ ㄆㄠˋ
麻醉	ㄇㄚˊ ㄗㄨㄟˋ
馬力	ㄇㄚˇ ㄌㄧˋ
麻辣	ㄇㄚˊ ㄌㄚˋ
馬桶	ㄇㄚˇ ㄊㄨㄥˇ
馬戲	ㄇㄚˇ ㄒㄧˋ
馬虎	ㄇㄚˇ ㄏㄨ˙
埋藏	ㄇㄞˊ ㄘㄤˊ
碼	ㄇㄚˇ
埋伏	ㄇㄞˊ ㄈㄨ˙
埋沒	ㄇㄞˊ ㄇㄛˋ
邁	ㄇㄞˋ
買不起	ㄇㄞˇ ㄅㄨ˙ ㄑㄧˇ
邁進	ㄇㄞˋ ㄐㄧㄣˋ
脈搏	ㄇㄞˋ ㄅㄛˊ
賣弄	ㄇㄞˋ ㄋㄨㄥ˙
脈絡	ㄇㄞˋ ㄌㄨㄛˋ
埋怨	ㄇㄢˊ ㄩㄢˋ
瞞	ㄇㄢˊ
蠻	ㄇㄢˊ
滿懷	ㄇㄢˇ ㄏㄨㄞˊ
漫	ㄇㄢˋ
蔓延	ㄇㄢˋ ㄧㄢˊ
漫遊	ㄇㄢˋ ㄧㄡˊ
忙碌	ㄇㄤˊ ㄌㄨˋ
慢慢來	ㄇㄢˋ ㄇㄢˋ ㄌㄞˊ
忙亂	ㄇㄤˊ ㄌㄨㄢˋ
慢性	ㄇㄢˋ ㄒㄧㄥˋ
忙活	ㄇㄤˊ ㄏㄨㄛ˙
盲目	ㄇㄤˊ ㄇㄨˋ
茫然	ㄇㄤˊ ㄖㄢˊ
茅臺	ㄇㄠˊ ㄊㄞˊ
茂密	ㄇㄠˋ ㄇㄧˋ
矛頭	ㄇㄠˊ ㄊㄡˊ
茂盛	ㄇㄠˋ ㄕㄥˋ
冒犯	ㄇㄠˋ ㄈㄢˋ
冒充	ㄇㄠˋ ㄔㄨㄥ
冒昧	ㄇㄠˋ ㄇㄟˋ
冒險	ㄇㄠˋ ㄒㄧㄢˇ
沒說的	ㄇㄟˊ ㄕㄨㄛ ㄉㄜ˙
沒勁	ㄇㄟˊ ㄐㄧㄣˋ
沒轍	ㄇㄟˊ ㄓㄜˊ
沒完沒了	ㄇㄟˊ ㄨㄢˊ-ㄇㄟˊ ㄌㄧㄠˇ
玫瑰	ㄇㄟˊ ㄍㄨㄟ˙
沒意思	ㄇㄟˊ ㄧˋ ㄙ˙
沒準兒	ㄇㄟˊ ㄓㄨㄣˇ ㄦ˙
眉開眼笑	ㄇㄟˊ ㄎㄞ-ㄧㄢˇ ㄒㄧㄠˋ
枚	ㄇㄟˊ
眉毛	ㄇㄟˊ ㄇㄠ˙
煤礦	ㄇㄟˊ ㄎㄨㄤˋ
每當	ㄇㄟˇ ㄉㄤ
每逢	ㄇㄟˇ ㄈㄥˊ
煤炭	ㄇㄟˊ ㄊㄢˋ
美觀	ㄇㄟˇ ㄍㄨㄢ
美德	ㄇㄟˇ ㄉㄜˊ
美化	ㄇㄟˇ ㄏㄨㄚˋ
美景	ㄇㄟˇ ㄐㄧㄥˇ
美滿	ㄇㄟˇ ㄇㄢˇ
美人	ㄇㄟˇ ㄖㄣˊ
美妙	ㄇㄟˇ ㄇㄧㄠˋ
美中不足	ㄇㄟˇ ㄓㄨㄥ-ㄅㄨˋ ㄗㄨˊ
美味	ㄇㄟˇ ㄨㄟˋ
美滋滋	ㄇㄟˇ ㄗ ㄗ
魅力	ㄇㄟˋ ㄌㄧˋ
門當戶對	ㄇㄣˊ ㄉㄤ-ㄏㄨˋ ㄉㄨㄟˋ
門檻	ㄇㄣˊ ㄎㄢˇ
門鈴	ㄇㄣˊ ㄌㄧㄥˊ
悶	ㄇㄣˋ
門路	ㄇㄣˊ ㄌㄨ˙
萌發	ㄇㄥˊ ㄈㄚ
盟友	ㄇㄥˊ ㄧㄡˇ
萌芽	ㄇㄥˊ ㄧㄚˊ
朦朧	ㄇㄥˊ ㄌㄨㄥˊ
猛然	ㄇㄥˇ ㄖㄢˊ
夢幻	ㄇㄥˋ ㄏㄨㄢˋ
猛烈	ㄇㄥˇ ㄌㄧㄝˋ
彌漫	ㄇㄧˊ ㄇㄢˋ
迷惑	ㄇㄧˊ ㄏㄨㄛ˙
迷惑不解	ㄇㄧˊ ㄏㄨㄛˋ ㄅㄨˋ ㄐㄧㄝˇ
彌補	ㄇㄧˊ ㄅㄨˇ
迷戀	ㄇㄧˊ ㄌㄧㄢˋ
迷路	ㄇㄧˊ ㄌㄨˋ
迷失	ㄇㄧˊ ㄕ
謎	ㄇㄟˋ
謎底	ㄇㄧˊ ㄉㄧˇ
謎團	ㄇㄧˊ ㄊㄨㄢˊ
祕方	ㄇㄧˋ ㄈㄤ
謎語	ㄇㄧˊ ㄩˇ
祕訣	ㄇㄧˋ ㄐㄩㄝˊ
密封	ㄇㄧˋ ㄈㄥ
密不可分	ㄇㄧˋ ㄅㄨˋ ㄎㄜˇ ㄈㄣ
密度	ㄇㄧˋ ㄉㄨˋ
蜜蜂	ㄇㄧˋ ㄈㄥ
蜜	ㄇㄧˋ
密集	ㄇㄧˋ ㄐㄧˊ
蜜月	ㄇㄧˋ ㄩㄝˋ
棉花	ㄇㄧㄢˊ ㄏㄨㄚ˙
免	ㄇㄧㄢˇ
免不了	ㄇㄧㄢˇ ㄅㄨ˙ ㄌㄧㄠˇ
免除	ㄇㄧㄢˇ ㄔㄨˊ
免疫	ㄇㄧㄢˇ ㄧˋ
免職	ㄇㄧㄢˇ ㄓˊ
勉強	ㄇㄧㄢˇ ㄑㄧㄤˇ
緬懷	ㄇㄧㄢˇ ㄏㄨㄞˊ
麵粉	ㄇㄧㄢˋ ㄈㄣˇ
面部	ㄇㄧㄢˋ ㄅㄨˋ
面紅耳赤	ㄇㄧㄢˋ ㄏㄨㄥˊ-ㄦˇ ㄔˋ
面面俱到	ㄇㄧㄢˋ ㄇㄧㄢˋ-ㄐㄩˋ ㄉㄠˋ
苗條	ㄇㄧㄠˊ ㄊㄧㄠ˙
面目全非	ㄇㄧㄢˋ ㄇㄨˋ-ㄑㄩㄢˊ ㄈㄟ
苗頭	ㄇㄧㄠˊ ㄊㄡ˙
苗	ㄇㄧㄠˊ
描繪	ㄇㄧㄠˊ ㄏㄨㄟˋ
瞄準	ㄇㄧㄠˊ ㄓㄨㄣˇ
廟	ㄇㄧㄠˋ
渺小	ㄇㄧㄠˇ ㄒㄧㄠˇ
廟會	ㄇㄧㄠˋ ㄏㄨㄟˋ
滅亡	ㄇㄧㄝˋ ㄨㄤˊ
滅絕	ㄇㄧㄝˋ ㄐㄩㄝˊ
民辦	ㄇㄧㄣˊ ㄅㄢˋ
民俗	ㄇㄧㄣˊ ㄙㄨˊ
民用	ㄇㄧㄣˊ ㄩㄥˋ
民眾	ㄇㄧㄣˊ ㄓㄨㄥˋ
敏捷	ㄇㄧㄣˇ ㄐㄧㄝˊ
名副其實	ㄇㄧㄥˊ ㄈㄨˋ ㄑㄧˊ ㄕˊ
名貴	ㄇㄧㄥˊ ㄍㄨㄟˋ
敏銳	ㄇㄧㄣˇ ㄖㄨㄟˋ
名利	ㄇㄧㄥˊ ㄌㄧˋ
名聲	ㄇㄧㄥˊ ㄕㄥ
名言	ㄇㄧㄥˊ ㄧㄢˊ
名氣	ㄇㄧㄥˊ ㄑㄧ˙
明朗	ㄇㄧㄥˊ ㄌㄤˇ
明媚	ㄇㄧㄥˊ ㄇㄟˋ
名著	ㄇㄧㄥˊ ㄓㄨˋ
銘記	ㄇㄧㄥˊ ㄐㄧˋ
明智	ㄇㄧㄥˊ ㄓˋ
命	ㄇㄧㄥˋ
命名	ㄇㄧㄥˋ ㄇㄧㄥˊ
命題	ㄇㄧㄥˋ ㄊㄧˊ
摸索	ㄇㄛ ㄙㄨㄛ˙
模擬	ㄇㄛˊ ㄋㄧˇ
磨難	ㄇㄛˊ ㄋㄢˋ
磨損	ㄇㄛˊ ㄙㄨㄣˇ
磨合	ㄇㄛˊ ㄏㄜˊ
蘑菇	ㄇㄛˊ ㄍㄨ˙
魔鬼	ㄇㄛˊ ㄍㄨㄟˇ
魔術	ㄇㄛˊ ㄕㄨˋ
抹	ㄇㄛˇ
沒落	ㄇㄛˋ ㄌㄨㄛˋ
末日	ㄇㄛˋ ㄖˋ
陌生	ㄇㄛˋ ㄕㄥ
莫非	ㄇㄛˋ ㄈㄟ
莫過於	ㄇㄛˋ ㄍㄨㄛˋ ㄩˊ
莫名其妙	ㄇㄛˋ ㄇㄧㄥˊ-ㄑㄧˊ ㄇㄧㄠˋ
漠然	ㄇㄛˋ ㄖㄢˊ
墨	ㄇㄛˋ
默讀	ㄇㄛˋ ㄉㄨˊ
默默無聞	ㄇㄛˋ ㄇㄛˋ-ㄨˊ ㄨㄣˊ
謀害	ㄇㄡˊ ㄏㄞˋ
謀求	ㄇㄡˊ ㄑㄧㄡˊ
默契	ㄇㄛˋ ㄑㄧˋ
謀生	ㄇㄡˊ ㄕㄥ
畝	ㄇㄨˇ
牡丹	ㄇㄨˇ ㄉㄢ˙
木板	ㄇㄨˋ ㄅㄢˇ
木材	ㄇㄨˋ ㄘㄞˊ
木匠	ㄇㄨˋ ㄐㄧㄤ˙
目不轉睛	ㄇㄨˋ ㄅㄨˋ ㄓㄨㄢˇ ㄐㄧㄥ
木偶	ㄇㄨˋ ㄡˇ
目瞪口呆	ㄇㄨˋ ㄉㄥˋ-ㄎㄡˇ ㄉㄞ
目睹	ㄇㄨˋ ㄉㄨˇ
目的地	ㄇㄨˋ ㄉㄧˋ ㄉㄧˋ
目錄	ㄇㄨˋ ㄌㄨˋ
目中無人	ㄇㄨˋ ㄓㄨㄥ-ㄨˊ ㄖㄣˊ
沐浴露	ㄇㄨˋ ㄩˋ ㄌㄨˋ
牧場	ㄇㄨˋ ㄔㄤˇ
募捐	ㄇㄨˋ ㄐㄩㄢ
牧民	ㄇㄨˋ ㄇㄧㄣˊ
墓地	ㄇㄨˋ ㄉㄧˋ
墓碑	ㄇㄨˋ ㄅㄟ
穆斯林	ㄇㄨˋ ㄙ ㄌㄧㄣˊ
拿手	ㄋㄚˊ ㄕㄡˇ
幕後	ㄇㄨˋ ㄏㄡˋ
幕	ㄇㄨˋ
吶喊	ㄋㄚˋ ㄏㄢˇ
納悶兒	ㄋㄚˋ ㄇㄣˋ ㄦ˙
哪知道	ㄋㄚˇ ㄓ ㄉㄠˋ
納稅	ㄋㄚˋ ㄕㄨㄟˋ
納入	ㄋㄚˋ ㄖㄨˋ
納稅人	ㄋㄚˋ ㄕㄨㄟˋ ㄖㄣˊ
乃至	ㄋㄞˇ ㄓˋ
耐	ㄋㄞˋ
耐人尋味	ㄋㄞˋ ㄖㄣˊ ㄒㄩㄣˊ ㄨㄟˋ
乃	ㄋㄞˇ
耐性	ㄋㄞˋ ㄒㄧㄥˋ
難處	ㄋㄢˊ ㄔㄨ˙
南瓜	ㄋㄢˊ ㄍㄨㄚ˙
難得一見	ㄋㄢˊ ㄉㄜˊ ㄧ ㄐㄧㄢˋ
難怪	ㄋㄢˊ ㄍㄨㄞˋ
難點	ㄋㄢˊ ㄉㄧㄢˇ
難堪	ㄋㄢˊ ㄎㄢ
難關	ㄋㄢˊ ㄍㄨㄢ
難為情	ㄋㄢˊ ㄨㄟˊ ㄑㄧㄥˊ
難以想象	ㄋㄢˊ ㄧˇ ㄒㄧㄤˇ ㄒㄧㄤˋ
難說	ㄋㄢˊ ㄕㄨㄛ
撓	ㄋㄠˊ
難以置信	ㄋㄢˊ ㄧˇ ㄓˋ ㄒㄧㄣˋ
惱羞成怒	ㄋㄠˇ ㄒㄧㄡ-ㄔㄥˊ ㄋㄨˋ
腦海	ㄋㄠˇ ㄏㄞˇ
鬧事	ㄋㄠˋ ㄕˋ
腦筋	ㄋㄠˇ ㄐㄧㄣ
鬧著玩兒	ㄋㄠˋ ㄓㄜ˙ ㄨㄢˊ ㄦ˙
內閣	ㄋㄟˋ ㄍㄜˊ
內存	ㄋㄟˋ ㄘㄨㄣˊ
內行	ㄋㄟˋ ㄏㄤˊ
內涵	ㄋㄟˋ ㄏㄢˊ
內幕	ㄋㄟˋ ㄇㄨˋ
內向	ㄋㄟˋ ㄒㄧㄤˋ
嫩	ㄋㄣˋ
內需	ㄋㄟˋ ㄒㄩ
能耗	ㄋㄥˊ ㄏㄠˋ
能人	ㄋㄥˊ ㄖㄣˊ
能源	ㄋㄥˊ ㄩㄢˊ
能耐	ㄋㄥˊ ㄋㄞ˙
泥潭	ㄋㄧˊ ㄊㄢˊ
尼龍	ㄋㄧˊ ㄌㄨㄥˊ
泥土	ㄋㄧˊ ㄊㄨˇ
擬定	ㄋㄧˇ ㄉㄧㄥˋ
擬	ㄋㄧˇ
匿名	ㄋㄧˋ ㄇㄧㄥˊ
逆	ㄋㄧˋ
年畫	ㄋㄧㄢˊ ㄏㄨㄚˋ
年限	ㄋㄧㄢˊ ㄒㄧㄢˋ
年薪	ㄋㄧㄢˊ ㄒㄧㄣ
年夜飯	ㄋㄧㄢˊ ㄧㄝˋ ㄈㄢˋ
年邁	ㄋㄧㄢˊ ㄇㄞˋ
年終	ㄋㄧㄢˊ ㄓㄨㄥ
念念不忘	ㄋㄧㄢˋ ㄋㄧㄢˋ-ㄅㄨˋ ㄨㄤˋ
黏	ㄋㄧㄢˊ
念書	ㄋㄧㄢˋ ㄕㄨ
念頭	ㄋㄧㄢˋ ㄊㄡ˙
釀造	ㄋㄧㄤˋ ㄗㄠˋ
娘	ㄋㄧㄤˊ
鳥巢	ㄋㄧㄠˇ ㄔㄠˊ
捏	ㄋㄧㄝ
尿	ㄋㄧㄠˋ
凝聚	ㄋㄧㄥˊ ㄐㄩˋ
凝固	ㄋㄧㄥˊ ㄍㄨˋ
寧可	ㄋㄧㄥˋ ㄎㄜˇ
擰	ㄋㄧㄥˊ
寧願	ㄋㄧㄥˋ ㄩㄢˋ
扭曲	ㄋㄧㄡˇ ㄑㄩ
扭頭	ㄋㄧㄡˇ ㄊㄡˊ
扭轉	ㄋㄧㄡˇ ㄓㄨㄢˇ
紐帶	ㄋㄧㄡˇ ㄉㄞˋ
紐扣	ㄋㄧㄡˇ ㄎㄡˋ
農場	ㄋㄨㄥˊ ㄔㄤˇ
農曆	ㄋㄨㄥˊ ㄌㄧˋ
農民工	ㄋㄨㄥˊ ㄇㄧㄣˊ ㄍㄨㄥ
濃縮	ㄋㄨㄥˊ ㄙㄨㄛ
農作物	ㄋㄨㄥˊ ㄗㄨㄛˋ ㄨˋ
濃郁	ㄋㄨㄥˊ ㄩˋ
濃厚	ㄋㄨㄥˊ ㄏㄡˋ
濃重	ㄋㄨㄥˊ ㄓㄨㄥˋ
弄虛作假	ㄋㄨㄥˋ ㄒㄩ-ㄗㄨㄛˋ ㄐㄧㄚˇ
奴隸	ㄋㄨˊ ㄌㄧˋ
暖烘烘	ㄋㄨㄢˇ ㄏㄨㄥ ㄏㄨㄥ
虐待	ㄋㄩㄝˋ ㄉㄞˋ
女婿	ㄋㄩˇ ㄒㄩ˙
諾言	ㄋㄨㄛˋ ㄧㄢˊ
哦	ㄛˊ
挪	ㄋㄨㄛˊ
毆打	ㄡ ㄉㄚˇ
嘔吐	ㄡˇ ㄊㄨˋ
拍板	ㄆㄞ ㄅㄢˇ
拍賣	ㄆㄞ ㄇㄞˋ
趴	ㄆㄚ
排放	ㄆㄞˊ ㄈㄤˋ
拍戲	ㄆㄞ ㄒㄧˋ
排練	ㄆㄞˊ ㄌㄧㄢˋ
排斥	ㄆㄞˊ ㄔˋ
徘徊	ㄆㄞˊ ㄏㄨㄞˊ
派別	ㄆㄞˋ ㄅㄧㄝˊ
牌照	ㄆㄞˊ ㄓㄠˋ
派遣	ㄆㄞˋ ㄑㄧㄢˇ
攀昇	ㄆㄢ ㄕㄥ
盤算	ㄆㄢˊ ㄙㄨㄢ˙
盤	ㄆㄢˊ
判處	ㄆㄢˋ ㄔㄨˇ
判定	ㄆㄢˋ ㄉㄧㄥˋ
盼	ㄆㄢˋ
判決	ㄆㄢˋ ㄐㄩㄝˊ
叛逆	ㄆㄢˋ ㄋㄧˋ
龐大	ㄆㄤˊ ㄉㄚˋ
旁觀	ㄆㄤˊ ㄍㄨㄢ
拋	ㄆㄠ
拋開	ㄆㄠ ㄎㄞ
刨	ㄆㄠˊ
拋棄	ㄆㄠ ㄑㄧˋ
跑車	ㄆㄠˇ ㄔㄜ
跑道	ㄆㄠˇ ㄉㄠˋ
跑龍套	ㄆㄠˇ ㄌㄨㄥˊ ㄊㄠˋ
泡沫	ㄆㄠˋ ㄇㄛˋ
陪伴	ㄆㄟˊ ㄅㄢˋ
陪葬	ㄆㄟˊ ㄗㄤˋ
賠錢	ㄆㄟˊ ㄑㄧㄢˊ
胚胎	ㄆㄟ ㄊㄞ
佩服	ㄆㄟˋ ㄈㄨ˙
配件	ㄆㄟˋ ㄐㄧㄢˋ
配送	ㄆㄟˋ ㄙㄨㄥˋ
配偶	ㄆㄟˋ ㄡˇ
配音	ㄆㄟˋ ㄧㄣ
噴泉	ㄆㄣ ㄑㄩㄢˊ
抨擊	ㄆㄥ ㄐㄧ
烹調	ㄆㄥ ㄊㄧㄠˊ
鵬程萬里	ㄆㄥˊ ㄔㄥˊ-ㄨㄢˋ ㄌㄧˇ
蓬勃	ㄆㄥˊ ㄅㄛˊ
膨脹	ㄆㄥˊ ㄓㄤˋ
捧	ㄆㄥˇ
捧場	ㄆㄥˇ ㄔㄤˇ
碰釘子	ㄆㄥˋ ㄉㄧㄥ ㄗ˙
碰巧	ㄆㄥˋ ㄑㄧㄠˇ
碰上	ㄆㄥˋ ㄕㄤˋ
碰撞	ㄆㄥˋ ㄓㄨㄤˋ
批發	ㄆㄧ ㄈㄚ
批判	ㄆㄧ ㄆㄢˋ
劈	ㄆㄧ
披露	ㄆㄧ ㄌㄨˋ
皮帶	ㄆㄧˊ ㄉㄞˋ
疲憊不堪	ㄆㄧˊ ㄅㄟˋ ㄅㄨˋ ㄎㄢ
疲憊	ㄆㄧˊ ㄅㄟˋ
疲倦	ㄆㄧˊ ㄐㄩㄢˋ
疲勞	ㄆㄧˊ ㄌㄠˊ
脾	ㄆㄧˊ
匹配	ㄆㄧˇ ㄆㄟˋ
譬如	ㄆㄧˋ ㄖㄨˊ
媲美	ㄆㄧˋ ㄇㄟˇ
譬如說	ㄆㄧˋ ㄖㄨˊ ㄕㄨㄛ
僻靜	ㄆㄧˋ ㄐㄧㄥˋ
偏差	ㄆㄧㄢ ㄔㄚ
偏方	ㄆㄧㄢ ㄈㄤ
偏見	ㄆㄧㄢ ㄐㄧㄢˋ
片子	ㄆㄧㄢ ㄗ˙
偏僻	ㄆㄧㄢ ㄆㄧˋ
偏偏	ㄆㄧㄢ ㄆㄧㄢ
偏向	ㄆㄧㄢ ㄒㄧㄤˋ
篇幅	ㄆㄧㄢ ㄈㄨ˙
偏遠	ㄆㄧㄢ ㄩㄢˇ
騙人	ㄆㄧㄢˋ ㄖㄣˊ
片段	ㄆㄧㄢˋ ㄉㄨㄢˋ
漂	ㄆㄧㄠˋ
飄	ㄆㄧㄠ
票房	ㄆㄧㄠˋ ㄈㄤˊ
撇	ㄆㄧㄝ
拼搏	ㄆㄧㄣ ㄅㄛˊ
貧富	ㄆㄧㄣˊ ㄈㄨˋ
拼命	ㄆㄧㄣ ㄇㄧㄥˋ
貧窮	ㄆㄧㄣˊ ㄑㄩㄥˊ
頻頻	ㄆㄧㄣˊ ㄆㄧㄣˊ
品嘗	ㄆㄧㄣˇ ㄔㄤˊ
頻率	ㄆㄧㄣˊ ㄌㄩˋ
品德	ㄆㄧㄣˇ ㄉㄜˊ
品行	ㄆㄧㄣˇ ㄒㄧㄥˊ
品位	ㄆㄧㄣˇ ㄨㄟˋ
聘用	ㄆㄧㄣˋ ㄩㄥˋ
乒乓球	ㄆㄧㄥ ㄆㄤ ㄑㄧㄡˊ
聘	ㄆㄧㄣˋ
聘任	ㄆㄧㄣˋ ㄖㄣˋ
平常心	ㄆㄧㄥˊ ㄔㄤˊ ㄒㄧㄣ
平淡	ㄆㄧㄥˊ ㄉㄢˋ
平和	ㄆㄧㄥˊ ㄏㄜˊ
平價	ㄆㄧㄥˊ ㄐㄧㄚˋ
平面	ㄆㄧㄥˊ ㄇㄧㄢˋ
平民	ㄆㄧㄥˊ ㄇㄧㄣˊ
平息	ㄆㄧㄥˊ ㄒㄧ
評定	ㄆㄧㄥˊ ㄉㄧㄥˋ
評論員	ㄆㄧㄥˊ ㄌㄨㄣˋ ㄩㄢˊ
平日	ㄆㄧㄥˊ ㄖˋ
評判	ㄆㄧㄥˊ ㄆㄢˋ
評審	ㄆㄧㄥˊ ㄕㄣˇ
憑借	ㄆㄧㄥˊ ㄐㄧㄝˋ
憑著	ㄆㄧㄥˊ ㄓㄜ˙
評委	ㄆㄧㄥˊ ㄨㄟˇ
憑證	ㄆㄧㄥˊ ㄓㄥˋ
萍水相逢	ㄆㄧㄥˊ ㄕㄨㄟˇ-ㄒㄧㄤ ㄈㄥˊ
瓶頸	ㄆㄧㄥˊ ㄐㄧㄥˇ
潑冷水	ㄆㄛ ㄌㄥˇ ㄕㄨㄟˇ
迫不及待	ㄆㄛˋ ㄅㄨˋ ㄐㄧˊ ㄉㄞˋ
頗	ㄆㄛ
迫害	ㄆㄛˋ ㄏㄞˋ
破案	ㄆㄛˋ ㄢˋ
破除	ㄆㄛˋ ㄔㄨˊ
破解	ㄆㄛˋ ㄐㄧㄝˇ
破舊	ㄆㄛˋ ㄐㄧㄡˋ
迫使	ㄆㄛˋ ㄕˇ
破裂	ㄆㄛˋ ㄌㄧㄝˋ
破碎	ㄆㄛˋ ㄙㄨㄟˋ
魄力	ㄆㄛˋ ㄌㄧˋ
破滅	ㄆㄛˋ ㄇㄧㄝˋ
撲面而來	ㄆㄨ ㄇㄧ˙ ㄚˋ ㄋㄜˊ ㄦ˙ ㄌㄞˊ
撲克	ㄆㄨ ㄎㄜˋ
鋪路	ㄆㄨ ㄌㄨˋ
樸實	ㄆㄨˇ ㄕˊ
菩薩	ㄆㄨˊ ㄙㄚˋ
樸素	ㄆㄨˇ ㄙㄨˋ
普通人	ㄆㄨˇ ㄊㄨㄥ ㄖㄣˊ
譜	ㄆㄨˇ
瀑布	ㄆㄨˋ ㄅㄨˋ
七嘴八舌	ㄑㄧ ㄗㄨㄟˇ-ㄅㄚ ㄕㄜˊ
沏	ㄑㄧ
凄涼	ㄑㄧ ㄌㄧㄤˊ
期盼	ㄑㄧ ㄆㄢˋ
欺騙	ㄑㄧ ㄆㄧㄢˋ
漆	ㄑㄧ
欺詐	ㄑㄧ ㄓㄚˋ
齊心協力	ㄑㄧˊ ㄒㄧㄣ-ㄒㄧㄝˊ ㄌㄧˋ
其間	ㄑㄧˊ ㄐㄧㄢ
其後	ㄑㄧˊ ㄏㄡˋ
奇花異草	ㄑㄧˊ ㄏㄨㄚ ㄧˋ ㄘㄠˇ
奇跡	ㄑㄧˊ ㄐㄧˋ
歧視	ㄑㄧˊ ㄕˋ
奇特	ㄑㄧˊ ㄊㄜˋ
祈禱	ㄑㄧˊ ㄉㄠˇ
棋	ㄑㄧˊ
棋子	ㄑㄧˊ ㄗˇ
旗袍	ㄑㄧˊ ㄆㄠˊ
旗幟	ㄑㄧˊ ㄓˋ
乞丐	ㄑㄧˇ ㄍㄞˋ
乞討	ㄑㄧˇ ㄊㄠˇ
豈有此理	ㄑㄧˇ ㄧㄡˇ-ㄘˇ ㄌㄧˇ
乞求	ㄑㄧˇ ㄑㄧㄡˊ
啟蒙	ㄑㄧˇ ㄇㄥˊ
啟迪	ㄑㄧˇ ㄉㄧˊ
啟示	ㄑㄧˇ ㄕˋ
起步	ㄑㄧˇ ㄅㄨˋ
起草	ㄑㄧˇ ㄘㄠˇ
起程	ㄑㄧˇ ㄔㄥˊ
起初	ㄑㄧˇ ㄔㄨ
起勁	ㄑㄧˇ ㄐㄧㄣˋ
起跑線	ㄑㄧˇ ㄆㄠˇ ㄒㄧㄢˋ
起源	ㄑㄧˇ ㄩㄢˊ
起伏	ㄑㄧˇ ㄈㄨˊ
氣憤	ㄑㄧˋ ㄈㄣˋ
氣管	ㄑㄧˋ ㄍㄨㄢˇ
氣餒	ㄑㄧˋ ㄋㄟˇ
氣泡	ㄑㄧˋ ㄆㄠˋ
氣派	ㄑㄧˋ ㄆㄞˋ
氣勢	ㄑㄧˋ ㄕˋ
氣味	ㄑㄧˋ ㄨㄟˋ
氣息	ㄑㄧˋ ㄒㄧ
氣魄	ㄑㄧˋ ㄆㄛˋ
氣質	ㄑㄧˋ ㄓˋ
迄今為止	ㄑㄧˋ ㄐㄧㄣ ㄨㄟˊ ㄓˇ
契約	ㄑㄧˋ ㄩㄝ
契機	ㄑㄧˋ ㄐㄧ
迄今	ㄑㄧˋ ㄐㄧㄣ
器材	ㄑㄧˋ ㄘㄞˊ
器械	ㄑㄧˋ ㄒㄧㄝˋ
卡	ㄎㄚˇ
掐	ㄑㄧㄚ
洽談	ㄑㄧㄚˋ ㄊㄢˊ
恰到好處	ㄑㄧㄚˋ ㄉㄠˋ-ㄏㄠˇ ㄔㄨˋ
卡子	ㄑㄧㄚˇ ㄗ˙
恰恰相反	ㄑㄧㄚˋ ㄑㄧㄚˋ ㄒㄧㄤ ㄈㄢˇ
恰如其分	ㄑㄧㄚˋ ㄖㄨˊ-ㄑㄧˊ ㄈㄣˋ
恰巧	ㄑㄧㄚˋ ㄑㄧㄠˇ
千變萬化	ㄑㄧㄢ ㄅㄧㄢˋ-ㄨㄢˋ ㄏㄨㄚˋ
千家萬戶	ㄑㄧㄢ ㄐㄧㄚ-ㄨㄢˋ ㄏㄨˋ
千方百計	ㄑㄧㄢ ㄈㄤ-ㄅㄞˇ ㄐㄧˋ
千鈞一髮	ㄑㄧㄢ ㄐㄩㄣ-ㄧ ㄈㄚˋ
千軍萬馬	ㄑㄧㄢ ㄐㄩㄣ-ㄨㄢˋ ㄇㄚˇ
遷就	ㄑㄧㄢ ㄐㄧㄡˋ
遷	ㄑㄧㄢ
遷移	ㄑㄧㄢ ㄧˊ
牽扯	ㄑㄧㄢ ㄔㄜˇ
牽涉	ㄑㄧㄢ ㄕㄜˋ
牽掛	ㄑㄧㄢ ㄍㄨㄚˋ
牽頭	ㄑㄧㄢ ㄊㄡˊ
鉛	ㄑㄧㄢ
牽制	ㄑㄧㄢ ㄓˋ
謙遜	ㄑㄧㄢ ㄒㄩㄣˋ
簽署	ㄑㄧㄢ ㄕㄨˇ
前輩	ㄑㄧㄢˊ ㄅㄟˋ
前不久	ㄑㄧㄢˊ ㄅㄨˋ ㄐㄧㄡˇ
前赴後繼	ㄑㄧㄢˊ ㄈㄨˋ-ㄏㄡˋ ㄐㄧˋ
簽	ㄑㄧㄢ
前期	ㄑㄧㄢˊ ㄑㄧ
前所未有	ㄑㄧㄢˊ ㄙㄨㄛˇ ㄨㄟˋ ㄧㄡˇ
前任	ㄑㄧㄢˊ ㄖㄣˋ
前無古人	ㄑㄧㄢˊ ㄨˊ ㄍㄨˇ ㄖㄣˊ
前夕	ㄑㄧㄢˊ ㄒㄧ
前臺	ㄑㄧㄢˊ ㄊㄞˊ
前線	ㄑㄧㄢˊ ㄒㄧㄢˋ
前仰後合	ㄑㄧㄢˊ ㄧㄤˇ-ㄏㄡˋ ㄏㄜˊ
前者	ㄑㄧㄢˊ ㄓㄜˇ
前沿	ㄑㄧㄢˊ ㄧㄢˊ
虔誠	ㄑㄧㄢˊ ㄔㄥˊ
鉗子	ㄑㄧㄢˊ ㄗ˙
錢財	ㄑㄧㄢˊ ㄘㄞˊ
潛能	ㄑㄧㄢˊ ㄋㄥˊ
潛艇	ㄑㄧㄢˊ ㄊㄧㄥˇ
潛移默化	ㄑㄧㄢˊ ㄧˊ-ㄇㄛˋ ㄏㄨㄚˋ
潛在	ㄑㄧㄢˊ ㄗㄞˋ
潛水	ㄑㄧㄢˊ ㄕㄨㄟˇ
譴責	ㄑㄧㄢˇ ㄗㄜˊ
欠缺	ㄑㄧㄢˋ ㄑㄩㄝ
欠條	ㄑㄧㄢˋ ㄊㄧㄠˊ
嗆	ㄑㄧㄤ
歉意	ㄑㄧㄢˋ ㄧˋ
槍斃	ㄑㄧㄤ ㄅㄧˋ
強加	ㄑㄧㄤˊ ㄐㄧㄚ
強勁	ㄑㄧㄤˊ ㄐㄧㄥˋ
強項	ㄑㄧㄤˊ ㄒㄧㄤˋ
強硬	ㄑㄧㄤˊ ㄧㄥˋ
強行	ㄑㄧㄤˊ ㄒㄧㄥˊ
腔	ㄑㄧㄤ
強占	ㄑㄧㄤˊ ㄓㄢˋ
強制	ㄑㄧㄤˊ ㄓˋ
搶奪	ㄑㄧㄤˇ ㄉㄨㄛˊ
搶眼	ㄑㄧㄤˇ ㄧㄢˇ
敲邊鼓	ㄑㄧㄠ ㄅㄧㄢ ㄍㄨˇ
搶劫	ㄑㄧㄤˇ ㄐㄧㄝˊ
敲詐	ㄑㄧㄠ ㄓㄚˋ
喬裝	ㄑㄧㄠˊ ㄓㄨㄤ
瞧不起	ㄑㄧㄠˊ ㄅㄨ˙ ㄑㄧˇ
竅門	ㄑㄧㄠˋ ㄇㄣˊ
巧合	ㄑㄧㄠˇ ㄏㄜˊ
翹	ㄑㄧㄠˋ
切除	ㄑㄧㄝ ㄔㄨˊ
切斷	ㄑㄧㄝ ㄉㄨㄢˋ
切割	ㄑㄧㄝ ㄍㄜ
撬	ㄑㄧㄠˋ
且	ㄑㄧㄝˇ
切身	ㄑㄧㄝˋ ㄕㄣ
竊取	ㄑㄧㄝˋ ㄑㄩˇ
欽佩	ㄑㄧㄣ ㄆㄟˋ
侵害	ㄑㄧㄣ ㄏㄞˋ
侵略	ㄑㄧㄣ ㄌㄩㄝˋ
侵占	ㄑㄧㄣ ㄓㄢˋ
親和力	ㄑㄧㄣ ㄏㄜˊ ㄌㄧˋ
侵權	ㄑㄧㄣ ㄑㄩㄢˊ
親朋好友	ㄑㄧㄣ ㄆㄥˊ ㄏㄠˇ ㄧㄡˇ
親近	ㄑㄧㄣ ㄐㄧㄣˋ
親戚	ㄑㄧㄣ ㄑㄧ˙
親情	ㄑㄧㄣ ㄑㄧㄥˊ
親熱	ㄑㄧㄣ ㄖㄜˋ
親身	ㄑㄧㄣ ㄕㄣ
親手	ㄑㄧㄣ ㄕㄡˇ
親生	ㄑㄧㄣ ㄕㄥ
親友	ㄑㄧㄣ ㄧㄡˇ
勤工儉學	ㄑㄧㄣˊ ㄍㄨㄥ-ㄐㄧㄢˇ ㄒㄩㄝˊ
勤勞	ㄑㄧㄣˊ ㄌㄠˊ
勤快	ㄑㄧㄣˊ ㄎㄨㄞ˙
寢室	ㄑㄧㄣˇ ㄕˋ
青春期	ㄑㄧㄥ ㄔㄨㄣ ㄑㄧ
青蛙	ㄑㄧㄥ ㄨㄚ
輕而易舉	ㄑㄧㄣ ㄍㄜˊ ㄦ˙ ㄧˋ ㄐㄩˇ
輕蔑	ㄑㄧㄥ ㄇㄧㄝˋ
輕型	ㄑㄧㄥ ㄒㄧㄥˊ
輕微	ㄑㄧㄥ ㄨㄟ
傾家蕩產	ㄑㄧㄥ ㄐㄧㄚ-ㄉㄤˋ ㄔㄢˇ
傾聽	ㄑㄧㄥ ㄊㄧㄥ
傾銷	ㄑㄧㄥ ㄒㄧㄠ
傾訴	ㄑㄧㄥ ㄙㄨˋ
傾斜	ㄑㄧㄥ ㄒㄧㄝˊ
清單	ㄑㄧㄥ ㄉㄢ
清除	ㄑㄧㄥ ㄔㄨˊ
清脆	ㄑㄧㄥ ㄘㄨㄟˋ
清靜	ㄑㄧㄥ ㄐㄧㄥˋ
清涼	ㄑㄧㄥ ㄌㄧㄤˊ
清淡	ㄑㄧㄥ ㄉㄢˋ
清明	ㄑㄧㄥ ㄇㄧㄥˊ
清晰	ㄑㄧㄥ ㄒㄧ
清新	ㄑㄧㄥ ㄒㄧㄣ
清真寺	ㄑㄧㄥ ㄓㄣ ㄙˋ
情報	ㄑㄧㄥˊ ㄅㄠˋ
情	ㄑㄧㄥˊ
情不自禁	ㄑㄧㄥˊ ㄅㄨˋ ㄗˋ ㄐㄧㄣ
情懷	ㄑㄧㄥˊ ㄏㄨㄞˊ
情調	ㄑㄧㄥˊ ㄉㄧㄠˋ
情結	ㄑㄧㄥˊ ㄐㄧㄝˊ
情侶	ㄑㄧㄥˊ ㄌㄩˇ
情人	ㄑㄧㄥˊ ㄖㄣˊ
情誼	ㄑㄧㄥˊ ㄧˋ
情願	ㄑㄧㄥˊ ㄩㄢˋ
請帖	ㄑㄧㄥˇ ㄊㄧㄝˇ
請柬	ㄑㄧㄥˇ ㄐㄧㄢˇ
慶典	ㄑㄧㄥˋ ㄉㄧㄢˇ
慶幸	ㄑㄧㄥˋ ㄒㄧㄥˋ
慶賀	ㄑㄧㄥˋ ㄏㄜˋ
丘陵	ㄑㄧㄡ ㄌㄧㄥˊ
囚犯	ㄑㄧㄡˊ ㄈㄢˋ
求婚	ㄑㄧㄡˊ ㄏㄨㄣ
求學	ㄑㄧㄡˊ ㄒㄩㄝˊ
求救	ㄑㄧㄡˊ ㄐㄧㄡˋ
求證	ㄑㄧㄡˊ ㄓㄥˋ
求醫	ㄑㄧㄡˊ ㄧ
曲線	ㄑㄩ ㄒㄧㄢˋ
曲折	ㄑㄩ ㄓㄜˊ
求助	ㄑㄧㄡˊ ㄓㄨˋ
驅動	ㄑㄩ ㄉㄨㄥˋ
屈服	ㄑㄩ ㄈㄨˊ
驅逐	ㄑㄩ ㄓㄨˊ
曲	ㄑㄩ
趨於	ㄑㄩ ㄩˊ
取代	ㄑㄩˇ ㄉㄞˋ
取而代之	ㄑㄩˇ ㄦˊ ㄉㄞˋ ㄓ
取經	ㄑㄩˇ ㄐㄧㄥ
取決於	ㄑㄩˇ ㄐㄩㄝˊ ㄩˊ
取締	ㄑㄩˇ ㄉㄧˋ
取暖	ㄑㄩˇ ㄋㄨㄢˇ
取笑	ㄑㄩˇ ㄒㄧㄠˋ
取勝	ㄑㄩˇ ㄕㄥˋ
娶	ㄑㄩˇ
去除	ㄑㄩˋ ㄔㄨˊ
去向	ㄑㄩˋ ㄒㄧㄤˋ
去處	ㄑㄩˋ ㄔㄨˋ
圈套	ㄑㄩㄢ ㄊㄠˋ
趣味	ㄑㄩˋ ㄨㄟˋ
權衡	ㄑㄩㄢˊ ㄏㄥˊ
權威	ㄑㄩㄢˊ ㄨㄟ
圈子	ㄑㄩㄢ ㄗ˙
權益	ㄑㄩㄢˊ ㄧˋ
全程	ㄑㄩㄢˊ ㄔㄥˊ
全長	ㄑㄩㄢˊ ㄔㄤˊ
全方位	ㄑㄩㄢˊ ㄈㄤ ㄨㄟˋ
全局	ㄑㄩㄢˊ ㄐㄩˊ
全力以赴	ㄑㄩㄢˊ ㄌㄧˋ ㄧˇ ㄈㄨˋ
全能	ㄑㄩㄢˊ ㄋㄥˊ
全心全意	ㄑㄩㄢˊ ㄒㄧㄣ-ㄑㄩㄢˊ ㄧˋ
拳	ㄑㄩㄢˊ
全文	ㄑㄩㄢˊ ㄨㄣˊ
勸告	ㄑㄩㄢˋ ㄍㄠˋ
勸說	ㄑㄩㄢˋ ㄕㄨㄛ
勸阻	ㄑㄩㄢˋ ㄗㄨˇ
缺口	ㄑㄩㄝ ㄎㄡˇ
拳頭	ㄑㄩㄢˊ ㄊㄡ˙
確切	ㄑㄩㄝˋ ㄑㄧㄝˋ
缺失	ㄑㄩㄝ ㄕ
確信	ㄑㄩㄝˋ ㄒㄧㄣˋ
缺席	ㄑㄩㄝ ㄒㄧˊ
確診	ㄑㄩㄝˋ ㄓㄣˇ
確鑿	ㄑㄩㄝˋ ㄗㄠˊ
燃放	ㄖㄢˊ ㄈㄤˋ
燃氣	ㄖㄢˊ ㄑㄧˋ
燃油	ㄖㄢˊ ㄧㄡˊ
讓步	ㄖㄤˋ ㄅㄨˋ
嚷	ㄖㄤˇ
饒	ㄖㄠˊ
擾亂	ㄖㄠˇ ㄌㄨㄢˋ
饒恕	ㄖㄠˊ ㄕㄨˋ
繞行	ㄖㄠˋ ㄒㄧㄥˊ
惹	ㄖㄜˇ
熱潮	ㄖㄜˋ ㄔㄠˊ
熱氣	ㄖㄜˋ ㄑㄧˋ
熱帶	ㄖㄜˋ ㄉㄞˋ
熱騰騰	ㄖㄜˋ ㄊㄥˊ ㄊㄥˊ
熱衷	ㄖㄜˋ ㄓㄨㄥ
熱氣球	ㄖㄜˋ ㄑㄧˋ ㄑㄧㄡˊ
人道	ㄖㄣˊ ㄉㄠˋ
人次	ㄖㄣˊ ㄘˋ
人格	ㄖㄣˊ ㄍㄜˊ
人工智能	ㄖㄣˊ ㄍㄨㄥ ㄓˋ ㄋㄥˊ
人均	ㄖㄣˊ ㄐㄩㄣ
人品	ㄖㄣˊ ㄆㄧㄣˇ
人情	ㄖㄣˊ ㄑㄧㄥˊ
人氣	ㄖㄣˊ ㄑㄧˋ
人身	ㄖㄣˊ ㄕㄣ
人事	ㄖㄣˊ ㄕˋ
人手	ㄖㄣˊ ㄕㄡˇ
人體	ㄖㄣˊ ㄊㄧˇ
人為	ㄖㄣˊ ㄨㄟˊ
人文	ㄖㄣˊ ㄨㄣˊ
人行道	ㄖㄣˊ ㄒㄧㄥˊ ㄉㄠˋ
人選	ㄖㄣˊ ㄒㄩㄢˇ
人緣兒	ㄖㄣˊ ㄩㄢˊ ㄦ˙
人造	ㄖㄣˊ ㄗㄠˋ
人性	ㄖㄣˊ ㄒㄧㄥ˙
人質	ㄖㄣˊ ㄓˋ
仁慈	ㄖㄣˊ ㄘˊ
忍飢挨餓	ㄖㄣˇ ㄐㄧ-ㄞˊ ㄜˋ
忍耐	ㄖㄣˇ ㄋㄞˋ
忍心	ㄖㄣˇ ㄒㄧㄣ
認錯	ㄖㄣˋ ㄘㄨㄛˋ
認證	ㄖㄣˋ ㄓㄥˋ
任命	ㄖㄣˋ ㄇㄧㄥˋ
認知	ㄖㄣˋ ㄓ
任期	ㄖㄣˋ ㄑㄧ
任人宰割	ㄖㄣˋ ㄖㄣˊ-ㄗㄞˇ ㄍㄜ
任意	ㄖㄣˋ ㄧˋ
任職	ㄖㄣˋ ㄓˊ
韌性	ㄖㄣˋ ㄒㄧㄥˋ
日程	ㄖˋ ㄔㄥˊ
日復一日	ㄖˋ ㄈㄨˋ ㄧ ㄖˋ
日前	ㄖˋ ㄑㄧㄢˊ
日後	ㄖˋ ㄏㄡˋ
日趨	ㄖˋ ㄑㄩ
日新月異	ㄖˋ ㄒㄧㄣ-ㄩㄝˋ ㄧˋ
日益	ㄖˋ ㄧˋ
榮獲	ㄖㄨㄥˊ ㄏㄨㄛˋ
榮幸	ㄖㄨㄥˊ ㄒㄧㄥˋ
榮譽	ㄖㄨㄥˊ ㄩˋ
容光煥發	ㄖㄨㄥˊ ㄍㄨㄤ-ㄏㄨㄢˋ ㄈㄚ
容忍	ㄖㄨㄥˊ ㄖㄣˇ
容量	ㄖㄨㄥˊ ㄌㄧㄤˋ
容納	ㄖㄨㄥˊ ㄋㄚˋ
容顏	ㄖㄨㄥˊ ㄧㄢˊ
容許	ㄖㄨㄥˊ ㄒㄩˇ
溶解	ㄖㄨㄥˊ ㄐㄧㄝˇ
融	ㄖㄨㄥˊ
融化	ㄖㄨㄥˊ ㄏㄨㄚˋ
冗長	ㄖㄨㄥˇ ㄔㄤˊ
融洽	ㄖㄨㄥˊ ㄑㄧㄚˋ
柔和	ㄖㄡˊ ㄏㄜˊ
柔軟	ㄖㄡˊ ㄖㄨㄢˇ
如果說	ㄖㄨˊ ㄍㄨㄛˇ ㄕㄨㄛ
揉	ㄖㄡˊ
如實	ㄖㄨˊ ㄕˊ
如意	ㄖㄨˊ ㄧˋ
如願以償	ㄖㄨˊ ㄩㄢˋ-ㄧˇ ㄔㄤˊ
儒家	ㄖㄨˊ ㄐㄧㄚ
如醉如痴	ㄖㄨˊ ㄗㄨㄟˋ-ㄖㄨˊ ㄔ
入場	ㄖㄨˋ ㄔㄤˇ
儒學	ㄖㄨˊ ㄒㄩㄝˊ
入場券	ㄖㄨˋ ㄔㄤˇ ㄑㄩㄢˋ
入侵	ㄖㄨˋ ㄑㄧㄣ
入境	ㄖㄨˋ ㄐㄧㄥˋ
入選	ㄖㄨˋ ㄒㄩㄢˇ
軟弱	ㄖㄨㄢˇ ㄖㄨㄛˋ
軟實力	ㄖㄨㄢˇ ㄕˊ ㄌㄧˋ
瑞雪	ㄖㄨㄟˋ ㄒㄩㄝˇ
潤	ㄖㄨㄣˋ
若干	ㄖㄨㄛˋ ㄍㄢ
弱勢	ㄖㄨㄛˋ ㄕˋ
弱點	ㄖㄨㄛˋ ㄉㄧㄢˇ
撒謊	ㄙㄚ ㄏㄨㄤˇ
撒	ㄙㄚ
賽車	ㄙㄞˋ ㄔㄜ
三番五次	ㄙㄢ ㄈㄢ-ㄨˇ ㄘˋ
賽跑	ㄙㄞˋ ㄆㄠˇ
三角	ㄙㄢ ㄐㄧㄠˇ
三維	ㄙㄢ ㄨㄟˊ
散布	ㄙㄢˋ ㄅㄨˋ
桑拿	ㄙㄤ ㄋㄚˊ
嗓子	ㄙㄤˇ ㄗ˙
散發	ㄙㄢˋ ㄈㄚ
喪生	ㄙㄤˋ ㄕㄥ
騷亂	ㄙㄠ ㄌㄨㄢˋ
騷擾	ㄙㄠ ㄖㄠˇ
掃除	ㄙㄠˇ ㄔㄨˊ
掃描	ㄙㄠˇ ㄇㄧㄠˊ
掃興	ㄙㄠˇ ㄒㄧㄥˋ
嫂子	ㄙㄠˇ ㄗ˙
掃墓	ㄙㄠˇ ㄇㄨˋ
殺害	ㄕㄚ ㄏㄞˋ
僧人	ㄙㄥ ㄖㄣˊ
殺手	ㄕㄚ ㄕㄡˇ
沙龍	ㄕㄚ ㄌㄨㄥˊ
紗	ㄕㄚ
沙灘	ㄕㄚ ㄊㄢ
砂糖	ㄕㄚ ㄊㄤˊ
剎車	ㄕㄚ ㄔㄜ
鯊魚	ㄕㄚ ㄩˊ
傻瓜	ㄕㄚˇ ㄍㄨㄚ
篩	ㄕㄞ
曬太陽	ㄕㄞˋ ㄊㄞˋ ㄧㄤ˙
山川	ㄕㄢ ㄔㄨㄢ
篩選	ㄕㄞ ㄒㄩㄢˇ
山岡	ㄕㄢ ㄍㄤ
山嶺	ㄕㄢ ㄌㄧㄥˇ
山頂	ㄕㄢ ㄉㄧㄥˇ
山寨	ㄕㄢ ㄓㄞˋ
山路	ㄕㄢ ㄌㄨˋ
刪除	ㄕㄢ ㄔㄨˊ
刪	ㄕㄢ
煽動	ㄕㄢ ㄉㄨㄥˋ
閃爍	ㄕㄢˇ ㄕㄨㄛˋ
善意	ㄕㄢˋ ㄧˋ
善	ㄕㄢˋ
擅長	ㄕㄢˋ ㄔㄤˊ
擅自	ㄕㄢˋ ㄗˋ
膳食	ㄕㄢˋ ㄕˊ
贍養	ㄕㄢˋ ㄧㄤˇ
傷殘	ㄕㄤ ㄘㄢˊ
傷痕	ㄕㄤ ㄏㄣˊ
傷腦筋	ㄕㄤ ㄋㄠˇ ㄐㄧㄣ
傷勢	ㄕㄤ ㄕˋ
傷感	ㄕㄤ ㄍㄢˇ
商販	ㄕㄤ ㄈㄢˋ
商討	ㄕㄤ ㄊㄠˇ
商賈	ㄕㄤ ㄍㄨˇ
上報	ㄕㄤˋ ㄅㄠˋ
上場	ㄕㄤˋ ㄔㄤˇ
上方	ㄕㄤˋ ㄈㄤ
上崗	ㄕㄤˋ ㄍㄤˇ
上火	ㄕㄤˋ ㄏㄨㄛˇ
上空	ㄕㄤˋ ㄎㄨㄥ
上流	ㄕㄤˋ ㄌㄧㄡˊ
上任	ㄕㄤˋ ㄖㄣˋ
上期	ㄕㄤˋ ㄑㄧ
上述	ㄕㄤˋ ㄕㄨˋ
上司	ㄕㄤˋ ㄙ˙
上訴	ㄕㄤˋ ㄙㄨˋ
上調	ㄕㄤˋ ㄉㄧㄠˋ
上頭	ㄕㄤˋ ㄊㄡ˙
上限	ㄕㄤˋ ㄒㄧㄢˋ
上旬	ㄕㄤˋ ㄒㄩㄣˊ
上癮	ㄕㄤˋ ㄧㄣˇ
上游	ㄕㄤˋ ㄧㄡˊ
上映	ㄕㄤˋ ㄧㄥˋ
尚	ㄕㄤˋ
尚未	ㄕㄤˋ ㄨㄟˋ
捎	ㄕㄠ
燒毀	ㄕㄠ ㄏㄨㄟˇ
燒烤	ㄕㄠ ㄎㄠˇ
稍後	ㄕㄠ ㄏㄡˋ
稍稍	ㄕㄠ ㄕㄠ
少見	ㄕㄠˇ ㄐㄧㄢˋ
少不了	ㄕㄠˇ ㄅㄨ˙ ㄌㄧㄠˇ
少量	ㄕㄠˇ ㄌㄧㄤˋ
稍候	ㄕㄠ ㄏㄡˋ
少林寺	ㄕㄠˋ ㄌㄧㄣˊ ㄙˋ
少有	ㄕㄠˇ ㄧㄡˇ
奢侈	ㄕㄜ ㄔˇ
少女	ㄕㄠˋ ㄋㄩˇ
奢望	ㄕㄜ ㄨㄤˋ
設	ㄕㄜˋ
設定	ㄕㄜˋ ㄉㄧㄥˋ
設法	ㄕㄜˋ ㄈㄚˇ
社交	ㄕㄜˋ ㄐㄧㄠ
社會主義	ㄕㄜˋ ㄏㄨㄟˋ ㄓㄨˇ ㄧˋ
社論	ㄕㄜˋ ㄌㄨㄣˋ
社團	ㄕㄜˋ ㄊㄨㄢˊ
攝氏度	ㄕㄜˋ ㄕˋ ㄉㄨˋ
誰知道	ㄕㄨㄟˊ ㄓ ㄉㄠˋ
涉嫌	ㄕㄜˋ ㄒㄧㄢˊ
申辦	ㄕㄣ ㄅㄢˋ
申領	ㄕㄣ ㄌㄧㄥˇ
伸手	ㄕㄣ ㄕㄡˇ
伸縮	ㄕㄣ ㄙㄨㄛ
申報	ㄕㄣ ㄅㄠˋ
伸張	ㄕㄣ ㄓㄤ
身不由己	ㄕㄣ ㄅㄨˋ ㄧㄡˊ ㄐㄧˇ
身軀	ㄕㄣ ㄑㄩ
身價	ㄕㄣ ㄐㄧㄚˋ
身心	ㄕㄣ ㄒㄧㄣ
身影	ㄕㄣ ㄧㄥˇ
身子	ㄕㄣ ㄗ˙
紳士	ㄕㄣ ㄕˋ
深切	ㄕㄣ ㄑㄧㄝˋ
深情	ㄕㄣ ㄑㄧㄥˊ
深奧	ㄕㄜ ㄋㄠˋ
深入人心	ㄕㄣ ㄖㄨˋ-ㄖㄣˊ ㄒㄧㄣ
深受	ㄕㄣ ㄕㄡˋ
深信	ㄕㄣ ㄒㄧㄣˋ
深思	ㄕㄣ ㄙ
深遠	ㄕㄣ ㄩㄢˇ
深夜	ㄕㄣ ㄧㄝˋ
神氣	ㄕㄣˊ ㄑㄧˋ
神聖	ㄕㄣˊ ㄕㄥˋ
神仙	ㄕㄣˊ ㄒㄧㄢ˙
神態	ㄕㄣˊ ㄊㄞˋ
審定	ㄕㄣˇ ㄉㄧㄥˋ
審核	ㄕㄣˇ ㄏㄜˊ
審美	ㄕㄣˇ ㄇㄟˇ
審批	ㄕㄣˇ ㄆㄧ
審判	ㄕㄣˇ ㄆㄢˋ
腎	ㄕㄣˋ
審視	ㄕㄣˇ ㄕˋ
甚至於	ㄕㄣˋ ㄓˋ ㄩˊ
滲透	ㄕㄣˋ ㄊㄡˋ
慎重	ㄕㄣˋ ㄓㄨㄥˋ
滲	ㄕㄣˋ
升溫	ㄕㄥ ㄨㄣ
生理	ㄕㄥ ㄌㄧˇ
生機	ㄕㄥ ㄐㄧ
生命線	ㄕㄥ ㄇㄧㄥˋ ㄒㄧㄢˋ
生平	ㄕㄥ ㄆㄧㄥˊ
生怕	ㄕㄥ ㄆㄚˋ
生前	ㄕㄥ ㄑㄧㄢˊ
生態	ㄕㄥ ㄊㄞˋ
生死	ㄕㄥ-ㄙˇ
生效	ㄕㄥ ㄒㄧㄠˋ
生物	ㄕㄥ ㄨˋ
生涯	ㄕㄥ ㄧㄚˊ
生硬	ㄕㄥ ㄧㄥˋ
生育	ㄕㄥ ㄩˋ
聲稱	ㄕㄥ ㄔㄥ
聲譽	ㄕㄥ ㄩˋ
聲望	ㄕㄥ ㄨㄤˋ
繩子	ㄕㄥˊ ㄗ˙
牲畜	ㄕㄥ ㄔㄨˋ
省略	ㄕㄥˇ ㄌㄩㄝˋ
省事	ㄕㄥˇ ㄕˋ
勝出	ㄕㄥˋ ㄔㄨ
聖賢	ㄕㄥˋ ㄒㄧㄢˊ
勝任	ㄕㄥˋ ㄖㄣˋ
盛大	ㄕㄥˋ ㄉㄚˋ
盛會	ㄕㄥˋ ㄏㄨㄟˋ
盛氣凌人	ㄕㄥˋ ㄑㄧˋ-ㄌㄧㄥˊ ㄖㄣˊ
剩餘	ㄕㄥˋ ㄩˊ
盛開	ㄕㄥˋ ㄎㄞ
失傳	ㄕ ㄔㄨㄢˊ
屍體	ㄕ ㄊㄧˇ
失控	ㄕ ㄎㄨㄥˋ
失利	ㄕ ㄌㄧˋ
失戀	ㄕ ㄌㄧㄢˋ
失靈	ㄕ ㄌㄧㄥˊ
失眠	ㄕ ㄇㄧㄢˊ
失明	ㄕ ㄇㄧㄥˊ
失落	ㄕ ㄌㄨㄛˋ
失效	ㄕ ㄒㄧㄠˋ
失蹤	ㄕ ㄗㄨㄥ
失業率	ㄕ ㄧㄝˋ ㄌㄩˋ
師範	ㄕ ㄈㄢˋ
師長	ㄕ ㄓㄤˇ
獅子	ㄕ ㄗ˙
師資	ㄕ ㄗ
施工	ㄕ ㄍㄨㄥ
施加	ㄕ ㄐㄧㄚ
施行	ㄕ ㄒㄧㄥˊ
施壓	ㄕ ㄧㄚ
濕潤	ㄕ ㄖㄨㄣˋ
濕度	ㄕ ㄉㄨˋ
十字路口	ㄕˊ ㄗˋ ㄌㄨˋ ㄎㄡˇ
時段	ㄕˊ ㄉㄨㄢˋ
時不時	ㄕˊ ㄅㄨˋ ㄕˊ
時隔	ㄕˊ ㄍㄜˊ
時間表	ㄕˊ ㄐㄧㄢ ㄅㄧㄠˇ
時好時壞	ㄕˊ ㄏㄠˇ ㄕˊ ㄏㄨㄞˋ
時髦	ㄕˊ ㄇㄠˊ
時尚	ㄕˊ ㄕㄤˋ
時空	ㄕˊ ㄎㄨㄥ
時速	ㄕˊ ㄙㄨˋ
識別	ㄕˊ ㄅㄧㄝˊ
實話	ㄕˊ ㄏㄨㄚˋ
實地	ㄕˊ ㄉㄧˋ
實話實說	ㄕˊ ㄏㄨㄚˋ-ㄕˊ ㄕㄨㄛ
實事求是	ㄕˊ ㄕˋ-ㄑㄧㄡˊ ㄕˋ
實體	ㄕˊ ㄊㄧˇ
實況	ㄕˊ ㄎㄨㄤˋ
實質	ㄕˊ ㄓˋ
實物	ㄕˊ ㄨˋ
食宿	ㄕˊ-ㄙㄨˋ
食用	ㄕˊ ㄩㄥˋ
史無前例	ㄕˇ ㄨˊ ㄑㄧㄢˊ ㄌㄧˋ
使喚	ㄕˇ ㄏㄨㄢ˙
使命	ㄕˇ ㄇㄧㄥˋ
使者	ㄕˇ ㄓㄜˇ
士氣	ㄕˋ ㄑㄧˋ
示威	ㄕˋ ㄨㄟ
示意	ㄕˋ ㄧˋ
世代	ㄕˋ ㄉㄞˋ
世界級	ㄕˋ ㄐㄧㄝˋ ㄐㄧˊ
世故	ㄕˋ ㄍㄨ˙
世襲	ㄕˋ ㄒㄧˊ
市場經濟	ㄕˋ ㄔㄤˇ ㄐㄧㄥ ㄐㄧˋ
勢必	ㄕˋ ㄅㄧˋ
勢頭	ㄕˋ ㄊㄡ˙
勢不可當	ㄕˋ ㄅㄨˋ ㄎㄜˇ ㄉㄤ
事務	ㄕˋ ㄨˋ
事態	ㄕˋ ㄊㄞˋ
事務所	ㄕˋ ㄨˋ ㄙㄨㄛˇ
事項	ㄕˋ ㄒㄧㄤˋ
事跡	ㄕˋ ㄐㄧˋ
侍候	ㄕˋ ㄏㄡˋ
試探	ㄕˋ ㄊㄢ˙
事宜	ㄕˋ ㄧˊ
試行	ㄕˋ ㄒㄧㄥˊ
試用期	ㄕˋ ㄩㄥˋ ㄑㄧ
試用	ㄕˋ ㄩㄥˋ
視角	ㄕˋ ㄐㄧㄠˇ
視覺	ㄕˋ ㄐㄩㄝˊ
視察	ㄕˋ ㄔㄚˊ
視線	ㄕˋ ㄒㄧㄢˋ
視野	ㄕˋ ㄧㄝˇ
視力	ㄕˋ ㄌㄧˋ
是非	ㄕˋ ㄈㄟ
適度	ㄕˋ ㄉㄨˋ
柿子	ㄕˋ ㄗ˙
適宜	ㄕˋ ㄧˊ
適時	ㄕˋ ㄕˊ
釋放	ㄕˋ ㄈㄤˋ
適量	ㄕˋ ㄌㄧㄤˋ
嗜好	ㄕˋ ㄏㄠˋ
收復	ㄕㄡ ㄈㄨˋ
收據	ㄕㄡ ㄐㄩˋ
收斂	ㄕㄡ ㄌㄧㄢˇ
收買	ㄕㄡ ㄇㄞˇ
逝世	ㄕˋ ㄕˋ
收留	ㄕㄡ ㄌㄧㄡˊ
收縮	ㄕㄡ ㄙㄨㄛ
收視率	ㄕㄡ ㄕˋ ㄌㄩˋ
收支	ㄕㄡ ㄓ
手臂	ㄕㄡˇ ㄅㄧˋ
手冊	ㄕㄡˇ ㄘㄜˋ
手動	ㄕㄡˇ ㄉㄨㄥˋ
手帕	ㄕㄡˇ ㄆㄚˋ
手腳	ㄕㄡˇ ㄐㄧㄠˇ
手槍	ㄕㄡˇ ㄑㄧㄤ
手勢	ㄕㄡˇ ㄕˋ
手術室	ㄕㄡˇ ㄕㄨˋ ㄕˋ
手腕	ㄕㄡˇ ㄨㄢˋ
手頭	ㄕㄡˇ ㄊㄡˊ
手藝	ㄕㄡˇ ㄧˋ
手掌	ㄕㄡˇ ㄓㄤˇ
守候	ㄕㄡˇ ㄏㄡˋ
守株待兔	ㄕㄡˇ ㄓㄨ-ㄉㄞˋ ㄊㄨˋ
首創	ㄕㄡˇ ㄔㄨㄤˋ
守護	ㄕㄡˇ ㄏㄨˋ
首府	ㄕㄡˇ ㄈㄨˇ
首批	ㄕㄡˇ ㄆㄧ
首飾	ㄕㄡˇ ㄕ˙
首要	ㄕㄡˇ ㄧㄠˋ
受過	ㄕㄡˋ ㄍㄨㄛˋ
壽命	ㄕㄡˋ ㄇㄧㄥˋ
受害人	ㄕㄡˋ ㄏㄞˋ ㄖㄣˊ
受害	ㄕㄡˋ ㄏㄞˋ
受賄	ㄕㄡˋ ㄏㄨㄟˋ
受驚	ㄕㄡˋ ㄐㄧㄥ
受苦	ㄕㄡˋ ㄎㄨˇ
受理	ㄕㄡˋ ㄌㄧˇ
受益	ㄕㄡˋ ㄧˋ
授權	ㄕㄡˋ ㄑㄩㄢˊ
受騙	ㄕㄡˋ ㄆㄧㄢˋ
售價	ㄕㄡˋ ㄐㄧㄚˋ
授予	ㄕㄡˋ ㄩˇ
售票	ㄕㄡˋ ㄆㄧㄠˋ
書櫥	ㄕㄨ ㄔㄨˊ
書籍	ㄕㄨ ㄐㄧˊ
書記	ㄕㄨ ㄐㄧ˙
書面	ㄕㄨ ㄇㄧㄢˋ
書寫	ㄕㄨ ㄒㄧㄝˇ
抒情	ㄕㄨ ㄑㄧㄥˊ
梳	ㄕㄨ
樞紐	ㄕㄨ ㄋㄧㄡˇ
梳子	ㄕㄨ ㄗ˙
梳理	ㄕㄨ ㄌㄧˇ
舒暢	ㄕㄨ ㄔㄤˋ
疏導	ㄕㄨ ㄉㄠˇ
疏散	ㄕㄨ ㄙㄢˋ
疏通	ㄕㄨ ㄊㄨㄥ
輸家	ㄕㄨ ㄐㄧㄚ˙
疏忽	ㄕㄨ ㄏㄨ˙
輸送	ㄕㄨ ㄙㄨㄥˋ
輸血	ㄕㄨ ㄒㄩㄝˋ
贖	ㄕㄨˊ
輸液	ㄕㄨ ㄧㄝˋ
屬性	ㄕㄨˇ ㄒㄧㄥˋ
曙光	ㄕㄨˇ ㄍㄨㄤ
暑期	ㄕㄨˇ ㄑㄧ
束縛	ㄕㄨˋ ㄈㄨˋ
樹木	ㄕㄨˋ ㄇㄨˋ
樹立	ㄕㄨˋ ㄌㄧˋ
樹梢	ㄕㄨˋ ㄕㄠ
樹蔭	ㄕㄨˋ ㄧㄣ
竪	ㄕㄨˋ
樹枝	ㄕㄨˋ ㄓ
數據庫	ㄕㄨˋ ㄐㄩˋ ㄎㄨˋ
刷新	ㄕㄨㄚ ㄒㄧㄣ
耍	ㄕㄨㄚˇ
數額	ㄕㄨˋ ㄜˊ
耍賴	ㄕㄨㄚˇ ㄌㄞˋ
衰減	ㄕㄨㄞ ㄐㄧㄢˇ
衰竭	ㄕㄨㄞ ㄐㄧㄝˊ
衰弱	ㄕㄨㄞ ㄖㄨㄛˋ
衰老	ㄕㄨㄞ ㄌㄠˇ
衰退	ㄕㄨㄞ ㄊㄨㄟˋ
摔跤	ㄕㄨㄞ ㄐㄧㄠ
甩	ㄕㄨㄞˇ
涮	ㄕㄨㄢˋ
雙胞胎	ㄕㄨㄤ ㄅㄠ ㄊㄞ
拴	ㄕㄨㄢ
雙邊	ㄕㄨㄤ ㄅㄧㄢ
雙重	ㄕㄨㄤ ㄔㄨㄥˊ
雙向	ㄕㄨㄤ ㄒㄧㄤˋ
霜	ㄕㄨㄤ
雙贏	ㄕㄨㄤ ㄧㄥˊ
爽快	ㄕㄨㄤˇ ㄎㄨㄞ˙
水稻	ㄕㄨㄟˇ ㄉㄠˋ
水管	ㄕㄨㄟˇ ㄍㄨㄢˇ
水壺	ㄕㄨㄟˇ ㄏㄨˊ
水槽	ㄕㄨㄟˇ ㄘㄠˊ
水晶	ㄕㄨㄟˇ ㄐㄧㄥ
水利	ㄕㄨㄟˇ ㄌㄧˋ
水貨	ㄕㄨㄟˇ ㄏㄨㄛˋ
水靈靈	ㄕㄨㄟˇ ㄌㄧㄥˊ ㄌㄧㄥˊ
水落石出	ㄕㄨㄟˇ ㄌㄨㄛˋ-ㄕˊ ㄔㄨ
水面	ㄕㄨㄟˇ ㄇㄧㄢˋ
水龍頭	ㄕㄨㄟˇ ㄌㄨㄥˊ ㄊㄡˊ
水手	ㄕㄨㄟˇ ㄕㄡˇ
水溫	ㄕㄨㄟˇ ㄨㄣ
水源	ㄕㄨㄟˇ ㄩㄢˊ
水漲船高	ㄕㄨㄟˇ ㄓㄤˇ-ㄔㄨㄢˊ ㄍㄠ
水域	ㄕㄨㄟˇ ㄩˋ
水準	ㄕㄨㄟˇ ㄓㄨㄣˇ
稅收	ㄕㄨㄟˋ ㄕㄡ
稅務	ㄕㄨㄟˋ ㄨˋ
睡袋	ㄕㄨㄟˋ ㄉㄞˋ
順便	ㄕㄨㄣˋ ㄅㄧㄢˋ
順暢	ㄕㄨㄣˋ ㄔㄤˋ
順差	ㄕㄨㄣˋ ㄔㄚ
順從	ㄕㄨㄣˋ ㄘㄨㄥˊ
順理成章	ㄕㄨㄣˋ ㄌㄧˇ-ㄔㄥˊ ㄓㄤ
順其自然	ㄕㄨㄣˋ ㄑㄧˊ ㄗˋ ㄖㄢˊ
順路	ㄕㄨㄣˋ ㄌㄨˋ
順勢	ㄕㄨㄣˋ ㄕˋ
順手	ㄕㄨㄣˋ ㄕㄡˇ
順心	ㄕㄨㄣˋ ㄒㄧㄣ
順著	ㄕㄨㄣˋ ㄓㄜ˙
順應	ㄕㄨㄣˋ ㄧㄥˋ
說白了	ㄕㄨㄛ ㄅㄞˊ ㄌㄜ˙
說不上	ㄕㄨㄛ ㄅㄨ˙ ㄕㄤˋ
說到底	ㄕㄨㄛ ㄉㄠˋ ㄉㄧˇ
說道	ㄕㄨㄛ ㄉㄠ˙
瞬間	ㄕㄨㄣˋ ㄐㄧㄢ
說幹就幹	ㄕㄨㄛ ㄍㄢˋ ㄐㄧㄡˋ ㄍㄢˋ
說謊	ㄕㄨㄛ ㄏㄨㄤˇ
說老實話	ㄕㄨㄛ ㄌㄠˇ ㄕ˙ ㄏㄨㄚˋ
說起來	ㄕㄨㄛ ㄑㄧˇ ㄌㄞˊ
說閒話	ㄕㄨㄛ ㄒㄧㄢˊ ㄏㄨㄚˋ
說情	ㄕㄨㄛ ㄑㄧㄥˊ
說真的	ㄕㄨㄛ ㄓㄣ ㄉㄜ˙
碩果	ㄕㄨㄛˋ ㄍㄨㄛˇ
司空見慣	ㄙ ㄎㄨㄥ-ㄐㄧㄢˋ ㄍㄨㄢˋ
司令	ㄙ ㄌㄧㄥˋ
司法	ㄙ ㄈㄚˇ
絲綢	ㄙ ㄔㄡˊ
絲	ㄙ
絲毫	ㄙ ㄏㄠˊ
私房錢	ㄙ ㄈㄤ˙ ㄑㄧㄢˊ
私家車	ㄙ ㄐㄧㄚ ㄔㄜ
私立	ㄙ ㄌㄧˋ
私下	ㄙ ㄒㄧㄚˋ
私事	ㄙ ㄕˋ
私營	ㄙ ㄧㄥˊ
私有	ㄙ ㄧㄡˇ
私自	ㄙ ㄗˋ
思念	ㄙ ㄋㄧㄢˋ
思前想後	ㄙ ㄑㄧㄢˊ-ㄒㄧㄤˇ ㄏㄡˋ
思路	ㄙ ㄌㄨˋ
思索	ㄙ ㄙㄨㄛˇ
撕	ㄙ
死心	ㄙˇ ㄒㄧㄣ
死心塌地	ㄙˇ ㄒㄧㄣ-ㄊㄚ ㄉㄧˋ
四合院	ㄙˋ ㄏㄜˊ ㄩㄢˋ
四面八方	ㄙˋ ㄇㄧㄢˋ-ㄅㄚ ㄈㄤ
寺廟	ㄙˋ ㄇㄧㄠˋ
似曾相識	ㄙˋ ㄘㄥˊ ㄒㄧㄤ ㄕˊ
四季	ㄙˋ ㄐㄧˋ
似是而非	ㄙˋ ㄕˋ ㄦˊ ㄈㄟ
伺機	ㄙˋ ㄐㄧ
飼料	ㄙˋ ㄌㄧㄠˋ
飼養	ㄙˋ ㄧㄤˇ
鬆綁	ㄙㄨㄥ ㄅㄤˇ
聳立	ㄙㄨㄥˇ ㄌㄧˋ
鬆弛	ㄙㄨㄥ ㄔˊ
送別	ㄙㄨㄥˋ ㄅㄧㄝˊ
搜集	ㄙㄡ ㄐㄧˊ
搜查	ㄙㄡ ㄔㄚˊ
搜救	ㄙㄡ ㄐㄧㄡˋ
艘	ㄙㄡ
搜尋	ㄙㄡ ㄒㄩㄣˊ
酥	ㄙㄨ
蘇醒	ㄙㄨ ㄒㄧㄥˇ
俗話	ㄙㄨˊ ㄏㄨㄚˋ
俗話說	ㄙㄨˊ ㄏㄨㄚˋ ㄕㄨㄛ
俗	ㄙㄨˊ
訴苦	ㄙㄨˋ ㄎㄨˇ
訴說	ㄙㄨˋ ㄕㄨㄛ
俗語	ㄙㄨˊ ㄩˇ
訴訟	ㄙㄨˋ ㄙㄨㄥˋ
素	ㄙㄨˋ
素不相識	ㄙㄨˋ ㄅㄨˋ ㄒㄧㄤ ㄕˊ
素材	ㄙㄨˋ ㄘㄞˊ
素描	ㄙㄨˋ ㄇㄧㄠˊ
素養	ㄙㄨˋ ㄧㄤˇ
塑造	ㄙㄨˋ ㄗㄠˋ
蒜	ㄙㄨㄢˋ
素食	ㄙㄨˋ ㄕˊ
算計	ㄙㄨㄢˋ ㄐㄧ˙
算盤	ㄙㄨㄢˋ ㄆㄢ˙
算賬	ㄙㄨㄢˋ ㄓㄤˋ
隨處可見	ㄙㄨㄟˊ ㄔㄨˋ ㄎㄜˇ ㄐㄧㄢˋ
隨大溜	ㄙㄨㄟˊ ㄉㄚˋ ㄌㄧㄡˋ
隨機	ㄙㄨㄟˊ ㄐㄧ
雖說	ㄙㄨㄟ ㄕㄨㄛ
隨即	ㄙㄨㄟˊ ㄐㄧˊ
隨身	ㄙㄨㄟˊ ㄕㄣ
隨時隨地	ㄙㄨㄟˊ ㄕˊ-ㄙㄨㄟˊ ㄉㄧˋ
隨心所欲	ㄙㄨㄟˊ ㄒㄧㄣ ㄙㄨㄛˇ ㄩˋ
遂心	ㄙㄨㄟˋ ㄒㄧㄣ
隧道	ㄙㄨㄟˋ ㄉㄠˋ
損壞	ㄙㄨㄣˇ ㄏㄨㄞˋ
損人利己	ㄙㄨㄣˇ ㄖㄣˊ-ㄌㄧˋ ㄐㄧˇ
損傷	ㄙㄨㄣˇ ㄕㄤ
損	ㄙㄨㄣˇ
縮	ㄙㄨㄛ
縮水	ㄙㄨㄛ ㄕㄨㄟˇ
縮影	ㄙㄨㄛ ㄧㄥˇ
所屬	ㄙㄨㄛˇ ㄕㄨˇ
所謂	ㄙㄨㄛˇ ㄨㄟˋ
所作所為	ㄙㄨㄛˇ ㄗㄨㄛˋ-ㄙㄨㄛˇ ㄨㄟˊ
索賠	ㄙㄨㄛˇ ㄆㄟˊ
索性	ㄙㄨㄛˇ ㄒㄧㄥˋ
鎖定	ㄙㄨㄛˇ ㄉㄧㄥˋ
他人	ㄊㄚ ㄖㄣˊ
索取	ㄙㄨㄛˇ ㄑㄩˇ
胎	ㄊㄞ
踏上	ㄊㄚˋ ㄕㄤˋ
塌	ㄊㄚ
檯球	ㄊㄞˊ ㄑㄧㄡˊ
太極	ㄊㄞˋ ㄐㄧˊ
太極拳	ㄊㄞˋ ㄐㄧˊ ㄑㄩㄢˊ
胎兒	ㄊㄞ ㄦˊ
太平	ㄊㄞˋ ㄆㄧㄥˊ
泰斗	ㄊㄞˋ ㄉㄡˇ
貪	ㄊㄢ
貪婪	ㄊㄢ ㄌㄢˊ
貪玩兒	ㄊㄢ ㄨㄢˊ ㄦ˙
攤	ㄊㄢ
貪污	ㄊㄢ ㄨ
癱	ㄊㄢ
癱瘓	ㄊㄢ ㄏㄨㄢˋ
談不上	ㄊㄢˊ ㄅㄨ˙ ㄕㄤˋ
罈	ㄊㄢˊ
談到	ㄊㄢˊ ㄉㄠˋ
談論	ㄊㄢˊ ㄌㄨㄣˋ
彈性	ㄊㄢˊ ㄒㄧㄥˋ
談起	ㄊㄢˊ ㄑㄧˇ
痰	ㄊㄢˊ
坦誠	ㄊㄢˇ ㄔㄥˊ
坦白	ㄊㄢˇ ㄅㄞˊ
坦克	ㄊㄢˇ ㄎㄜˋ
坦然	ㄊㄢˇ ㄖㄢˊ
坦率	ㄊㄢˇ ㄕㄨㄞˋ
探	ㄊㄢˋ
毯子	ㄊㄢˇ ㄗ˙
炭	ㄊㄢˋ
探測	ㄊㄢˋ ㄘㄜˋ
探親	ㄊㄢˋ ㄑㄧㄣ
探求	ㄊㄢˋ ㄑㄧㄡˊ
探望	ㄊㄢˋ ㄨㄤˋ
探險	ㄊㄢˋ ㄒㄧㄢˇ
湯圓	ㄊㄤ ㄩㄢˊ
堂	ㄊㄤˊ
碳	ㄊㄢˋ
糖尿病	ㄊㄤˊ ㄋㄧㄠˋ ㄅㄧㄥˋ
糖果	ㄊㄤˊ ㄍㄨㄛˇ
倘若	ㄊㄤˇ ㄖㄨㄛˋ
淌	ㄊㄤˇ
掏錢	ㄊㄠ ㄑㄧㄢˊ
燙	ㄊㄤˋ
滔滔不絕	ㄊㄠ ㄊㄠ-ㄅㄨˋ ㄐㄩㄝˊ
逃生	ㄊㄠˊ ㄕㄥ
逃避	ㄊㄠˊ ㄅㄧˋ
逃亡	ㄊㄠˊ ㄨㄤˊ
陶冶	ㄊㄠˊ ㄧㄝˇ
陶瓷	ㄊㄠˊ ㄘˊ
陶醉	ㄊㄠˊ ㄗㄨㄟˋ
淘	ㄊㄠˊ
淘氣	ㄊㄠˊ ㄑㄧˋ
淘汰	ㄊㄠˊ ㄊㄞˋ
討好	ㄊㄠˇ ㄏㄠˇ
討價還價	ㄊㄠˇ ㄐㄧㄚˋ-ㄏㄨㄢˊ ㄐㄧㄚˋ
特產	ㄊㄜˋ ㄔㄢˇ
討人喜歡	ㄊㄠˇ ㄖㄣˊ ㄒㄧˇ ㄏㄨㄢ˙
討	ㄊㄠˇ
特長	ㄊㄜˋ ㄔㄤˊ
特例	ㄊㄜˋ ㄌㄧˋ
特權	ㄊㄜˋ ㄑㄩㄢˊ
特質	ㄊㄜˋ ㄓˋ
特製	ㄊㄜˋ ㄓˋ
藤椅	ㄊㄥˊ ㄧˇ
騰	ㄊㄥˊ
特邀	ㄊㄜˋ ㄧㄠ
梯子	ㄊㄧ ㄗ˙
剔除	ㄊㄧ ㄔㄨˊ
提拔	ㄊㄧˊ ㄅㄚ˙
提名	ㄊㄧˊ ㄇㄧㄥˊ
提煉	ㄊㄧˊ ㄌㄧㄢˋ
提速	ㄊㄧˊ ㄙㄨˋ
提心吊膽	ㄊㄧˊ ㄒㄧㄣ-ㄉㄧㄠˋ ㄉㄢˇ
提議	ㄊㄧˊ ㄧˋ
提早	ㄊㄧˊ ㄗㄠˇ
體面	ㄊㄧˇ ㄇㄧㄢ˙
體諒	ㄊㄧˇ ㄌㄧㄤˋ
體貼	ㄊㄧˇ ㄊㄧㄝ
體能	ㄊㄧˇ ㄋㄥˊ
體系	ㄊㄧˇ ㄒㄧˋ
體溫	ㄊㄧˇ ㄨㄣ
體制	ㄊㄧˇ ㄓˋ
剃	ㄊㄧˋ
替換	ㄊㄧˋ ㄏㄨㄢˋ
體質	ㄊㄧˇ ㄓˋ
替身	ㄊㄧˋ ㄕㄣ
天長地久	ㄊㄧㄢ ㄔㄤˊ-ㄉㄧˋ ㄐㄧㄡˇ
天地	ㄊㄧㄢ ㄉㄧˋ
天鵝	ㄊㄧ˙ ㄚ ㄋㄜˊ
天分	ㄊㄧㄢ ㄈㄣˋ
天經地義	ㄊㄧㄢ ㄐㄧㄥ-ㄉㄧˋ ㄧˋ
天平	ㄊㄧㄢ ㄆㄧㄥˊ
天賦	ㄊㄧㄢ ㄈㄨˋ
天橋	ㄊㄧㄢ ㄑㄧㄠˊ
天生	ㄊㄧㄢ ㄕㄥ
天線	ㄊㄧㄢ ㄒㄧㄢˋ
天使	ㄊㄧㄢ ㄕˇ
天性	ㄊㄧㄢ ㄒㄧㄥˋ
天主教	ㄊㄧㄢ ㄓㄨˇ ㄐㄧㄠˋ
甜美	ㄊㄧㄢˊ ㄇㄟˇ
甜蜜	ㄊㄧㄢˊ ㄇㄧˋ
添加	ㄊㄧㄢ ㄐㄧㄚ
填補	ㄊㄧㄢˊ ㄅㄨˇ
填充	ㄊㄧㄢˊ ㄔㄨㄥ
填寫	ㄊㄧㄢˊ ㄒㄧㄝˇ
舔	ㄊㄧㄢˇ
甜頭	ㄊㄧㄢˊ ㄊㄡ˙
挑剔	ㄊㄧㄠ ㄊㄧ˙
條款	ㄊㄧㄠˊ ㄎㄨㄢˇ
條例	ㄊㄧㄠˊ ㄌㄧˋ
條約	ㄊㄧㄠˊ ㄩㄝ
調侃	ㄊㄧㄠˊ ㄎㄢˇ
調控	ㄊㄧㄠˊ ㄎㄨㄥˋ
調料	ㄊㄧㄠˊ ㄌㄧㄠˋ
調試	ㄊㄧㄠˊ ㄕˋ
挑起	ㄊㄧㄠˇ ㄑㄧˇ
挑釁	ㄊㄧㄠˇ ㄒㄧㄣˋ
跳槽	ㄊㄧㄠˋ ㄘㄠˊ
跳傘	ㄊㄧㄠˋ ㄙㄢˇ
跳動	ㄊㄧㄠˋ ㄉㄨㄥˋ
跳躍	ㄊㄧㄠˋ ㄩㄝˋ
貼切	ㄊㄧㄝ ㄑㄧㄝˋ
帖子	ㄊㄧㄝˇ ㄗ˙
貼近	ㄊㄧㄝ ㄐㄧㄣˋ
聽從	ㄊㄧㄥ ㄘㄨㄥˊ
停泊	ㄊㄧㄥˊ ㄅㄛˊ
聽話	ㄊㄧㄥ ㄏㄨㄚˋ
停電	ㄊㄧㄥˊ ㄉㄧㄢˋ
停車位	ㄊㄧㄥˊ ㄔㄜ ㄨㄟˋ
停頓	ㄊㄧㄥˊ ㄉㄨㄣˋ
停放	ㄊㄧㄥˊ ㄈㄤˋ
通暢	ㄊㄨㄥ ㄔㄤˋ
停業	ㄊㄧㄥˊ ㄧㄝˋ
通車	ㄊㄨㄥ ㄔㄜ
通告	ㄊㄨㄥ ㄍㄠˋ
通風	ㄊㄨㄥ ㄈㄥ
通順	ㄊㄨㄥ ㄕㄨㄣˋ
通俗	ㄊㄨㄥ ㄙㄨˊ
通緝	ㄊㄨㄥ ㄐㄧ
通往	ㄊㄨㄥ ㄨㄤˇ
通通	ㄊㄨㄥ ㄊㄨㄥ
通宵	ㄊㄨㄥ ㄒㄧㄠ
通行證	ㄊㄨㄥ ㄒㄧㄥˊ ㄓㄥˋ
同伴	ㄊㄨㄥˊ ㄅㄢˋ
同等	ㄊㄨㄥˊ ㄉㄥˇ
同感	ㄊㄨㄥˊ ㄍㄢˇ
同伙	ㄊㄨㄥˊ ㄏㄨㄛˇ
同步	ㄊㄨㄥˊ ㄅㄨˋ
同類	ㄊㄨㄥˊ ㄌㄟˋ
同盟	ㄊㄨㄥˊ ㄇㄥˊ
同年	ㄊㄨㄥˊ ㄋㄧㄢˊ
同人	ㄊㄨㄥˊ ㄖㄣˊ
同志	ㄊㄨㄥˊ ㄓˋ
同舟共濟	ㄊㄨㄥˊ ㄓㄡ-ㄍㄨㄥˋ ㄐㄧˋ
統籌	ㄊㄨㄥˇ ㄔㄡˊ
銅	ㄊㄨㄥˊ
統統	ㄊㄨㄥˇ ㄊㄨㄥˇ
統治	ㄊㄨㄥˇ ㄓˋ
捅	ㄊㄨㄥˇ
桶	ㄊㄨㄥˇ
筒	ㄊㄨㄥˇ
痛心	ㄊㄨㄥˋ ㄒㄧㄣ
偷看	ㄊㄡ ㄎㄢˋ
痛	ㄊㄨㄥˋ
偷窺	ㄊㄡ ㄎㄨㄟ
偷懶	ㄊㄡ ㄌㄢˇ
頭頂	ㄊㄡˊ ㄉㄧㄥˇ
頭部	ㄊㄡˊ ㄅㄨˋ
頭號	ㄊㄡˊ ㄏㄠˋ
頭條	ㄊㄡˊ ㄊㄧㄠˊ
頭頭是道	ㄊㄡˊ ㄊㄡˊ-ㄕˋ ㄉㄠˋ
頭暈	ㄊㄡˊ ㄩㄣ
投奔	ㄊㄡˊ ㄅㄣˋ
頭銜	ㄊㄡˊ ㄒㄧㄢˊ
投稿	ㄊㄡˊ ㄍㄠˇ
投機	ㄊㄡˊ ㄐㄧ
投射	ㄊㄡˊ ㄕㄜˋ
投身	ㄊㄡˊ ㄕㄣ
投降	ㄊㄡˊ ㄒㄧㄤˊ
透徹	ㄊㄡˋ ㄔㄜˋ
透過	ㄊㄡˋ ㄍㄨㄛˋ
透支	ㄊㄡˋ ㄓ
透氣	ㄊㄡˋ ㄑㄧˋ
凸	ㄊㄨ
凸顯	ㄊㄨ ㄒㄧㄢˇ
突發	ㄊㄨ ㄈㄚ
突破口	ㄊㄨ ㄆㄛˋ ㄎㄡˇ
禿	ㄊㄨ
突擊	ㄊㄨ ㄐㄧ
圖表	ㄊㄨˊ ㄅㄧㄠˇ
圖像	ㄊㄨˊ ㄒㄧㄤˋ
突如其來	ㄊㄨ ㄖㄨˊ ㄑㄧˊ ㄌㄞˊ
圖形	ㄊㄨˊ ㄒㄧㄥˊ
圖紙	ㄊㄨˊ ㄓˇ
塗	ㄊㄨˊ
徒步	ㄊㄨˊ ㄅㄨˋ
屠殺	ㄊㄨˊ ㄕㄚ
土匪	ㄊㄨˇ ㄈㄟˇ
土壤	ㄊㄨˇ ㄖㄤˇ
土生土長	ㄊㄨˇ ㄕㄥ-ㄊㄨˇ ㄓㄤˇ
團聚	ㄊㄨㄢˊ ㄐㄩˋ
團伙	ㄊㄨㄢˊ ㄏㄨㄛˇ
團員	ㄊㄨㄢˊ ㄩㄢˊ
推測	ㄊㄨㄟ ㄘㄜˋ
團圓	ㄊㄨㄢˊ ㄩㄢˊ
推斷	ㄊㄨㄟ ㄉㄨㄢˋ
推翻	ㄊㄨㄟ ㄈㄢ
推辭	ㄊㄨㄟ ㄘˊ
推薦	ㄊㄨㄟ ㄐㄧㄢˋ
推理	ㄊㄨㄟ ㄌㄧˇ
推敲	ㄊㄨㄟ ㄑㄧㄠ
推卸	ㄊㄨㄟ ㄒㄧㄝˋ
推算	ㄊㄨㄟ ㄙㄨㄢˋ
推選	ㄊㄨㄟ ㄒㄩㄢˇ
推移	ㄊㄨㄟ ㄧˊ
頹廢	ㄊㄨㄟˊ ㄈㄟˋ
退回	ㄊㄨㄟˋ ㄏㄨㄟˊ
退卻	ㄊㄨㄟˋ ㄑㄩㄝˋ
退讓	ㄊㄨㄟˋ ㄖㄤˋ
退學	ㄊㄨㄟˋ ㄒㄩㄝˊ
退休金	ㄊㄨㄟˋ ㄒㄧㄡ ㄐㄧㄣ
退縮	ㄊㄨㄟˋ ㄙㄨㄛ
退役	ㄊㄨㄟˋ ㄧˋ
屯	ㄊㄨㄣˊ
拖累	ㄊㄨㄛ ㄌㄟˇ
拖欠	ㄊㄨㄛ ㄑㄧㄢˋ
託付	ㄊㄨㄛ ㄈㄨˋ
拖延	ㄊㄨㄛ ㄧㄢˊ
脫節	ㄊㄨㄛ ㄐㄧㄝˊ
脫口而出	ㄊㄨㄛ ㄎㄡˇ ㄦˊ ㄔㄨ
脫身	ㄊㄨㄛ ㄕㄣ
脫落	ㄊㄨㄛ ㄌㄨㄛˋ
脫穎而出	ㄊㄨㄛ ㄧㄣˇ ㄍㄜˊ ㄦ˙ ㄔㄨ
馱	ㄊㄨㄛˊ
妥當	ㄊㄨㄛˇ ㄉㄤ˙
妥善	ㄊㄨㄛˇ ㄕㄢˋ
妥	ㄊㄨㄛˇ
妥協	ㄊㄨㄛˇ ㄒㄧㄝˊ
拓寬	ㄊㄨㄛˋ ㄎㄨㄢ
唾液	ㄊㄨㄛˋ ㄧㄝˋ
拓展	ㄊㄨㄛˋ ㄓㄢˇ
挖掘	ㄨㄚ ㄐㄩㄝˊ
瓦	ㄨㄚˇ
挖苦	ㄨㄚ ㄎㄨ˙
歪	ㄨㄞ
歪曲	ㄨㄞ ㄑㄩ
外表	ㄨㄞˋ ㄅㄧㄠˇ
外公	ㄨㄞˋ ㄍㄨㄥ
外行	ㄨㄞˋ ㄏㄤˊ
外號	ㄨㄞˋ ㄏㄠˋ
外籍	ㄨㄞˋ ㄐㄧˊ
外貿	ㄨㄞˋ ㄇㄠˋ
外貌	ㄨㄞˋ ㄇㄠˋ
外企	ㄨㄞˋ ㄑㄧˇ
外星人	ㄨㄞˋ ㄒㄧㄥ ㄖㄣˊ
外形	ㄨㄞˋ ㄒㄧㄥˊ
外婆	ㄨㄞˋ ㄆㄛˊ
丸	ㄨㄢˊ
完備	ㄨㄢˊ ㄅㄟˋ
外援	ㄨㄞˋ ㄩㄢˊ
完蛋	ㄨㄢˊ ㄉㄢˋ
完畢	ㄨㄢˊ ㄅㄧˋ
完好	ㄨㄢˊ ㄏㄠˇ
玩耍	ㄨㄢˊ ㄕㄨㄚˇ
玩意兒	ㄨㄢˊ ㄧˋ ㄦ˙
頑固	ㄨㄢˊ ㄍㄨˋ
挽回	ㄨㄢˇ ㄏㄨㄟˊ
挽	ㄨㄢˇ
挽救	ㄨㄢˇ ㄐㄧㄡˋ
晚間	ㄨㄢˇ ㄐㄧㄢ
晚期	ㄨㄢˇ ㄑㄧ
萬分	ㄨㄢˋ ㄈㄣ
惋惜	ㄨㄢˇ ㄒㄧ
萬古長青	ㄨㄢˋ ㄍㄨˇ-ㄔㄤˊ ㄑㄧㄥ
萬能	ㄨㄢˋ ㄋㄥˊ
晚年	ㄨㄢˇ ㄋㄧㄢˊ
萬無一失	ㄨㄢˋ ㄨˊ ㄧ ㄕ
萬萬	ㄨㄢˋ ㄨㄢˋ
汪洋	ㄨㄤ ㄧㄤˊ
亡羊補牢	ㄨㄤˊ ㄧㄤˊ-ㄅㄨˇ ㄌㄠˊ
王國	ㄨㄤˊ ㄍㄨㄛˊ
網點	ㄨㄤˇ ㄉㄧㄢˇ
網民	ㄨㄤˇ ㄇㄧㄣˊ
往常	ㄨㄤˇ ㄔㄤˊ
往返	ㄨㄤˇ ㄈㄢˇ
王牌	ㄨㄤˊ ㄆㄞˊ
往事	ㄨㄤˇ ㄕˋ
妄想	ㄨㄤˋ ㄒㄧㄤˇ
往日	ㄨㄤˇ ㄖˋ
忘掉	ㄨㄤˋ ㄉㄧㄠˋ
忘不了	ㄨㄤˋ ㄅㄨˋ ㄌㄧㄠˇ
旺季	ㄨㄤˋ ㄐㄧˋ
旺盛	ㄨㄤˋ ㄕㄥˋ
望	ㄨㄤˋ
旺	ㄨㄤˋ
危及	ㄨㄟ ㄐㄧˊ
望遠鏡	ㄨㄤˋ ㄩㄢˇ ㄐㄧㄥˋ
危急	ㄨㄟ ㄐㄧˊ
威風	ㄨㄟ ㄈㄥ
威懾	ㄨㄟ ㄕㄜˋ
威力	ㄨㄟ ㄌㄧˋ
威信	ㄨㄟ ㄒㄧㄣˋ
微不足道	ㄨㄟ ㄅㄨˋ ㄗㄨˊ ㄉㄠˋ
微觀	ㄨㄟ ㄍㄨㄢ
微妙	ㄨㄟ ㄇㄧㄠˋ
微型	ㄨㄟ ㄒㄧㄥˊ
微弱	ㄨㄟ ㄖㄨㄛˋ
為人	ㄨㄟˊ ㄖㄣˊ
違約	ㄨㄟˊ ㄩㄝ
違章	ㄨㄟˊ ㄓㄤ
違背	ㄨㄟˊ ㄅㄟˋ
圍牆	ㄨㄟˊ ㄑㄧㄤˊ
唯	ㄨㄟˊ
唯獨	ㄨㄟˊ ㄉㄨˊ
偽造	ㄨㄟˇ ㄗㄠˋ
偽裝	ㄨㄟˇ ㄓㄨㄤ
尾聲	ㄨㄟˇ ㄕㄥ
尾氣	ㄨㄟˇ ㄑㄧˋ
緯度	ㄨㄟˇ ㄉㄨˋ
委婉	ㄨㄟˇ ㄨㄢˇ
委屈	ㄨㄟˇ ㄑㄩ˙
委員	ㄨㄟˇ ㄩㄢˊ
委員會	ㄨㄟˇ ㄩㄢˊ ㄏㄨㄟˋ
萎縮	ㄨㄟˇ ㄙㄨㄛ
未	ㄨㄟˋ
衛視	ㄨㄟˋ ㄕˋ
未成年人	ㄨㄟˋ ㄔㄥˊ ㄋㄧㄢˊ ㄖㄣˊ
未經	ㄨㄟˋ ㄐㄧㄥ
未免	ㄨㄟˋ ㄇㄧㄢˇ
未知數	ㄨㄟˋ ㄓ ㄕㄨˋ
味精	ㄨㄟˋ ㄐㄧㄥ
位子	ㄨㄟˋ ㄗ˙
畏懼	ㄨㄟˋ ㄐㄩˋ
畏縮	ㄨㄟˋ ㄙㄨㄛ
喂養	ㄨㄟˋ ㄧㄤˇ
慰勞	ㄨㄟˋ ㄌㄠˊ
胃口	ㄨㄟˋ ㄎㄡ˙
溫度計	ㄨㄣ ㄉㄨˋ ㄐㄧˋ
溫柔	ㄨㄣ ㄖㄡˊ
溫泉	ㄨㄣ ㄑㄩㄢˊ
溫習	ㄨㄣ ㄒㄧˊ
溫室	ㄨㄣ ㄕˋ
溫馨	ㄨㄣ ㄒㄧㄣ
文	ㄨㄣˊ
瘟疫	ㄨㄣ ㄧˋ
文具	ㄨㄣˊ ㄐㄩˋ
文科	ㄨㄣˊ ㄎㄜ
文憑	ㄨㄣˊ ㄆㄧㄥˊ
文盲	ㄨㄣˊ ㄇㄤˊ
文人	ㄨㄣˊ ㄖㄣˊ
文獻	ㄨㄣˊ ㄒㄧㄢˋ
文雅	ㄨㄣˊ ㄧㄚˇ
聞名	ㄨㄣˊ ㄇㄧㄥˊ
蚊帳	ㄨㄣˊ ㄓㄤˋ
文物	ㄨㄣˊ ㄨˋ
蚊子	ㄨㄣˊ ㄗ˙
吻	ㄨㄣˇ
吻合	ㄨㄣˇ ㄏㄜˊ
紊亂	ㄨㄣˇ ㄌㄨㄢˋ
穩固	ㄨㄣˇ ㄍㄨˋ
穩健	ㄨㄣˇ ㄐㄧㄢˋ
穩重	ㄨㄣˇ ㄓㄨㄥˋ
穩妥	ㄨㄣˇ ㄊㄨㄛˇ
問卷	ㄨㄣˋ ㄐㄩㄢˋ
窩	ㄨㄛ
問世	ㄨㄣˋ ㄕˋ
臥	ㄨㄛˋ
污穢	ㄨ ㄏㄨㄟˋ
巫婆	ㄨ ㄆㄛˊ
嗚咽	ㄨ ㄧㄝˋ
無比	ㄨˊ ㄅㄧˇ
屋頂	ㄨ ㄉㄧㄥˇ
無不	ㄨˊ ㄅㄨˋ
無償	ㄨˊ ㄔㄤˊ
無敵	ㄨˊ ㄉㄧˊ
無惡不作	ㄨˊ ㄜˋ-ㄅㄨˋ ㄗㄨㄛˋ
無非	ㄨˊ ㄈㄟ
無辜	ㄨˊ ㄍㄨ
無關緊要	ㄨˊ ㄍㄨㄢ-ㄐㄧㄣˇ ㄧㄠˋ
無故	ㄨˊ ㄍㄨˋ
無話可說	ㄨˊ ㄏㄨㄚˋ ㄎㄜˇ ㄕㄨㄛ
無家可歸	ㄨˊ ㄐㄧㄚ-ㄎㄜˇ ㄍㄨㄟ
無濟於事	ㄨˊ ㄐㄧˋ-ㄩˊ ㄕˋ
無精打採	ㄨˊ ㄐㄧㄥ-ㄉㄚˇ ㄘㄞˇ
無可奉告	ㄨˊ ㄎㄜˇ-ㄈㄥˋ ㄍㄠˋ
無可厚非	ㄨˊ ㄎㄜˇ-ㄏㄡˋ ㄈㄟ
無理	ㄨˊ ㄌㄧˇ
無可奈何	ㄨˊ ㄎㄜˇ-ㄋㄞˋ ㄏㄜˊ
無力	ㄨˊ ㄌㄧˋ
無論如何	ㄨˊ ㄌㄨㄣˋ ㄖㄨˊ ㄏㄜˊ
無能為力	ㄨˊ ㄋㄥˊ ㄨㄟˊ ㄌㄧˋ
無情	ㄨˊ ㄑㄧㄥˊ
無情無義	ㄨˊ ㄑㄧㄥˊ ㄨˊ ㄧˋ
無窮	ㄨˊ ㄑㄩㄥˊ
無私	ㄨˊ ㄙ
無所事事	ㄨˊ ㄙㄨㄛˇ ㄕˋ ㄕˋ
無所作為	ㄨˊ ㄙㄨㄛˇ ㄗㄨㄛˋ ㄨㄟˊ
無條件	ㄨˊ ㄊㄧㄠˊ ㄐㄧㄢˋ
無微不至	ㄨˊ ㄨㄟ-ㄅㄨˋ ㄓˋ
無能	ㄨˊ ㄋㄥˊ
無線	ㄨˊ ㄒㄧㄢˋ
無線電	ㄨˊ ㄒㄧㄢˋ ㄉㄧㄢˋ
無形	ㄨˊ ㄒㄧㄥˊ
無形中	ㄨˊ ㄒㄧㄥˊ ㄓㄨㄥ
無須	ㄨˊ ㄒㄩ
無意	ㄨˊ ㄧˋ
無憂無慮	ㄨˊ ㄧㄡ-ㄨˊ ㄌㄩˋ
無緣	ㄨˊ ㄩㄢˊ
無足輕重	ㄨˊ ㄗㄨˊ ㄑㄧㄥ ㄓㄨㄥˋ
五花八門	ㄨˇ ㄏㄨㄚ-ㄅㄚ ㄇㄣˊ
無知	ㄨˊ ㄓ
五星級	ㄨˇ ㄒㄧㄥ ㄐㄧˊ
武力	ㄨˇ ㄌㄧˋ
武裝	ㄨˇ ㄓㄨㄤ
捂	ㄨˇ
侮辱	ㄨˇ ㄖㄨˇ
舞廳	ㄨˇ ㄊㄧㄥ
務必	ㄨˋ ㄅㄧˋ
務實	ㄨˋ ㄕˊ
勿	ㄨˋ
物證	ㄨˋ ㄓㄥˋ
物流	ㄨˋ ㄌㄧㄡˊ
物體	ㄨˋ ㄊㄧˇ
誤差	ㄨˋ ㄔㄚ
誤導	ㄨˋ ㄉㄠˇ
物資	ㄨˋ ㄗ
誤區	ㄨˋ ㄑㄩ
霧	ㄨˋ
吸納	ㄒㄧ ㄋㄚˋ
吸取	ㄒㄧ ㄑㄩˇ
息息相關	ㄒㄧ ㄒㄧ-ㄒㄧㄤ ㄍㄨㄢ
昔日	ㄒㄧ ㄖˋ
稀	ㄒㄧ
稀罕	ㄒㄧ ㄏㄢ˙
稀少	ㄒㄧ ㄕㄠˇ
稀奇	ㄒㄧ ㄑㄧˊ
熙熙攘攘	ㄒㄧ ㄒㄧ-ㄖㄤˇ ㄖㄤˇ
熄火	ㄒㄧ ㄏㄨㄛˇ
錫	ㄒㄧ
膝蓋	ㄒㄧ ㄍㄞˋ
嬉笑	ㄒㄧ ㄒㄧㄠˋ
習俗	ㄒㄧˊ ㄙㄨˊ
席	ㄒㄧˊ
席位	ㄒㄧˊ ㄨㄟˋ
襲擊	ㄒㄧˊ ㄐㄧ
洗滌劑	ㄒㄧˇ ㄉㄧˊ ㄐㄧˋ
媳婦	ㄒㄧˊ ㄈㄨˋ
喜出望外	ㄒㄧˇ ㄔㄨ ㄨㄤˋ ㄨㄞˋ
洗禮	ㄒㄧˇ ㄌㄧˇ
喜好	ㄒㄧˇ ㄏㄠˋ
喜怒哀樂	ㄒㄧˇ-ㄋㄨˋ-ㄞ-ㄌㄜˋ
喜酒	ㄒㄧˇ ㄐㄧㄡˇ
喜事	ㄒㄧˇ ㄕˋ
喜慶	ㄒㄧˇ ㄑㄧㄥˋ
喜洋洋	ㄒㄧˇ ㄧㄤˊ ㄧㄤˊ
喜糖	ㄒㄧˇ ㄊㄤˊ
喜悅	ㄒㄧˇ ㄩㄝˋ
細微	ㄒㄧˋ ㄨㄟ
細心	ㄒㄧˋ ㄒㄧㄣ
蝦	ㄒㄧㄚ
細膩	ㄒㄧˋ ㄋㄧˋ
俠義	ㄒㄧㄚˊ ㄧˋ
瞎	ㄒㄧㄚ
峽谷	ㄒㄧㄚˊ ㄍㄨˇ
狹隘	ㄒㄧㄚˊ ㄞˋ
狹小	ㄒㄧㄚˊ ㄒㄧㄠˇ
狹窄	ㄒㄧㄚˊ ㄓㄞˇ
下跌	ㄒㄧㄚˋ ㄉㄧㄝ
下場	ㄒㄧㄚˋ ㄔㄤ˙
下崗	ㄒㄧㄚˋ ㄍㄤˇ
下功夫	ㄒㄧㄚˋ ㄍㄨㄥ ㄈㄨ˙
下海	ㄒㄧㄚˋ ㄏㄞˇ
下決心	ㄒㄧㄚˋ ㄐㄩㄝˊ ㄒㄧㄣ
下令	ㄒㄧㄚˋ ㄌㄧㄥˋ
下級	ㄒㄧㄚˋ ㄐㄧˊ
下落	ㄒㄧㄚˋ ㄌㄨㄛˋ
下棋	ㄒㄧㄚˋ ㄑㄧˊ
下山	ㄒㄧㄚˋ ㄕㄢ
下手	ㄒㄧㄚˋ ㄕㄡˇ
下期	ㄒㄧㄚˋ ㄑㄧ
下屬	ㄒㄧㄚˋ ㄕㄨˇ
下臺	ㄒㄧㄚˋ ㄊㄞˊ
下調	ㄒㄧㄚˋ ㄉㄧㄠˋ
下旬	ㄒㄧㄚˋ ㄒㄩㄣˊ
下鄉	ㄒㄧㄚˋ ㄒㄧㄤ
下一代	ㄒㄧㄚˋ ㄧ ㄉㄞˋ
下游	ㄒㄧㄚˋ ㄧㄡˊ
下意識	ㄒㄧㄚˋ ㄧˋ ㄕ˙
下墜	ㄒㄧㄚˋ ㄓㄨㄟˋ
嚇唬	ㄒㄧㄚˋ ㄏㄨ˙
嚇人	ㄒㄧㄚˋ ㄖㄣˊ
夏令營	ㄒㄧㄚˋ ㄌㄧㄥˋ ㄧㄥˊ
仙鶴	ㄒㄧㄢ ㄏㄜˋ
仙女	ㄒㄧㄢ ㄋㄩˇ
先天	ㄒㄧㄢ ㄊㄧㄢ
先例	ㄒㄧㄢ ㄌㄧˋ
纖維	ㄒㄧㄢ ㄨㄟˊ
掀	ㄒㄧㄢ
掀起	ㄒㄧㄢ ㄑㄧˇ
鮮活	ㄒㄧㄢ ㄏㄨㄛˊ
鮮美	ㄒㄧㄢ ㄇㄟˇ
鮮血	ㄒㄧㄢ ㄒㄩㄝˋ
弦	ㄒㄧㄢˊ
銜接	ㄒㄧㄢˊ ㄐㄧㄝ
嫌棄	ㄒㄧㄢˊ ㄑㄧˋ
顯而易見	ㄒㄧㄚˇ ㄋㄜˊ ㄦ˙ ㄧˋ ㄐㄧㄢˋ
嫌疑	ㄒㄧㄢˊ ㄧˊ
顯赫	ㄒㄧㄢˇ ㄏㄜˋ
顯示器	ㄒㄧㄢˇ ㄕˋ ㄑㄧˋ
顯現	ㄒㄧㄢˇ ㄒㄧㄢˋ
現成	ㄒㄧㄢˋ ㄔㄥˊ
顯眼	ㄒㄧㄢˇ ㄧㄢˇ
現任	ㄒㄧㄢˋ ㄖㄣˋ
現行	ㄒㄧㄢˋ ㄒㄧㄥˊ
限定	ㄒㄧㄢˋ ㄉㄧㄥˋ
限	ㄒㄧㄢˋ
限度	ㄒㄧㄢˋ ㄉㄨˋ
線條	ㄒㄧㄢˋ ㄊㄧㄠˊ
憲法	ㄒㄧㄢˋ ㄈㄚˇ
陷	ㄒㄧㄢˋ
限於	ㄒㄧㄢˋ ㄩˊ
陷阱	ㄒㄧㄢˋ ㄐㄧㄥˇ
餡兒	ㄒㄧㄢˋ ㄦ˙
羨慕	ㄒㄧㄢˋ ㄇㄨˋ
獻血	ㄒㄧㄢˋ ㄒㄧㄝˇ
腺	ㄒㄧㄢˋ
鄉親	ㄒㄧㄤ ㄑㄧㄣ
鄉下	ㄒㄧㄤ ㄒㄧㄚ˙
相伴	ㄒㄧㄤ ㄅㄢˋ
相比之下	ㄒㄧㄤ ㄅㄧˇ ㄓ ㄒㄧㄚˋ
相傳	ㄒㄧㄤ ㄔㄨㄢˊ
相差	ㄒㄧㄤ ㄔㄚˋ
相當於	ㄒㄧㄤ ㄉㄤ ㄩˊ
相對而言	ㄒㄧㄤ ㄉㄨㄟˋ ㄦˊ ㄧㄢˊ
相對	ㄒㄧㄤ ㄉㄨㄟˋ
相輔相成	ㄒㄧㄤ ㄈㄨˇ-ㄒㄧㄤ ㄔㄥˊ
相連	ㄒㄧㄤ ㄌㄧㄢˊ
相繼	ㄒㄧㄤ ㄐㄧˋ
相識	ㄒㄧㄤ ㄕˊ
相提並論	ㄒㄧㄤ ㄊㄧˊ-ㄅㄧㄥˋ ㄌㄨㄣˋ
相依為命	ㄒㄧㄤ ㄧ-ㄨㄟˊ ㄇㄧㄥˋ
相通	ㄒㄧㄤ ㄊㄨㄥ
相約	ㄒㄧㄤ ㄩㄝ
香料	ㄒㄧㄤ ㄌㄧㄠˋ
香水	ㄒㄧㄤ ㄕㄨㄟˇ
相遇	ㄒㄧㄤ ㄩˋ
香味	ㄒㄧㄤ ㄨㄟˋ
香煙	ㄒㄧㄤ ㄧㄢ
香油	ㄒㄧㄤ ㄧㄡˊ
鑲	ㄒㄧㄤ
鑲嵌	ㄒㄧㄤ ㄑㄧㄢˋ
享	ㄒㄧㄤˇ
詳盡	ㄒㄧㄤˊ ㄐㄧㄣˋ
享有	ㄒㄧㄤˇ ㄧㄡˇ
響亮	ㄒㄧㄤˇ ㄌㄧㄤˋ
祥和	ㄒㄧㄤˊ ㄏㄜˊ
響應	ㄒㄧㄤˇ ㄧㄥˋ
響起	ㄒㄧㄤˇ ㄑㄧˇ
想方設法	ㄒㄧㄤˇ ㄈㄤ-ㄕㄜˋ ㄈㄚˇ
向來	ㄒㄧㄤˋ ㄌㄞˊ
嚮往	ㄒㄧㄤˋ ㄨㄤˇ
項鏈	ㄒㄧㄤˋ ㄌㄧㄢˋ
像	ㄒㄧㄤˋ
向著	ㄒㄧㄤˋ ㄓㄜ˙
像樣	ㄒㄧㄤˋ ㄧㄤˋ
橡皮	ㄒㄧㄤˋ ㄆㄧˊ
橡膠	ㄒㄧㄤˋ ㄐㄧㄠ
消	ㄒㄧㄠ
消沉	ㄒㄧㄠ ㄔㄣˊ
削	ㄒㄩㄝ
消遣	ㄒㄧㄠ ㄑㄧㄢˇ
蕭條	ㄒㄧㄠ ㄊㄧㄠˊ
銷	ㄒㄧㄠ
銷毀	ㄒㄧㄠ ㄏㄨㄟˇ
銷量	ㄒㄧㄠ ㄌㄧㄤˋ
瀟灑	ㄒㄧㄠ ㄙㄚˇ
小醜	ㄒㄧㄠˇ ㄔㄡˇ
小販	ㄒㄧㄠˇ ㄈㄢˋ
小看	ㄒㄧㄠˇ ㄎㄢˋ
小康	ㄒㄧㄠˇ ㄎㄤ
小路	ㄒㄧㄠˇ ㄌㄨˋ
小品	ㄒㄧㄠˇ ㄆㄧㄣˇ
小氣	ㄒㄧㄠˇ ㄑㄧ˙
小區	ㄒㄧㄠˇ ㄑㄩ
小曲	ㄒㄧㄠˇ ㄑㄩˇ
小人	ㄒㄧㄠˇ ㄖㄣˊ
小溪	ㄒㄧㄠˇ ㄒㄧ
小提琴	ㄒㄧㄠˇ ㄊㄧˊ ㄑㄧㄣˊ
小心翼翼	ㄒㄧㄠˇ ㄒㄧㄣ-ㄧˋ ㄧˋ
孝敬	ㄒㄧㄠˋ ㄐㄧㄥˋ
小卒	ㄒㄧㄠˇ ㄗㄨˊ
孝順	ㄒㄧㄠˋ ㄕㄨㄣ˙
效仿	ㄒㄧㄠˋ ㄈㄤˇ
肖像	ㄒㄧㄠˋ ㄒㄧㄤˋ
效益	ㄒㄧㄠˋ ㄧˋ
效應	ㄒㄧㄠˋ ㄧㄥˋ
協定	ㄒㄧㄝˊ ㄉㄧㄥˋ
效力	ㄒㄧㄠˋ ㄌㄧˋ
協同	ㄒㄧㄝˊ ㄊㄨㄥˊ
邪	ㄒㄧㄝˊ
協作	ㄒㄧㄝˊ ㄗㄨㄛˋ
邪惡	ㄒㄧㄝˊ ㄜˋ
挾持	ㄒㄧㄝˊ ㄔˊ
攜帶	ㄒㄧㄝˊ ㄉㄞˋ
攜手	ㄒㄧㄝˊ ㄕㄡˇ
寫照	ㄒㄧㄝˇ ㄓㄠˋ
泄	ㄒㄧㄝˋ
泄露	ㄒㄧㄝˋ ㄌㄨˋ
泄密	ㄒㄧㄝˋ ㄇㄧˋ
泄氣	ㄒㄧㄝˋ ㄑㄧˋ
泄漏	ㄒㄧㄝˋ ㄌㄡˋ
瀉	ㄒㄧㄝˋ
心愛	ㄒㄧ ㄋㄞˋ
心安理得	ㄒㄧ ㄋㄢ-ㄌㄧˇ ㄉㄜˊ
心病	ㄒㄧㄣ ㄅㄧㄥˋ
心腸	ㄒㄧㄣ ㄔㄤˊ
卸	ㄒㄧㄝˋ
心得	ㄒㄧㄣ ㄉㄜˊ
心急如焚	ㄒㄧㄣ ㄐㄧˊ-ㄖㄨˊ ㄈㄣˊ
心慌	ㄒㄧㄣ ㄏㄨㄤ
心裡話	ㄒㄧㄣ ㄌㄧ˙ ㄏㄨㄚˋ
心靈手巧	ㄒㄧㄣ ㄌㄧㄥˊ ㄕㄡˇ ㄑㄧㄠˇ
心目	ㄒㄧㄣ ㄇㄨˋ
心聲	ㄒㄧㄣ ㄕㄥ
心思	ㄒㄧㄣ ㄙ˙
心事	ㄒㄧㄣ ㄕ˙
心酸	ㄒㄧㄣ ㄙㄨㄢ
心胸	ㄒㄧㄣ ㄒㄩㄥ
心想事成	ㄒㄧㄣ ㄒㄧㄤˇ-ㄕˋ ㄔㄥˊ
心眼兒	ㄒㄧㄣ ㄧㄢˇ ㄦ˙
心血	ㄒㄧㄣ ㄒㄩㄝˋ
心意	ㄒㄧㄣ ㄧˋ
芯片	ㄒㄧㄣ ㄆㄧㄢˋ
辛酸	ㄒㄧㄣ ㄙㄨㄢ
欣慰	ㄒㄧㄣ ㄨㄟˋ
辛勤	ㄒㄧㄣ ㄑㄧㄣˊ
欣欣向榮	ㄒㄧㄣ ㄒㄧㄣ-ㄒㄧㄤˋ ㄖㄨㄥˊ
新潮	ㄒㄧㄣ ㄔㄠˊ
欣喜	ㄒㄧㄣ ㄒㄧˇ
新陳代謝	ㄒㄧㄣ ㄔㄣˊ-ㄉㄞˋ ㄒㄧㄝˋ
新款	ㄒㄧㄣ ㄎㄨㄢˇ
新房	ㄒㄧㄣ ㄈㄤˊ
新奇	ㄒㄧㄣ ㄑㄧˊ
新生	ㄒㄧㄣ ㄕㄥ
新手	ㄒㄧㄣ ㄕㄡˇ
新穎	ㄒㄧㄣ ㄧㄥˇ
新式	ㄒㄧㄣ ㄕˋ
信貸	ㄒㄧㄣˋ ㄉㄞˋ
信件	ㄒㄧㄣˋ ㄐㄧㄢˋ
信譽	ㄒㄧㄣˋ ㄩˋ
信賴	ㄒㄧㄣˋ ㄌㄞˋ
興建	ㄒㄧㄥ ㄐㄧㄢˋ
興奮劑	ㄒㄧㄥ ㄈㄣˋ ㄐㄧˋ
興起	ㄒㄧㄥ ㄑㄧˇ
猩猩	ㄒㄧㄥ ㄒㄧㄥ˙
星座	ㄒㄧㄥ ㄗㄨㄛˋ
腥	ㄒㄧㄥ
刑法	ㄒㄧㄥˊ ㄈㄚ˙
行使	ㄒㄧㄥˊ ㄕˇ
行政	ㄒㄧㄥˊ ㄓㄥˋ
行走	ㄒㄧㄥˊ ㄗㄡˇ
形形色色	ㄒㄧㄥˊ ㄒㄧㄥˊ-ㄙㄜˋ ㄙㄜˋ
形影不離	ㄒㄧㄥˊ ㄧㄥˇ-ㄅㄨˋ ㄌㄧˊ
醒來	ㄒㄧㄥˇ ㄌㄞˊ
醒悟	ㄒㄧㄥˇ ㄨˋ
興高采烈	ㄒㄧㄥˋ ㄍㄠ-ㄘㄞˇ ㄌㄧㄝˋ
醒目	ㄒㄧㄥˇ ㄇㄨˋ
興致	ㄒㄧㄥˋ ㄓˋ
幸存	ㄒㄧㄥˋ ㄘㄨㄣˊ
幸好	ㄒㄧㄥˋ ㄏㄠˇ
幸虧	ㄒㄧㄥˋ ㄎㄨㄟ
幸免	ㄒㄧㄥˋ ㄇㄧㄢˇ
性價比	ㄒㄧㄥˋ ㄐㄧㄚˋ ㄅㄧˇ
性情	ㄒㄧㄥˋ ㄑㄧㄥˊ
性命	ㄒㄧㄥˋ ㄇㄧㄥˋ
姓氏	ㄒㄧㄥˋ ㄕˋ
凶殘	ㄒㄩㄥ ㄘㄢˊ
凶惡	ㄒㄩㄥ ㄜˋ
凶猛	ㄒㄩㄥ ㄇㄥˇ
洶涌	ㄒㄩㄥ ㄩㄥˇ
胸膛	ㄒㄩㄥ ㄊㄤˊ
凶狠	ㄒㄩㄥ ㄏㄣˇ
胸有成竹	ㄒㄩㄥ ㄧㄡˇ ㄔㄥˊ ㄓㄨˊ
雄厚	ㄒㄩㄥˊ ㄏㄡˋ
休克	ㄒㄧㄡ ㄎㄜˋ
休眠	ㄒㄧㄡ ㄇㄧㄢˊ
休想	ㄒㄧㄡ ㄒㄧㄤˇ
休養	ㄒㄧㄡ ㄧㄤˇ
修補	ㄒㄧㄡ ㄅㄨˇ
修長	ㄒㄧㄡ ㄔㄤˊ
修正	ㄒㄧㄡ ㄓㄥˋ
羞愧	ㄒㄧㄡ ㄎㄨㄟˋ
修訂	ㄒㄧㄡ ㄉㄧㄥˋ
秀麗	ㄒㄧㄡˋ ㄌㄧˋ
修路	ㄒㄧㄡ ㄌㄨˋ
秀美	ㄒㄧㄡˋ ㄇㄟˇ
袖手旁觀	ㄒㄧㄡˋ ㄕㄡˇ-ㄆㄤˊ ㄍㄨㄢ
鏽	ㄒㄧㄡˋ
嗅覺	ㄒㄧㄡˋ ㄐㄩㄝˊ
繡	ㄒㄧㄡˋ
須	ㄒㄩ
虛	ㄒㄩ
虛構	ㄒㄩ ㄍㄡˋ
虛幻	ㄒㄩ ㄏㄨㄢˋ
虛擬	ㄒㄩ ㄋㄧˇ
虛假	ㄒㄩ ㄐㄧㄚˇ
虛弱	ㄒㄩ ㄖㄨㄛˋ
虛偽	ㄒㄩ ㄨㄟˇ
徐徐	ㄒㄩˊ ㄒㄩˊ
許	ㄒㄩˇ
需	ㄒㄩ
許可證	ㄒㄩˇ ㄎㄜˇ ㄓㄥˋ
旭日	ㄒㄩˋ ㄖˋ
序	ㄒㄩˋ
序幕	ㄒㄩˋ ㄇㄨˋ
敘述	ㄒㄩˋ ㄕㄨˋ
酗酒	ㄒㄩˋ ㄐㄧㄡˇ
宣稱	ㄒㄩㄢ ㄔㄥ
續	ㄒㄩˋ
絮叨	ㄒㄩˋ ㄉㄠ˙
宣讀	ㄒㄩㄢ ㄉㄨˊ
宣告	ㄒㄩㄢ ㄍㄠˋ
宣誓	ㄒㄩㄢ ㄕˋ
宣言	ㄒㄩㄢ ㄧㄢˊ
宣泄	ㄒㄩㄢ ㄒㄧㄝˋ
宣揚	ㄒㄩㄢ ㄧㄤˊ
喧嘩	ㄒㄩㄢ ㄏㄨㄚˊ
喧鬧	ㄒㄩㄢ ㄋㄠˋ
玄	ㄒㄩㄢˊ
玄機	ㄒㄩㄢˊ ㄐㄧ
懸掛	ㄒㄩㄢˊ ㄍㄨㄚˋ
懸念	ㄒㄩㄢˊ ㄋㄧㄢˋ
懸殊	ㄒㄩㄢˊ ㄕㄨ
懸崖	ㄒㄩㄢˊ ㄧㄚˊ
旋律	ㄒㄩㄢˊ ㄌㄩˋ
選民	ㄒㄩㄢˇ ㄇㄧㄣˊ
選項	ㄒㄩㄢˇ ㄒㄧㄤˋ
旋渦	ㄒㄩㄢˊ ㄨㄛ
選用	ㄒㄩㄢˇ ㄩㄥˋ
炫耀	ㄒㄩㄢˋ ㄧㄠˋ
削弱	ㄒㄩㄝ ㄖㄨㄛˋ
靴子	ㄒㄩㄝ ㄗ˙
穴位	ㄒㄩㄝˊ ㄨㄟˋ
學歷	ㄒㄩㄝˊ ㄌㄧˋ
學士	ㄒㄩㄝˊ ㄕˋ
學說	ㄒㄩㄝˊ ㄕㄨㄛ
學堂	ㄒㄩㄝˊ ㄊㄤˊ
學藝	ㄒㄩㄝˊ ㄧˋ
學業	ㄒㄩㄝˊ ㄧㄝˋ
學子	ㄒㄩㄝˊ ㄗˇ
雪山	ㄒㄩㄝˇ ㄕㄢ
雪上加霜	ㄒㄩㄝˇ ㄕㄤˋ-ㄐㄧㄚ ㄕㄨㄤ
血脈	ㄒㄩㄝˋ ㄇㄞˋ
血栓	ㄒㄩㄝˋ ㄕㄨㄢ
血壓	ㄒㄩㄝˋ ㄧㄚ
血緣	ㄒㄩㄝˋ ㄩㄢˊ
勛章	ㄒㄩㄣ ㄓㄤ
薰陶	ㄒㄩㄣ ㄊㄠˊ
熏	ㄒㄩㄣ
尋	ㄒㄩㄣˊ
尋覓	ㄒㄩㄣˊ ㄇㄧˋ
尋常	ㄒㄩㄣˊ ㄔㄤˊ
巡邏	ㄒㄩㄣˊ ㄌㄨㄛˊ
循序漸進	ㄒㄩㄣˊ ㄒㄩˋ-ㄐㄧㄢˋ ㄐㄧㄣˋ
馴	ㄒㄩㄣˋ
遜色	ㄒㄩㄣˋ ㄙㄜˋ
丫頭	ㄧㄚ ㄊㄡ˙
訓	ㄒㄩㄣˋ
壓倒	ㄧㄚ ㄉㄠˇ
壓抑	ㄧㄚ ㄧˋ
壓縮	ㄧㄚ ㄙㄨㄛ
壓制	ㄧㄚ ㄓˋ
押	ㄧㄚ
鴉雀無聲	ㄧㄚ ㄑㄩㄝˋ-ㄨˊ ㄕㄥ
牙齒	ㄧㄚˊ ㄔˇ
牙膏	ㄧㄚˊ ㄍㄠ
啞	ㄧㄚˇ
咽喉	ㄧㄢ ㄏㄡˊ
芽	ㄧㄚˊ
煙囪	ㄧㄢ ㄘㄨㄥ
煙火	ㄧㄢ ㄏㄨㄛ˙
淹	ㄧㄢ
延	ㄧㄢˊ
延緩	ㄧㄢˊ ㄏㄨㄢˇ
延誤	ㄧㄢˊ ㄨˋ
嚴謹	ㄧㄢˊ ㄐㄧㄣˇ
嚴禁	ㄧㄢˊ ㄐㄧㄣˋ
嚴峻	ㄧㄢˊ ㄐㄩㄣˋ
言辭	ㄧㄢˊ ㄘˊ
嚴密	ㄧㄢˊ ㄇㄧˋ
言論	ㄧㄢˊ ㄌㄨㄣˋ
言行	ㄧㄢˊ ㄒㄧㄥˊ
岩石	ㄧㄢˊ ㄕˊ
炎癥	ㄧㄢˊ ㄓㄥˋ
炎熱	ㄧㄢˊ ㄖㄜˋ
沿途	ㄧㄢˊ ㄊㄨˊ
沿線	ㄧㄢˊ ㄒㄧㄢˋ
沿岸	ㄧㄚˊ ㄋㄢˋ
閻王	ㄧㄢˊ ㄨㄤ˙
研討	ㄧㄢˊ ㄊㄠˇ
衍生	ㄧㄢˇ ㄕㄥ
掩蓋	ㄧㄢˇ ㄍㄞˋ
掩護	ㄧㄢˇ ㄏㄨˋ
掩飾	ㄧㄢˇ ㄕˋ
眼紅	ㄧㄢˇ ㄏㄨㄥˊ
眼色	ㄧㄢˇ ㄙㄜˋ
眼界	ㄧㄢˇ ㄐㄧㄝˋ
眼神	ㄧㄢˇ ㄕㄣˊ
眼下	ㄧㄢˇ ㄒㄧㄚˋ
演變	ㄧㄢˇ ㄅㄧㄢˋ
演播室	ㄧㄢˇ ㄅㄛ ㄕˋ
演練	ㄧㄢˇ ㄌㄧㄢˋ
演技	ㄧㄢˇ ㄐㄧˋ
演示	ㄧㄢˇ ㄕˋ
演說	ㄧㄢˇ ㄕㄨㄛ
演習	ㄧㄢˇ ㄒㄧˊ
演戲	ㄧㄢˇ ㄒㄧˋ
演藝圈	ㄧㄢˇ ㄧˋ ㄑㄩㄢ
演繹	ㄧㄢˇ ㄧˋ
厭煩	ㄧㄢˋ ㄈㄢˊ
厭倦	ㄧㄢˋ ㄐㄩㄢˋ
咽	ㄧㄢˋ
艷麗	ㄧㄢˋ ㄌㄧˋ
驗收	ㄧㄢˋ ㄕㄡ
驗	ㄧㄢˋ
驗證	ㄧㄢˋ ㄓㄥˋ
燕子	ㄧㄢˋ ㄗ˙
焰火	ㄧㄢˋ ㄏㄨㄛˇ
秧歌	ㄧㄤ ㄍㄜ˙
陽性	ㄧㄤˊ ㄒㄧㄥˋ
揚	ㄧㄤˊ
楊樹	ㄧㄤˊ ㄕㄨˋ
洋溢	ㄧㄤˊ ㄧˋ
養老金	ㄧㄤˇ ㄌㄠˇ ㄐㄧㄣ
養老院	ㄧㄤˇ ㄌㄠˇ ㄩㄢˋ
養活	ㄧㄤˇ ㄏㄨㄛ˙
養生	ㄧㄤˇ ㄕㄥ
氧	ㄧㄤˇ
養殖	ㄧㄤˇ ㄓˊ
癢	ㄧㄤˇ
樣本	ㄧㄤˋ ㄅㄣˇ
樣品	ㄧㄤˋ ㄆㄧㄣˇ
妖怪	ㄧㄠ ㄍㄨㄞˋ
邀	ㄧㄠ
謠言	ㄧㄠˊ ㄧㄢˊ
窯	ㄧㄠˊ
搖擺	ㄧㄠˊ ㄅㄞˇ
搖滾	ㄧㄠˊ ㄍㄨㄣˇ
搖晃	ㄧㄠˊ ㄏㄨㄤ˙
搖搖欲墜	ㄧㄠˊ ㄧㄠˊ-ㄩˋ ㄓㄨㄟˋ
搖籃	ㄧㄠˊ ㄌㄢˊ
遙控	ㄧㄠˊ ㄎㄨㄥˋ
遙遠	ㄧㄠˊ ㄩㄢˇ
藥材	ㄧㄠˋ ㄘㄞˊ
藥方	ㄧㄠˋ ㄈㄤ
要不是	ㄧㄠˋ ㄅㄨ˙ ㄕ˙
要不	ㄧㄠˋ ㄅㄨˋ
要點	ㄧㄠˋ ㄉㄧㄢˇ
要害	ㄧㄠˋ ㄏㄞˋ
要緊	ㄧㄠˋ ㄐㄧㄣˇ
要領	ㄧㄠˋ ㄌㄧㄥˇ
要強	ㄧㄠˋ ㄑㄧㄤˊ
鑰匙	ㄧㄠˋ ㄕ˙
要命	ㄧㄠˋ ㄇㄧㄥˋ
耀眼	ㄧㄠˋ ㄧㄢˇ
椰子	ㄧㄝ ㄗ˙
也就是說	ㄧㄝˇ ㄐㄧㄡˋ ㄕˋ ㄕㄨㄛ
野炊	ㄧㄝˇ ㄔㄨㄟ
野餐	ㄧㄝˇ ㄘㄢ
野蠻	ㄧㄝˇ ㄇㄢˊ
野獸	ㄧㄝˇ ㄕㄡˋ
野外	ㄧㄝˇ ㄨㄞˋ
野心	ㄧㄝˇ ㄒㄧㄣ
野營	ㄧㄝˇ ㄧㄥˊ
業	ㄧㄝˋ
夜班	ㄧㄝˋ ㄅㄢ
業績	ㄧㄝˋ ㄐㄧˋ
夜市	ㄧㄝˋ ㄕˋ
夜校	ㄧㄝˋ ㄒㄧㄠˋ
夜晚	ㄧㄝˋ ㄨㄢˇ
夜以繼日	ㄧㄝˋ ㄧˇ ㄐㄧˋ ㄖˋ
夜總會	ㄧㄝˋ ㄗㄨㄥˇ ㄏㄨㄟˋ
液晶	ㄧㄝˋ ㄐㄧㄥ
一把手	ㄧ ㄅㄚˇ ㄕㄡˇ
液體	ㄧㄝˋ ㄊㄧˇ
一線	ㄧ ㄒㄧㄢˋ
一一	ㄧ ㄧ
伊斯蘭教	ㄧ ㄙ ㄌㄢˊ ㄐㄧㄠˋ
衣食住行	ㄧ-ㄕˊ-ㄓㄨˋ-ㄒㄧㄥˊ
依	ㄧ
醫務	ㄧ ㄨˋ
依託	ㄧ ㄊㄨㄛ
依依不捨	ㄧ ㄧ-ㄅㄨˋ ㄕㄜˇ
一不小心	ㄧ ㄅㄨˋ ㄒㄧㄠˇ ㄒㄧㄣ
一剎那	ㄧ ㄔㄚˋ ㄋㄚˋ
一動不動	ㄧ ㄉㄨㄥˋ ㄅㄨˋ ㄉㄨㄥˋ
一度	ㄧ ㄉㄨˋ
一大早	ㄧ ㄉㄚˋ ㄗㄠˇ
一概	ㄧ ㄍㄞˋ
一概而論	ㄧ ㄍㄞˋ ㄦˊ ㄌㄨㄣˋ
一個勁兒	ㄧ ㄍㄜ˙ ㄐㄧㄣˋ ㄦ˙
一技之長	ㄧ ㄐㄧˋ ㄓ ㄔㄤˊ
一面	ㄧ ㄇㄧㄢˋ
一晃	ㄧ ㄏㄨㄤˇ
一目了然	ㄧ ㄇㄨˋ-ㄌㄧㄠˇ ㄖㄢˊ
一事無成	ㄧ ㄕˋ-ㄨˊ ㄔㄥˊ
一瞬間	ㄧ ㄕㄨㄣˋ ㄐㄧㄢ
一味	ㄧ ㄨㄟˋ
一系列	ㄧ ㄒㄧˋ ㄌㄧㄝˋ
一陣	ㄧ ㄓㄣˋ
儀表	ㄧˊ ㄅㄧㄠˇ
移交	ㄧˊ ㄐㄧㄠ
移植	ㄧˊ ㄓˊ
姨	ㄧˊ
遺留	ㄧˊ ㄌㄧㄡˊ
遺棄	ㄧˊ ㄑㄧˋ
遺忘	ㄧˊ ㄨㄤˋ
遺物	ㄧˊ ㄨˋ
遺體	ㄧˊ ㄊㄧˇ
遺囑	ㄧˊ ㄓㄨˇ
遺願	ㄧˊ ㄩㄢˋ
疑點	ㄧˊ ㄉㄧㄢˇ
遺址	ㄧˊ ㄓˇ
疑惑	ㄧˊ ㄏㄨㄛˋ
疑慮	ㄧˊ ㄌㄩˋ
以	ㄧˇ
以身作則	ㄧˇ ㄕㄣ-ㄗㄨㄛˋ ㄗㄜˊ
以免	ㄧˇ ㄇㄧㄢˇ
以至於	ㄧˇ ㄓˋ ㄩˊ
矣	ㄧˇ
以致	ㄧˇ ㄓˋ
倚	ㄧˇ
一成不變	ㄧ ㄔㄥˊ-ㄅㄨˋ ㄅㄧㄢˋ
一長一短	ㄧ ㄔㄤˊ ㄧ ㄉㄨㄢˇ
一籌莫展	ㄧ ㄔㄡˊ-ㄇㄛˋ ㄓㄢˇ
一帆風順	ㄧ ㄈㄢ-ㄈㄥ ㄕㄨㄣˋ
一乾二淨	ㄧ ㄍㄢ-ㄦˋ ㄐㄧㄥˋ
一鼓作氣	ㄧ ㄍㄨˇ-ㄗㄨㄛˋ ㄑㄧˋ
一鍋粥	ㄧ ㄍㄨㄛ ㄓㄡ
一回事	ㄧ ㄏㄨㄟˊ ㄕˋ
一家人	ㄧ ㄐㄧㄚ ㄖㄣˊ
一舉	ㄧ ㄐㄩˇ
一經	ㄧ ㄐㄧㄥ
一舉一動	ㄧ ㄐㄩˇ-ㄧ ㄉㄨㄥˋ
一卡通	ㄧ ㄎㄚˇ ㄊㄨㄥ
一攬子	ㄧ ㄌㄢˇ ㄗ˙
一連	ㄧ ㄌㄧㄢˊ
一連串	ㄧ ㄌㄧㄢˊ ㄔㄨㄢˋ
一毛不拔	ㄧ ㄇㄠˊ-ㄅㄨˋ ㄅㄚˊ
一年到頭	ㄧ ㄋㄧㄢˊ-ㄉㄠˋ ㄊㄡˊ
一如既往	ㄧ ㄖㄨˊ-ㄐㄧˋ ㄨㄤˇ
一旁	ㄧ ㄆㄤˊ
一聲不吭	ㄧ ㄕㄥ ㄅㄨˋ ㄎㄥ
一塌糊塗	ㄧ ㄊㄚ ㄏㄨˊ ㄊㄨˊ
一體	ㄧ ㄊㄧˇ
一手	ㄧ ㄕㄡˇ
一天到晚	ㄧ ㄊㄧㄢ-ㄉㄠˋ ㄨㄢˇ
一頭	ㄧ ㄊㄡˊ
一無所有	ㄧ ㄨˊ-ㄙㄨㄛˇ ㄧㄡˇ
一無所知	ㄧ ㄨˊ-ㄙㄨㄛˇ ㄓ
一心	ㄧ ㄒㄧㄣ
一心一意	ㄧ ㄒㄧㄣ-ㄧ ㄧˋ
一言不發	ㄧ ㄧㄢˊ-ㄅㄨˋ ㄈㄚ
一言一行	ㄧ ㄧㄢˊ-ㄧˋ ㄒㄧㄥˊ
一應俱全	ㄧ ㄧㄥ-ㄐㄩˋ ㄑㄩㄢˊ
一早	ㄧ ㄗㄠˇ
一眼	ㄧ ㄧㄢˇ
義工	ㄧˋ ㄍㄨㄥ
議程	ㄧˋ ㄔㄥˊ
議會	ㄧˋ ㄏㄨㄟˋ
議	ㄧˋ
議員	ㄧˋ ㄩㄢˊ
屹立	ㄧˋ ㄌㄧˋ
亦	ㄧˋ
異想天開	ㄧˋ ㄒㄧㄤˇ-ㄊㄧㄢ ㄎㄞ
異性	ㄧˋ ㄒㄧㄥˋ
異議	ㄧˋ ㄧˋ
異口同聲	ㄧˋ ㄎㄡˇ-ㄊㄨㄥˊ ㄕㄥ
抑鬱	ㄧˋ ㄩˋ
抑揚頓挫	ㄧˋ ㄧㄤˊ-ㄉㄨㄣˋ ㄘㄨㄛˋ
抑制	ㄧˋ ㄓˋ
抑鬱症	ㄧˋ ㄩˋ ㄓㄥˋ
譯	ㄧˋ
疫苗	ㄧˋ ㄇㄧㄠˊ
易拉罐	ㄧˋ ㄌㄚ ㄍㄨㄢˋ
意料	ㄧˋ ㄌㄧㄠˋ
意料之外	ㄧˋ ㄌㄧㄠˋ ㄓ ㄨㄞˋ
意圖	ㄧˋ ㄊㄨˊ
意向	ㄧˋ ㄒㄧㄤˋ
益處	ㄧˋ ㄔㄨ˙
溢	ㄧˋ
毅然	ㄧˋ ㄖㄢˊ
毅力	ㄧˋ ㄌㄧˋ
陰暗	ㄧ ㄋㄢˋ
因人而異	ㄧㄣ ㄖㄜˊ ㄋㄜˊ ㄦ˙ ㄧˋ
音響	ㄧㄣ ㄒㄧㄤˇ
陰性	ㄧㄣ ㄒㄧㄥˋ
殷勤	ㄧㄣ ㄑㄧㄣˊ
銀幕	ㄧㄣˊ ㄇㄨˋ
引發	ㄧㄣˇ ㄈㄚ
引經據典	ㄧㄣˇ ㄐㄧㄥ-ㄐㄩˋ ㄉㄧㄢˇ
引擎	ㄧㄣˇ ㄑㄧㄥˊ
引領	ㄧㄣˇ ㄌㄧㄥˇ
引入	ㄧㄣˇ ㄖㄨˋ
引人注目	ㄧㄣˇ ㄖㄣˊ-ㄓㄨˋ ㄇㄨˋ
引誘	ㄧㄣˇ ㄧㄡˋ
引用	ㄧㄣˇ ㄩㄥˋ
飲水	ㄧㄣˇ ㄕㄨㄟˇ
飲用水	ㄧㄣˇ ㄩㄥˋ ㄕㄨㄟˇ
隱蔽	ㄧㄣˇ ㄅㄧˋ
隱患	ㄧㄣˇ ㄏㄨㄢˋ
隱情	ㄧㄣˇ ㄑㄧㄥˊ
隱瞞	ㄧㄣˇ ㄇㄢˊ
隱身	ㄧㄣˇ ㄕㄣ
隱形	ㄧㄣˇ ㄒㄧㄥˊ
隱性	ㄧㄣˇ ㄒㄧㄥˋ
隱約	ㄧㄣˇ ㄩㄝ
癮	ㄧㄣˇ
印章	ㄧㄣˋ ㄓㄤ
印刷術	ㄧㄣˋ ㄕㄨㄚ ㄕㄨˋ
印證	ㄧㄣˋ ㄓㄥˋ
應有盡有	ㄧㄥ ㄧㄡˇ-ㄐㄧㄣˋ ㄧㄡˇ
英俊	ㄧㄥ ㄐㄩㄣˋ
英鎊	ㄧㄥ ㄅㄤˋ
嬰兒	ㄧㄣ ㄍㄜˊ ㄦ˙
鷹	ㄧㄥ
迎合	ㄧㄥˊ ㄏㄜˊ
迎	ㄧㄥˊ
熒光	ㄧㄥˊ ㄍㄨㄤ
盈利	ㄧㄥˊ ㄌㄧˋ
營救	ㄧㄥˊ ㄐㄧㄡˋ
贏家	ㄧㄥˊ ㄐㄧㄚ˙
營造	ㄧㄥˊ ㄗㄠˋ
影像	ㄧㄥˇ ㄒㄧㄤˋ
應酬	ㄧㄥˋ ㄔㄡ˙
應付	ㄧㄥ ㄈㄨˋ
應聘	ㄧㄥˋ ㄆㄧㄣˋ
應邀	ㄧㄥˋ ㄧㄠ
硬幣	ㄧㄥˋ ㄅㄧˋ
映	ㄧㄥˋ
硬盤	ㄧㄥˋ ㄆㄢˊ
擁護	ㄩㄥ ㄏㄨˋ
擁擠	ㄩㄥ ㄐㄧˇ
庸俗	ㄩㄥ ㄙㄨˊ
硬朗	ㄧㄥˋ ㄌㄤ˙
永恆	ㄩㄥˇ ㄏㄥˊ
永久	ㄩㄥˇ ㄐㄧㄡˇ
永不	ㄩㄥˇ ㄅㄨˋ
勇往直前	ㄩㄥˇ ㄨㄤˇ-ㄓˊ ㄑㄧㄢˊ
勇於	ㄩㄥˇ ㄩˊ
涌	ㄩㄥˇ
湧入	ㄩㄥˇ ㄖㄨˋ
涌現	ㄩㄥˇ ㄒㄧㄢˋ
用餐	ㄩㄥˋ ㄘㄢ
踴躍	ㄩㄥˇ ㄩㄝˋ
用人	ㄩㄥˋ ㄖㄣ˙
用力	ㄩㄥˋ ㄌㄧˋ
用功	ㄩㄥˋ ㄍㄨㄥ
優	ㄧㄡ
用意	ㄩㄥˋ ㄧˋ
優化	ㄧㄡ ㄏㄨㄚˋ
優異	ㄧㄡ ㄧˋ
優越	ㄧㄡ ㄩㄝˋ
優雅	ㄧㄡ ㄧㄚˇ
憂愁	ㄧㄡ ㄔㄡˊ
憂慮	ㄧㄡ ㄌㄩˋ
悠久	ㄧㄡ ㄐㄧㄡˇ
憂鬱	ㄧㄡ ㄩˋ
悠閒	ㄧㄡ ㄒㄧㄢˊ
尤為	ㄧㄡˊ ㄨㄟˊ
由此看來	ㄧㄡˊ ㄘˇ ㄎㄢˋ ㄌㄞˊ
由來	ㄧㄡˊ ㄌㄞˊ
由此可見	ㄧㄡˊ ㄘˇ-ㄎㄜˇ ㄐㄧㄢˋ
郵編	ㄧㄡˊ ㄅㄧㄢ
由衷	ㄧㄡˊ ㄓㄨㄥ
郵政	ㄧㄡˊ ㄓㄥˋ
猶豫不決	ㄧㄡˊ ㄩˋ-ㄅㄨˋ ㄐㄩㄝˊ
猶如	ㄧㄡˊ ㄖㄨˊ
油畫	ㄧㄡˊ ㄏㄨㄚˋ
遊船	ㄧㄡˊ ㄔㄨㄢˊ
遊覽	ㄧㄡˊ ㄌㄢˇ
友情	ㄧㄡˇ ㄑㄧㄥˊ
友人	ㄧㄡˇ ㄖㄣˊ
友善	ㄧㄡˇ ㄕㄢˋ
有待	ㄧㄡˇ ㄉㄞˋ
有的放矢	ㄧㄡˇ ㄉㄧˋ-ㄈㄤˋ ㄕˇ
有機	ㄧㄡˇ ㄐㄧ
有口無心	ㄧㄡˇ ㄎㄡˇ-ㄨˊ ㄒㄧㄣ
有聲有色	ㄧㄡˇ ㄕㄥ-ㄧㄡˇ ㄙㄜˋ
有兩下子	ㄧㄡˇ ㄌㄧㄤˇ ㄒㄧㄚˋ ㄗ˙
有所不同	ㄧㄡˇ ㄙㄨㄛˇ ㄅㄨˋ ㄊㄨㄥˊ
有所	ㄧㄡˇ ㄙㄨㄛˇ
有望	ㄧㄡˇ ㄨㄤˋ
有效期	ㄧㄡˇ ㄒㄧㄠˋ ㄑㄧ
有幸	ㄧㄡˇ ㄒㄧㄥˋ
有序	ㄧㄡˇ ㄒㄩˋ
有益	ㄧㄡˇ ㄧˋ
有意	ㄧㄡˇ ㄧˋ
有朝一日	ㄧㄡˇ ㄓㄠ-ㄧ ㄖˋ
幼稚	ㄧㄡˋ ㄓˋ
有助於	ㄧㄡˇ ㄓㄨˋ ㄩˊ
誘餌	ㄧㄡˋ ㄦˇ
誘惑	ㄧㄡˋ ㄏㄨㄛˋ
誘發	ㄧㄡˋ ㄈㄚ
誘人	ㄧㄡˋ ㄖㄣˊ
餘地	ㄩˊ ㄉㄧˋ
餘額	ㄩˊ ㄜˊ
余	ㄩˊ
漁船	ㄩˊ ㄔㄨㄢˊ
漁民	ㄩˊ ㄇㄧㄣˊ
逾期	ㄩˊ ㄑㄧ
愚蠢	ㄩˊ ㄔㄨㄣˇ
愚公移山	ㄩˊ ㄍㄨㄥ-ㄧˊ ㄕㄢ
輿論	ㄩˊ ㄌㄨㄣˋ
與此同時	ㄩˇ ㄘˇ ㄊㄨㄥˊ ㄕˊ
與其	ㄩˇ ㄑㄧˊ
與否	ㄩˇ ㄈㄡˇ
與眾不同	ㄩˇ ㄓㄨㄥˋ-ㄅㄨˋ ㄊㄨㄥˊ
與日俱增	ㄩˇ ㄖˋ-ㄐㄩˋ ㄗㄥ
與時俱進	ㄩˇ ㄕˊ-ㄐㄩˋ ㄐㄧㄣˋ
宇宙	ㄩˇ ㄓㄡˋ
予以	ㄩˇ ㄧˇ
浴室	ㄩˋ ㄕˋ
預定	ㄩˋ ㄉㄧㄥˋ
預感	ㄩˋ ㄍㄢˇ
語氣	ㄩˇ ㄑㄧˋ
預告	ㄩˋ ㄍㄠˋ
預見	ㄩˋ ㄐㄧㄢˋ
預料	ㄩˋ ㄌㄧㄠˋ
預示	ㄩˋ ㄕˋ
預賽	ㄩˋ ㄙㄞˋ
預售	ㄩˋ ㄕㄡˋ
預算	ㄩˋ ㄙㄨㄢˋ
預先	ㄩˋ ㄒㄧㄢ
預言	ㄩˋ ㄧㄢˊ
慾望	ㄩˋ ㄨㄤˋ
遇難	ㄩˋ ㄋㄢˋ
遇險	ㄩˋ ㄒㄧㄢˇ
寓言	ㄩˋ ㄧㄢˊ
預兆	ㄩˋ ㄓㄠˋ
遇上	ㄩˋ ㄕㄤˋ
寓意	ㄩˋ ㄧˋ
愈來愈	ㄩˋ ㄌㄞˊ ㄩˋ
愈演愈烈	ㄩˋ ㄧㄢˇ-ㄩˋ ㄌㄧㄝˋ
癒合	ㄩˋ ㄏㄜˊ
淵源	ㄩㄢ ㄩㄢˊ
冤	ㄩㄢ
元老	ㄩㄢˊ ㄌㄠˇ
元首	ㄩㄢˊ ㄕㄡˇ
元宵節	ㄩㄢˊ ㄒㄧㄠ ㄐㄧㄝˊ
原本	ㄩㄢˊ ㄅㄣˇ
冤枉	ㄩㄢ ㄨㄤ˙
原材料	ㄩㄢˊ ㄘㄞˊ ㄌㄧㄠˋ
原地	ㄩㄢˊ ㄉㄧˋ
原創	ㄩㄢˊ ㄔㄨㄤˋ
原型	ㄩㄢˊ ㄒㄧㄥˊ
原裝	ㄩㄢˊ ㄓㄨㄤ
原汁原味	ㄩㄢˊ ㄓ-ㄩㄢˊ ㄨㄟˋ
圓形	ㄩㄢˊ ㄒㄧㄥˊ
緣分	ㄩㄢˊ ㄈㄣ˙
源泉	ㄩㄢˊ ㄑㄩㄢˊ
源於	ㄩㄢˊ ㄩˊ
源頭	ㄩㄢˊ ㄊㄡˊ
源源不斷	ㄩㄢˊ ㄩㄢˊ ㄅㄨˋ ㄉㄨㄢˋ
遠程	ㄩㄢˇ ㄔㄥˊ
遠見	ㄩㄢˇ ㄐㄧㄢˋ
遠近聞名	ㄩㄢˇ ㄐㄧㄣˋ ㄨㄣˊ ㄇㄧㄥˊ
怨恨	ㄩㄢˋ ㄏㄣˋ
怨言	ㄩㄢˋ ㄧㄢˊ
怨氣	ㄩㄢˋ ㄑㄧˋ
院士	ㄩㄢˋ ㄕˋ
約定俗成	ㄩㄝ ㄉㄧㄥˋ-ㄙㄨˊ ㄔㄥˊ
月初	ㄩㄝˋ ㄔㄨ
曰	ㄩㄝ
月票	ㄩㄝˋ ㄆㄧㄠˋ
樂器	ㄩㄝˋ ㄑㄧˋ
岳父	ㄩㄝˋ ㄈㄨˋ
岳母	ㄩㄝˋ ㄇㄨˇ
悅耳	ㄩㄝˋ ㄦˇ
越發	ㄩㄝˋ ㄈㄚ
閱歷	ㄩㄝˋ ㄌㄧˋ
越過	ㄩㄝˋ ㄍㄨㄛˋ
暈倒	ㄩㄣ ㄉㄠˇ
孕婦	ㄩㄣˋ ㄈㄨˋ
隕石	ㄩㄣˇ ㄕˊ
孕育	ㄩㄣˋ ㄩˋ
運送	ㄩㄣˋ ㄙㄨㄥˋ
運河	ㄩㄣˋ ㄏㄜˊ
運營	ㄩㄣˋ ㄧㄥˊ
運轉	ㄩㄣˋ ㄓㄨㄢˇ
韻味	ㄩㄣˋ ㄨㄟˋ
醞釀	ㄩㄣˋ ㄋㄧㄤˋ
蘊涵	ㄩㄣˋ ㄏㄢˊ
蘊藏	ㄩㄣˋ ㄘㄤˊ
雜亂無章	ㄗㄚˊ ㄌㄨㄢˋ-ㄨˊ ㄓㄤ
雜技	ㄗㄚˊ ㄐㄧˋ
雜交	ㄗㄚˊ ㄐㄧㄠ
砸	ㄗㄚˊ
栽	ㄗㄞ
栽培	ㄗㄞ ㄆㄟˊ
再度	ㄗㄞˋ ㄉㄨˋ
宰	ㄗㄞˇ
再現	ㄗㄞˋ ㄒㄧㄢˋ
在線	ㄗㄞˋ ㄒㄧㄢˋ
在意	ㄗㄞˋ ㄧˋ
載體	ㄗㄞˋ ㄊㄧˇ
在職	ㄗㄞˋ ㄓˊ
暫	ㄗㄢˋ
攢	ㄗㄢˇ
贊不絕口	ㄗㄢˋ ㄅㄨˋ ㄐㄩㄝˊ ㄎㄡˇ
贊嘆	ㄗㄢˋ ㄊㄢˋ
贊嘆不已	ㄗㄢˋ ㄊㄢˋ ㄅㄨˋ ㄧˇ
贊同	ㄗㄢˋ ㄊㄨㄥˊ
贊許	ㄗㄢˋ ㄒㄩˇ
贊美	ㄗㄢˋ ㄇㄟˇ
贊揚	ㄗㄢˋ ㄧㄤˊ
葬禮	ㄗㄤˋ ㄌㄧˇ
遭殃	ㄗㄠ ㄧㄤ
鑿	ㄗㄠˊ
葬	ㄗㄤˋ
早日	ㄗㄠˇ ㄖˋ
早年	ㄗㄠˇ ㄋㄧㄢˊ
棗	ㄗㄠˇ
造假	ㄗㄠˋ ㄐㄧㄚˇ
造價	ㄗㄠˋ ㄐㄧㄚˋ
造福	ㄗㄠˋ ㄈㄨˊ
造就	ㄗㄠˋ ㄐㄧㄡˋ
噪聲	ㄗㄠˋ ㄕㄥ
造紙術	ㄗㄠˋ ㄓˇ ㄕㄨˋ
則	ㄗㄜˊ
噪音	ㄗㄠˋ ㄧㄣ
責備	ㄗㄜˊ ㄅㄟˋ
責怪	ㄗㄜˊ ㄍㄨㄞˋ
增收	ㄗㄥ ㄕㄡ
賊	ㄗㄟˊ
扎根	ㄓㄚ ㄍㄣ
增添	ㄗㄥ ㄊㄧㄢ
閘	ㄓㄚˊ
渣子	ㄓㄚ ㄗ˙
眨眼	ㄓㄚˇ ㄧㄢˇ
炸	ㄓㄚˋ
詐騙	ㄓㄚˋ ㄆㄧㄢˋ
榨	ㄓㄚˋ
窄	ㄓㄞˇ
債務	ㄓㄞˋ ㄨˋ
沾	ㄓㄢ
占卜	ㄓㄢ ㄅㄨˇ
沾光	ㄓㄢ ㄍㄨㄤ
瞻仰	ㄓㄢ ㄧㄤˇ
粘	ㄓㄢ
斬	ㄓㄢˇ
斬草除根	ㄓㄢˇ ㄘㄠˇ-ㄔㄨˊ ㄍㄣ
展出	ㄓㄢˇ ㄔㄨ
盞	ㄓㄢˇ
展覽會	ㄓㄢˇ ㄌㄢˇ ㄏㄨㄟˋ
展望	ㄓㄢˇ ㄨㄤˋ
占用	ㄓㄢˋ ㄩㄥˋ
嶄新	ㄓㄢˇ ㄒㄧㄣ
站立	ㄓㄢˋ ㄌㄧˋ
綻放	ㄓㄢˋ ㄈㄤˋ
張燈結彩	ㄓㄤ ㄉㄥ-ㄐㄧㄝˊ ㄘㄞˇ
蘸	ㄓㄢˋ
張貼	ㄓㄤ ㄊㄧㄝ
張揚	ㄓㄤ ㄧㄤˊ
長相	ㄓㄤˇ ㄒㄧㄤˋ
掌管	ㄓㄤˇ ㄍㄨㄢˇ
帳篷	ㄓㄤˋ ㄆㄥ˙
長輩	ㄓㄤˇ ㄅㄟˋ
帳子	ㄓㄤˋ ㄗ˙
賬單	ㄓㄤˋ ㄉㄢ
脹	ㄓㄤˋ
賬號	ㄓㄤˋ ㄏㄠˋ
招標	ㄓㄠ ㄅㄧㄠ
招待	ㄓㄠ ㄉㄞˋ
招待會	ㄓㄠ ㄉㄞˋ ㄏㄨㄟˋ
招募	ㄓㄠ ㄇㄨˋ
招攬	ㄓㄠ ㄌㄢˇ
招牌	ㄓㄠ ㄆㄞ˙
朝氣蓬勃	ㄓㄠ ㄑㄧˋ-ㄆㄥˊ ㄅㄛˊ
招數	ㄓㄠ ㄕㄨˋ
朝三暮四	ㄓㄠ ㄙㄢ-ㄇㄨˋ ㄙˋ
朝夕相處	ㄓㄠ ㄒㄧ ㄒㄧㄤ ㄔㄨˇ
招收	ㄓㄠ ㄕㄡ
著迷	ㄓㄠˊ ㄇㄧˊ
沼澤	ㄓㄠˇ ㄗㄜˊ
兆頭	ㄓㄠˋ ㄊㄡ˙
召集	ㄓㄠˋ ㄐㄧˊ
照辦	ㄓㄠˋ ㄅㄢˋ
照常	ㄓㄠˋ ㄔㄤˊ
照例	ㄓㄠˋ ㄌㄧˋ
照料	ㄓㄠˋ ㄌㄧㄠˋ
罩	ㄓㄠˋ
照明	ㄓㄠˋ ㄇㄧㄥˊ
肇事	ㄓㄠˋ ㄕˋ
折騰	ㄓㄜ ㄊㄥ˙
遮	ㄓㄜ
遮蓋	ㄓㄜ ㄍㄞˋ
折合	ㄓㄜˊ ㄏㄜˊ
折疊	ㄓㄜˊ ㄉㄧㄝˊ
折磨	ㄓㄜˊ ㄇㄛ˙
折扣	ㄓㄜˊ ㄎㄡˋ
折射	ㄓㄜˊ ㄕㄜˋ
這會兒	ㄓㄜˋ ㄏㄨㄟˋ ㄦ˙
這樣一來	ㄓㄜˋ ㄧㄤˋ ㄧ ㄌㄞˊ
針鋒相對	ㄓㄣ ㄈㄥ-ㄒㄧㄤ ㄉㄨㄟˋ
偵察	ㄓㄣ ㄔㄚˊ
針灸	ㄓㄣ ㄐㄧㄡˇ
珍藏	ㄓㄣ ㄘㄤˊ
珍重	ㄓㄣ ㄓㄨㄥˋ
珍視	ㄓㄣ ㄕˋ
真空	ㄓㄣ ㄎㄨㄥ
真假	ㄓㄣ ㄐㄧㄚˇ
真情	ㄓㄣ ㄑㄧㄥˊ
真心	ㄓㄣ ㄒㄧㄣ
真是的	ㄓㄣ ㄕ˙ ㄉㄜ˙
診所	ㄓㄣˇ ㄙㄨㄛˇ
真摯	ㄓㄣ ㄓˋ
枕頭	ㄓㄣˇ ㄊㄡ˙
陣營	ㄓㄣˋ ㄧㄥˊ
陣容	ㄓㄣˋ ㄖㄨㄥˊ
振興	ㄓㄣˋ ㄒㄧㄥ
振作	ㄓㄣˋ ㄗㄨㄛˋ
振奮	ㄓㄣˋ ㄈㄣˋ
震動	ㄓㄣˋ ㄉㄨㄥˋ
震	ㄓㄣˋ
震撼	ㄓㄣˋ ㄏㄢˋ
鎮定	ㄓㄣˋ ㄉㄧㄥˋ
爭吵	ㄓㄥ ㄔㄠˇ
爭端	ㄓㄥ ㄉㄨㄢ
爭分奪秒	ㄓㄥ ㄈㄣ-ㄉㄨㄛˊ ㄇㄧㄠˇ
爭光	ㄓㄥ ㄍㄨㄤ
爭氣	ㄓㄥ ㄑㄧˋ
爭先恐後	ㄓㄥ ㄒㄧㄢ-ㄎㄨㄥˇ ㄏㄡˋ
征	ㄓㄥ
爭執	ㄓㄥ ㄓˊ
徵收	ㄓㄥ ㄕㄡ
徵集	ㄓㄥ ㄐㄧˊ
癥結	ㄓㄥ ㄐㄧㄝˊ
睜	ㄓㄥ
掙扎	ㄓㄥ ㄓㄚˊ
拯救	ㄓㄥˇ ㄐㄧㄡˋ
蒸	ㄓㄥ
整合	ㄓㄥˇ ㄏㄜˊ
整潔	ㄓㄥˇ ㄐㄧㄝˊ
正面	ㄓㄥˋ ㄇㄧㄢˋ
正能量	ㄓㄥˋ ㄋㄥˊ ㄌㄧㄤˋ
正視	ㄓㄥˋ ㄕˋ
正直	ㄓㄥˋ ㄓˊ
正宗	ㄓㄥˋ ㄗㄨㄥ
整數	ㄓㄥˇ ㄕㄨˋ
鄭重	ㄓㄥˋ ㄓㄨㄥˋ
之	ㄓ
證人	ㄓㄥˋ ㄖㄣ˙
支票	ㄓ ㄆㄧㄠˋ
之所以	ㄓ ㄙㄨㄛˇ ㄧˇ
汁	ㄓ
支柱	ㄓ ㄓㄨˋ
芝麻	ㄓ ㄇㄚ˙
芝士	ㄓ ㄕˋ
知覺	ㄓ ㄐㄩㄝˊ
知己	ㄓ ㄐㄧˇ
知識分子	ㄓ ㄕ˙ ㄈㄣˋ ㄗˇ
知足	ㄓ ㄗㄨˊ
脂肪	ㄓ ㄈㄤˊ
肢體	ㄓ ㄊㄧˇ
執意	ㄓˊ ㄧˋ
執照	ㄓˊ ㄓㄠˋ
執法	ㄓˊ ㄈㄚˇ
執著	ㄓˊ ㄓㄨㄛˊ
直奔	ㄓˊ ㄅㄣˋ
直觀	ㄓˊ ㄍㄨㄢ
直達	ㄓˊ ㄉㄚˊ
直徑	ㄓˊ ㄐㄧㄥˋ
直視	ㄓˊ ㄕˋ
直覺	ㄓˊ ㄐㄩㄝˊ
值錢	ㄓˊ ㄑㄧㄢˊ
職權	ㄓˊ ㄑㄩㄢˊ
直至	ㄓˊ ㄓˋ
職業病	ㄓˊ ㄧㄝˋ ㄅㄧㄥˋ
止步	ㄓˇ ㄅㄨˋ
職員	ㄓˊ ㄩㄢˊ
止血	ㄓˇ ㄒㄩㄝˋ
止咳	ㄓˇ ㄎㄜˊ
旨在	ㄓˇ ㄗㄞˋ
指點	ㄓˇ ㄉㄧㄢˇ
指令	ㄓˇ ㄌㄧㄥˋ
指教	ㄓˇ ㄐㄧㄠˋ
指南針	ㄓˇ ㄋㄢˊ ㄓㄣ
指手畫腳	ㄓˇ ㄕㄡˇ-ㄏㄨㄚˋ ㄐㄧㄠˇ
指望	ㄓˇ ㄨㄤ˙
指南	ㄓˇ ㄋㄢˊ
指向	ㄓˇ ㄒㄧㄤˋ
指引	ㄓˇ ㄧㄣˇ
至此	ㄓˋ ㄘˇ
至關重要	ㄓˋ ㄍㄨㄢ ㄓㄨㄥˋ ㄧㄠˋ
製	ㄓˋ
志氣	ㄓˋ ㄑㄧ˙
制服	ㄓˋ ㄈㄨˊ
制裁	ㄓˋ ㄘㄞˊ
制止	ㄓˋ ㄓˇ
製品	ㄓˋ ㄆㄧㄣˇ
質地	ㄓˋ ㄉㄧˋ
質問	ㄓˋ ㄨㄣˋ
質樸	ㄓˋ ㄆㄨˇ
質疑	ㄓˋ ㄧˊ
治學	ㄓˋ ㄒㄩㄝˊ
治癒	ㄓˋ ㄩˋ
致敬	ㄓˋ ㄐㄧㄥˋ
致	ㄓˋ
致辭	ㄓˋ ㄘˊ
致力於	ㄓˋ ㄌㄧˋ ㄩˊ
致富	ㄓˋ ㄈㄨˋ
致命	ㄓˋ ㄇㄧㄥˋ
致使	ㄓˋ ㄕˇ
窒息	ㄓˋ ㄒㄧ
秩序	ㄓˋ ㄒㄩˋ
智商	ㄓˋ ㄕㄤ
滯後	ㄓˋ ㄏㄡˋ
滯留	ㄓˋ ㄌㄧㄡˊ
置	ㄓˋ
中國畫	ㄓㄨㄥ ㄍㄨㄛˊ ㄏㄨㄚˋ
中途	ㄓㄨㄥ ㄊㄨˊ
中立	ㄓㄨㄥ ㄌㄧˋ
中型	ㄓㄨㄥ ㄒㄧㄥˊ
中性	ㄓㄨㄥ ㄒㄧㄥˋ
中旬	ㄓㄨㄥ ㄒㄩㄣˊ
中庸	ㄓㄨㄥ ㄩㄥ
忠誠	ㄓㄨㄥ ㄔㄥˊ
忠實	ㄓㄨㄥ ㄕˊ
中止	ㄓㄨㄥ ㄓˇ
忠於	ㄓㄨㄥ ㄩˊ
終結	ㄓㄨㄥ ㄐㄧㄝˊ
忠貞	ㄓㄨㄥ ㄓㄣ
終生	ㄓㄨㄥ ㄕㄥ
終究	ㄓㄨㄥ ㄐㄧㄡ
腫瘤	ㄓㄨㄥˇ ㄌㄧㄡˊ
衷心	ㄓㄨㄥ ㄒㄧㄣ
種族	ㄓㄨㄥˇ ㄗㄨˊ
仲裁	ㄓㄨㄥˋ ㄘㄞˊ
眾所週知	ㄓㄨㄥˋ ㄙㄨㄛˇ ㄓㄡ ㄓ
眾志成城	ㄓㄨㄥˋ ㄓˋ-ㄔㄥˊ ㄔㄥˊ
眾人	ㄓㄨㄥˋ ㄖㄣˊ
重創	ㄓㄨㄥˋ ㄔㄨㄤ
重量級	ㄓㄨㄥˋ ㄌㄧㄤˋ ㄐㄧˊ
重傷	ㄓㄨㄥˋ ㄕㄤ
重任	ㄓㄨㄥˋ ㄖㄣˋ
重型	ㄓㄨㄥˋ ㄒㄧㄥˊ
重中之重	ㄓㄨㄥˋ ㄓㄨㄥ ㄓ ㄓㄨㄥˋ
周邊	ㄓㄡ ㄅㄧㄢ
週到	ㄓㄡ ㄉㄠˋ
重心	ㄓㄨㄥˋ ㄒㄧㄣ
周旋	ㄓㄡ ㄒㄩㄢˊ
周密	ㄓㄡ ㄇㄧˋ
晝夜	ㄓㄡˋ ㄧㄝˋ
驟然	ㄓㄡˋ ㄖㄢˊ
皺	ㄓㄡˋ
朱紅	ㄓㄨ ㄏㄨㄥˊ
株	ㄓㄨ
諸多	ㄓㄨ ㄉㄨㄛ
諸如此類	ㄓㄨ ㄖㄨˊ ㄘˇ ㄌㄟˋ
逐年	ㄓㄨˊ ㄋㄧㄢˊ
主	ㄓㄨˇ
竹竿	ㄓㄨˊ ㄍㄢ
主婦	ㄓㄨˇ ㄈㄨˋ
主編	ㄓㄨˇ ㄅㄧㄢ
主力	ㄓㄨˇ ㄌㄧˋ
主人公	ㄓㄨˇ ㄖㄣˊ ㄍㄨㄥ
主食	ㄓㄨˇ ㄕˊ
主題歌	ㄓㄨˇ ㄊㄧˊ ㄍㄜ
主權	ㄓㄨˇ ㄑㄩㄢˊ
主頁	ㄓㄨˇ ㄧㄝˋ
主義	ㄓㄨˇ ㄧˋ
主宰	ㄓㄨˇ ㄗㄞˇ
主演	ㄓㄨˇ ㄧㄢˇ
拄	ㄓㄨˇ
囑咐	ㄓㄨˇ ㄈㄨ˙
矚目	ㄓㄨˇ ㄇㄨˋ
助威	ㄓㄨˋ ㄨㄟ
住戶	ㄓㄨˋ ㄏㄨˋ
住處	ㄓㄨˋ ㄔㄨ˙
住址	ㄓㄨˋ ㄓˇ
貯藏	ㄓㄨˋ ㄘㄤˊ
注	ㄓㄨˋ
住宿	ㄓㄨˋ ㄙㄨˋ
註定	ㄓㄨˋ ㄉㄧㄥˋ
鑄造	ㄓㄨˋ ㄗㄠˋ
築	ㄓㄨˋ
注入	ㄓㄨˋ ㄖㄨˋ
拽	ㄧㄝˋ
爪子	ㄓㄨㄚˇ ㄗ˙
專長	ㄓㄨㄢ ㄔㄤˊ
專程	ㄓㄨㄢ ㄔㄥˊ
專欄	ㄓㄨㄢ ㄌㄢˊ
專賣店	ㄓㄨㄢ ㄇㄞˋ ㄉㄧㄢˋ
專人	ㄓㄨㄢ ㄖㄣˊ
專制	ㄓㄨㄢ ㄓˋ
專職	ㄓㄨㄢ ㄓˊ
專注	ㄓㄨㄢ ㄓㄨˋ
專著	ㄓㄨㄢ ㄓㄨˋ
磚	ㄓㄨㄢ
轉播	ㄓㄨㄢˇ ㄅㄛ
轉達	ㄓㄨㄢˇ ㄉㄚˊ
轉交	ㄓㄨㄢˇ ㄐㄧㄠ
專櫃	ㄓㄨㄢ ㄍㄨㄟˋ
轉型	ㄓㄨㄢˇ ㄒㄧㄥˊ
轉學	ㄓㄨㄢˇ ㄒㄩㄝˊ
轉機	ㄓㄨㄢˇ ㄐㄧ
轉載	ㄓㄨㄢˇ ㄗㄞˇ
轉折	ㄓㄨㄢˇ ㄓㄜˊ
轉折點	ㄓㄨㄢˇ ㄓㄜˊ ㄉㄧㄢˇ
傳	ㄔㄨㄢˊ
傳記	ㄓㄨㄢˋ ㄐㄧˋ
轉悠	ㄓㄨㄢˋ ㄧㄡ˙
撰寫	ㄓㄨㄢˋ ㄒㄧㄝˇ
轉眼	ㄓㄨㄢˇ ㄧㄢˇ
莊稼	ㄓㄨㄤ ㄐㄧㄚ˙
莊嚴	ㄓㄨㄤ ㄧㄢˊ
莊園	ㄓㄨㄤ ㄩㄢˊ
壯	ㄓㄨㄤˋ
裝扮	ㄓㄨㄤ ㄅㄢˋ
壯大	ㄓㄨㄤˋ ㄉㄚˋ
壯膽	ㄓㄨㄤˋ ㄉㄢˇ
壯麗	ㄓㄨㄤˋ ㄌㄧˋ
狀元	ㄓㄨㄤˋ ㄩㄢ˙
撞擊	ㄓㄨㄤˋ ㄐㄧ
幢	ㄔㄨㄤˊ
追悼會	ㄓㄨㄟ ㄉㄠˋ ㄏㄨㄟˋ
追趕	ㄓㄨㄟ ㄍㄢˇ
追溯	ㄓㄨㄟ ㄙㄨˋ
壯實	ㄓㄨㄤˋ ㄕ˙
追隨	ㄓㄨㄟ ㄙㄨㄟˊ
追尾	ㄓㄨㄟ ㄨㄟˇ
追問	ㄓㄨㄟ ㄨㄣˋ
追蹤	ㄓㄨㄟ ㄗㄨㄥ
墜	ㄓㄨㄟˋ
準許	ㄓㄨㄣˇ ㄒㄩˇ
樁	ㄓㄨㄤ
拙劣	ㄓㄨㄛ ㄌㄧㄝˋ
灼熱	ㄓㄨㄛˊ ㄖㄜˋ
捉迷藏	ㄓㄨㄛ ㄇㄧˊ ㄘㄤˊ
追逐	ㄓㄨㄟ ㄓㄨˊ
準則	ㄓㄨㄣˇ ㄗㄜˊ
酌情	ㄓㄨㄛˊ ㄑㄧㄥˊ
著力	ㄓㄨㄛˊ ㄌㄧˋ
著落	ㄓㄨㄛˊ ㄌㄨㄛˋ
著實	ㄓㄨㄛˊ ㄕˊ
著手	ㄓㄨㄛˊ ㄕㄡˇ
著想	ㄓㄨㄛˊ ㄒㄧㄤˇ
著眼	ㄓㄨㄛˊ ㄧㄢˇ
著眼於	ㄓㄨㄛˊ ㄧㄢˇ ㄩˊ
著重	ㄓㄨㄛˊ ㄓㄨㄥˋ
姿態	ㄗ ㄊㄞˋ
茲	ㄘˊ
資本主義	ㄗ ㄅㄣˇ ㄓㄨˇ ㄧˋ
資歷	ㄗ ㄌㄧˋ
姿勢	ㄗ ㄕˋ
資深	ㄗ ㄕㄣ
卓越	ㄓㄨㄛˊ ㄩㄝˋ
滋潤	ㄗ ㄖㄨㄣˋ
滋味	ㄗ ㄨㄟˋ
子弟	ㄗˇ ㄉㄧˋ
子孫	ㄗˇ ㄙㄨㄣ
自稱	ㄗˋ ㄔㄥ
自卑	ㄗˋ ㄅㄟ
資訊	ㄗ ㄒㄩㄣˋ
自費	ㄗˋ ㄈㄟˋ
自發	ㄗˋ ㄈㄚ
自負	ㄗˋ ㄈㄨˋ
自理	ㄗˋ ㄌㄧˇ
自力更生	ㄗˋ ㄌㄧˋ-ㄍㄥ ㄕㄥ
自強不息	ㄗˋ ㄑㄧㄤˊ-ㄅㄨˋ ㄒㄧ
自然而然	ㄗˋ ㄖㄢˊ ㄦ˙ ㄖㄢˊ
自立	ㄗˋ ㄌㄧˋ
自然界	ㄗˋ ㄖㄢˊ ㄐㄧㄝˋ
自始至終	ㄗˋ ㄕˇ-ㄓˋ ㄓㄨㄥ
自如	ㄗˋ ㄖㄨˊ
自衛	ㄗˋ ㄨㄟˋ
自相矛盾	ㄗˋ ㄒㄧㄤ-ㄇㄠˊ ㄉㄨㄣˋ
自私自利	ㄗˋ ㄙ-ㄗˋ ㄌㄧˋ
自信心	ㄗˋ ㄒㄧㄣˋ ㄒㄧㄣ
自行	ㄗˋ ㄒㄧㄥˊ
自以為是	ㄗˋ ㄧˇ ㄨㄟˊ ㄕˋ
自由自在	ㄗˋ ㄧㄡˊ-ㄗˋ ㄗㄞˋ
自責	ㄗˋ ㄗㄜˊ
自助	ㄗˋ ㄓㄨˋ
自尊	ㄗˋ ㄗㄨㄣ
自尊心	ㄗˋ ㄗㄨㄣ ㄒㄧㄣ
字跡	ㄗˋ ㄐㄧˋ
字體	ㄗˋ ㄊㄧˇ
字眼	ㄗˋ ㄧㄢˇ
宗	ㄗㄨㄥ
宗旨	ㄗㄨㄥ ㄓˇ
字幕	ㄗˋ ㄇㄨˋ
綜上所述	ㄗㄨㄥ ㄕㄤˋ ㄙㄨㄛˇ ㄕㄨˋ
自私	ㄗˋ ㄙ
總額	ㄗㄨㄥˇ ㄜˊ
總的來說	ㄗㄨㄥˇ ㄉㄜ˙ ㄌㄞˊ ㄕㄨㄛ
總計	ㄗㄨㄥˇ ㄐㄧˋ
縱觀	ㄗㄨㄥˋ ㄍㄨㄢ
縱橫交錯	ㄗㄨㄥˋ ㄏㄥˊ-ㄐㄧㄠ ㄘㄨㄛˋ
縱然	ㄗㄨㄥˋ ㄖㄢˊ
縱容	ㄗㄨㄥˋ ㄖㄨㄥˊ
縱深	ㄗㄨㄥˋ ㄕㄣ
粽子	ㄗㄨㄥˋ ㄗ˙
走過場	ㄗㄡˇ ㄍㄨㄛˋ ㄔㄤˇ
總而言之	ㄗㄨㄥˇ ㄦˊ ㄧㄢˊ ㄓ
走近	ㄗㄡˇ ㄐㄧㄣˋ
走廊	ㄗㄡˇ ㄌㄤˊ
走投無路	ㄗㄡˇ ㄊㄡˊ-ㄨˊ ㄌㄨˋ
走彎路	ㄗㄡˇ ㄨㄢ ㄌㄨˋ
走後門	ㄗㄡˇ ㄏㄡˋ ㄇㄣˊ
揍	ㄗㄡˋ
租賃	ㄗㄨ ㄌㄧㄣˋ
足智多謀	ㄗㄨˊ ㄓˋ-ㄉㄨㄛ ㄇㄡˊ
阻擋	ㄗㄨˇ ㄉㄤˇ
阻攔	ㄗㄨˇ ㄌㄢˊ
奏效	ㄗㄡˋ ㄒㄧㄠˋ
阻力	ㄗㄨˇ ㄌㄧˋ
阻撓	ㄗㄨˇ ㄋㄠˊ
組裝	ㄗㄨˇ ㄓㄨㄤ
祖傳	ㄗㄨˇ ㄔㄨㄢˊ
祖籍	ㄗㄨˇ ㄐㄧˊ
祖先	ㄗㄨˇ ㄒㄧㄢ
祖宗	ㄗㄨˇ ㄗㄨㄥ˙
鑽空子	ㄗㄨㄢ ㄎㄨㄥˋ ㄗ˙
鑽研	ㄗㄨㄢ ㄧㄢˊ
組建	ㄗㄨˇ ㄐㄧㄢˋ
鑽石	ㄗㄨㄢˋ ㄕˊ
足跡	ㄗㄨˊ ㄐㄧˋ
嘴唇	ㄗㄨㄟˇ ㄔㄨㄣˊ
罪魁禍首	ㄗㄨㄟˋ ㄎㄨㄟˊ-ㄏㄨㄛˋ ㄕㄡˇ
尊嚴	ㄗㄨㄣ ㄧㄢˊ
尊貴	ㄗㄨㄣ ㄍㄨㄟˋ
遵循	ㄗㄨㄣ ㄒㄩㄣˊ
遵照	ㄗㄨㄣ ㄓㄠˋ
琢磨	ㄓㄨㄛˊ ㄇㄛˊ
罪犯	ㄗㄨㄟˋ ㄈㄢˋ
左顧右盼	ㄗㄨㄛˇ ㄍㄨˋ-ㄧㄡˋ ㄆㄢˋ
佐料	ㄗㄨㄛˇ ㄌㄧㄠˋ
作對	ㄗㄨㄛˋ ㄉㄨㄟˋ
作風	ㄗㄨㄛˋ ㄈㄥ
作物	ㄗㄨㄛˋ ㄨˋ
坐落	ㄗㄨㄛˋ ㄌㄨㄛˋ
作弊	ㄗㄨㄛˋ ㄅㄧˋ
座右銘	ㄗㄨㄛˋ ㄧㄡˋ ㄇㄧㄥˊ
座談	ㄗㄨㄛˋ ㄊㄢˊ
做生意	ㄗㄨㄛˋ ㄕㄥ ㄧ˙
做證	ㄗㄨㄛˋ ㄓㄥˋ
作客	ㄗㄨㄛˋ ㄎㄜˋ
