阿姨	ㄚ ㄧˊ
啊	ㄚ˙
愛國	ㄞˋ ㄍㄨㄛˊ
矮	ㄞˇ
愛護	ㄞˋ ㄏㄨˋ
矮小	ㄞˇ ㄒㄧㄠˇ
按時	ㄢˋ ㄕˊ
安置	ㄢ ㄓˋ
暗示	ㄢˋ ㄕˋ
安	ㄢ
百貨	ㄅㄞˇ ㄏㄨㄛˋ
暗	ㄢˋ
擺	ㄅㄞˇ
擺動	ㄅㄞˇ ㄉㄨㄥˋ
巴士	ㄅㄚ ㄕˋ
擺脫	ㄅㄞˇ ㄊㄨㄛ
辦事	ㄅㄢˋ ㄕˋ
包裹	ㄅㄠ ㄍㄨㄛˇ
敗	ㄅㄞˋ
包括	ㄅㄠ ㄎㄨㄛˋ
寶	ㄅㄠˇ
包含	ㄅㄠ ㄏㄢˊ
寶寶	ㄅㄠˇ ㄅㄠ˙
寶貝	ㄅㄠˇ ㄅㄟˋ
寶貴	ㄅㄠˇ ㄍㄨㄟˋ
寶石	ㄅㄠˇ ㄕˊ
保守	ㄅㄠˇ ㄕㄡˇ
抱	ㄅㄠˋ
背景	ㄅㄟˋ ㄐㄧㄥˇ
倍	ㄅㄟˋ
保密	ㄅㄠˇ ㄇㄧˋ
本科	ㄅㄣˇ ㄎㄜ
薄	ㄅㄠˊ
比分	ㄅㄧˇ ㄈㄣ
畢業	ㄅㄧˋ ㄧㄝˋ
笨	ㄅㄣˋ
畢業生	ㄅㄧˋ ㄧㄝˋ ㄕㄥ
避	ㄅㄧˋ
避免	ㄅㄧˋ ㄇㄧㄢˇ
被迫	ㄅㄟˋ ㄆㄛˋ
辯論	ㄅㄧㄢˋ ㄌㄨㄣˋ
標志	ㄅㄧㄠ ㄓˋ
編	ㄅㄧㄢ
表情	ㄅㄧㄠˇ ㄑㄧㄥˊ
表揚	ㄅㄧㄠˇ ㄧㄤˊ
別	ㄅㄧㄝˊ
冰	ㄅㄧㄥ
冰箱	ㄅㄧㄥ ㄒㄧㄤ
冰雪	ㄅㄧㄥ ㄒㄩㄝˇ
兵	ㄅㄧㄥ
并	ㄅㄧㄥˋ
不要緊	ㄅㄨˋ ㄧㄠˋ ㄐㄧㄣˇ
不管	ㄅㄨˋ ㄍㄨㄢˇ
不在乎	ㄅㄨˋ ㄗㄞˋ ㄏㄨ˙
布置	ㄅㄨˋ ㄓˋ
不然	ㄅㄨˋ ㄖㄢˊ
步行	ㄅㄨˋ ㄒㄧㄥˊ
才	ㄘㄞˊ
擦	ㄘㄚ
材料	ㄘㄞˊ ㄌㄧㄠˋ
財富	ㄘㄞˊ ㄈㄨˋ
財產	ㄘㄞˊ ㄔㄢˇ
參考	ㄘㄢ ㄎㄠˇ
參與	ㄘㄢ ㄩˋ
採訪	ㄘㄞˇ ㄈㄤˇ
操場	ㄘㄠ ㄔㄤˇ
操作	ㄘㄠ ㄗㄨㄛˋ
測量	ㄘㄜˋ ㄌㄧㄤˊ
測	ㄘㄜˋ
測試	ㄘㄜˋ ㄕˋ
茶葉	ㄔㄚˊ ㄧㄝˋ
產品	ㄔㄢˇ ㄆㄧㄣˇ
曾	ㄘㄥˊ
長途	ㄔㄤˊ ㄊㄨˊ
唱片	ㄔㄤˋ ㄆㄧㄢˋ
常識	ㄔㄤˊ ㄕˊ
抄寫	ㄔㄠ ㄒㄧㄝˇ
潮流	ㄔㄠˊ ㄌㄧㄡˊ
抄	ㄔㄠ
潮	ㄔㄠˊ
徹底	ㄔㄜˋ ㄉㄧˇ
潮濕	ㄔㄠˊ ㄕ
沉	ㄔㄣˊ
沉默	ㄔㄣˊ ㄇㄛˋ
沉重	ㄔㄣˊ ㄓㄨㄥˋ
成人	ㄔㄥˊ ㄖㄣˊ
誠實	ㄔㄥˊ ㄕ˙
稱贊	ㄔㄥ ㄗㄢˋ
承擔	ㄔㄥˊ ㄉㄢ
承認	ㄔㄥˊ ㄖㄣˋ
誠信	ㄔㄥˊ ㄒㄧㄣˋ
程序	ㄔㄥˊ ㄒㄩˋ
吃驚	ㄔ ㄐㄧㄥ
承受	ㄔㄥˊ ㄕㄡˋ
尺	ㄔˇ
遲到	ㄔˊ ㄉㄠˋ
沖	ㄔㄨㄥ
尺子	ㄔˇ ㄗ˙
充電	ㄔㄨㄥ ㄉㄧㄢˋ
充電器	ㄔㄨㄥ ㄉㄧㄢˋ ㄑㄧˋ
尺寸	ㄔˇ ㄘㄨㄣ˙
蟲子	ㄔㄨㄥˊ ㄗ˙
充分	ㄔㄨㄥ ㄈㄣˋ
抽	ㄔㄡ
抽獎	ㄔㄡ ㄐㄧㄤˇ
出口	ㄔㄨ ㄎㄡˇ
抽煙	ㄔㄡ ㄧㄢ
出色	ㄔㄨ ㄙㄜˋ
出席	ㄔㄨ ㄒㄧˊ
處於	ㄔㄨˇ ㄩˊ
出售	ㄔㄨ ㄕㄡˋ
處	ㄔㄨˋ
穿上	ㄔㄨㄢ ㄕㄤ˙
窗戶	ㄔㄨㄤ ㄏㄨ˙
窗臺	ㄔㄨㄤ ㄊㄞˊ
傳統	ㄔㄨㄢˊ ㄊㄨㄥˇ
純	ㄔㄨㄣˊ
純淨水	ㄔㄨㄣˊ ㄐㄧㄥˋ ㄕㄨㄟˇ
窗子	ㄔㄨㄤ ㄗ˙
春季	ㄔㄨㄣ ㄐㄧˋ
詞匯	ㄘˊ ㄏㄨㄟˋ
此	ㄘˇ
此外	ㄘˇ ㄨㄞˋ
次	ㄘˋ
刺激	ㄘˋ ㄐㄧ
刺	ㄘˋ
從此	ㄘㄨㄥˊ ㄘˇ
粗	ㄘㄨ
粗心	ㄘㄨ ㄒㄧㄣ
促銷	ㄘㄨˋ ㄒㄧㄠ
措施	ㄘㄨㄛˋ ㄕ
促使	ㄘㄨˋ ㄕˇ
打	ㄉㄚˇ
促進	ㄘㄨˋ ㄐㄧㄣˋ
答案	ㄉㄚˊ ㄢˋ
打雷	ㄉㄚˇ ㄌㄟˊ
打敗	ㄉㄚˇ ㄅㄞˋ
打掃	ㄉㄚˇ ㄙㄠˇ
打折	ㄉㄚˇ ㄓㄜˊ
打針	ㄉㄚˇ ㄓㄣ
大多	ㄉㄚˋ ㄉㄨㄛ
大巴	ㄉㄚˋ ㄅㄚ
大方	ㄉㄚˋ ㄈㄤ˙
大哥	ㄉㄚˋ ㄍㄜ
大規模	ㄉㄚˋ ㄍㄨㄟ ㄇㄛˊ
大會	ㄉㄚˋ ㄏㄨㄟˋ
大姐	ㄉㄚˋ ㄐㄧㄝˇ
大樓	ㄉㄚˋ ㄌㄡˊ
大媽	ㄉㄚˋ ㄇㄚ
大型	ㄉㄚˋ ㄒㄧㄥˊ
大陸	ㄉㄚˋ ㄌㄨˋ
大眾	ㄉㄚˋ ㄓㄨㄥˋ
大爺	ㄉㄚˋ ㄧㄝ˙
代替	ㄉㄞˋ ㄊㄧˋ
袋	ㄉㄞˋ
待遇	ㄉㄞˋ ㄩˋ
戴	ㄉㄞˋ
擔任	ㄉㄢ ㄖㄣˋ
擔保	ㄉㄢ ㄅㄠˇ
擔心	ㄉㄢ ㄒㄧㄣ
單純	ㄉㄢ ㄔㄨㄣˊ
單	ㄉㄢ
單調	ㄉㄢ ㄉㄧㄠˋ
單獨	ㄉㄢ ㄉㄨˊ
導遊	ㄉㄠˇ ㄧㄡˊ
倒閉	ㄉㄠˇ ㄅㄧˋ
淡	ㄉㄢˋ
倒車	ㄉㄠˇ ㄔㄜ
得意	ㄉㄜˊ ㄧˋ
得	ㄉㄜ˙
導致	ㄉㄠˇ ㄓˋ
燈光	ㄉㄥ ㄍㄨㄤ
登	ㄉㄥ
登記	ㄉㄥ ㄐㄧˋ
登錄	ㄉㄥ ㄌㄨˋ
登山	ㄉㄥ ㄕㄢ
的確	ㄉㄧˊ ㄑㄩㄝˋ
敵人	ㄉㄧˊ ㄖㄣˊ
地方	ㄉㄧˋ ㄈㄤ˙
底	ㄉㄧˇ
地面	ㄉㄧˋ ㄇㄧㄢˋ
地位	ㄉㄧˋ ㄨㄟˋ
地下	ㄉㄧˋ ㄒㄧㄚ˙
地址	ㄉㄧˋ ㄓˇ
典型	ㄉㄧㄢˇ ㄒㄧㄥˊ
點名	ㄉㄧㄢˇ ㄇㄧㄥˊ
電燈	ㄉㄧㄢˋ ㄉㄥ
電動車	ㄉㄧㄢˋ ㄉㄨㄥˋ ㄔㄜ
電梯	ㄉㄧㄢˋ ㄊㄧ
電源	ㄉㄧㄢˋ ㄩㄢˊ
定	ㄉㄧㄥˋ
頂	ㄉㄧㄥˇ
冬季	ㄉㄨㄥ ㄐㄧˋ
動畫片	ㄉㄨㄥˋ ㄏㄨㄚˋ ㄆㄧㄢˋ
豆腐	ㄉㄡˋ ㄈㄨ˙
獨立	ㄉㄨˊ ㄌㄧˋ
動搖	ㄉㄨㄥˋ ㄧㄠˊ
獨自	ㄉㄨˊ ㄗˋ
獨特	ㄉㄨˊ ㄊㄜˋ
堵	ㄉㄨˇ
肚子	ㄉㄨˇ ㄗ˙
堵車	ㄉㄨˇ ㄔㄜ
度過	ㄉㄨˋ ㄍㄨㄛˋ
對比	ㄉㄨㄟˋ ㄅㄧˇ
鍛煉	ㄉㄨㄢˋ ㄌㄧㄢˋ
多次	ㄉㄨㄛ ㄘˋ
對於	ㄉㄨㄟˋ ㄩˊ
對付	ㄉㄨㄟˋ ㄈㄨ˙
多年	ㄉㄨㄛ ㄋㄧㄢˊ
多種	ㄉㄨㄛ ㄓㄨㄥˇ
而	ㄦˊ
惡心	ㄜˇ ㄒㄧㄣ˙
兒童	ㄦˊ ㄊㄨㄥˊ
多樣	ㄉㄨㄛ ㄧㄤˋ
而是	ㄦˊ ㄕˋ
二手	ㄦˋ ㄕㄡˇ
耳機	ㄦˇ ㄐㄧ
發揮	ㄈㄚ ㄏㄨㄟ
發票	ㄈㄚ ㄆㄧㄠˋ
發燒	ㄈㄚ ㄕㄠ
法	ㄈㄚˇ
法官	ㄈㄚˇ ㄍㄨㄢ
法律	ㄈㄚˇ ㄌㄩˋ
法院	ㄈㄚˇ ㄩㄢˋ
翻譯	ㄈㄢ ㄧˋ
煩	ㄈㄢˊ
翻	ㄈㄢ
反而	ㄈㄚˇ ㄋㄜˊ ㄦ˙
反映	ㄈㄢˇ ㄧㄥˋ
反	ㄈㄢˇ
方案	ㄈㄢ ㄍㄢˋ
方	ㄈㄤ
方針	ㄈㄤ ㄓㄣ
非	ㄈㄟ
放鬆	ㄈㄤˋ ㄙㄨㄥ
肥	ㄈㄟˊ
分布	ㄈㄣ ㄅㄨˋ
分手	ㄈㄣ ㄕㄡˇ
分為	ㄈㄣ ㄨㄟˊ
…分之…	ㄈㄣ ㄓ
奮鬥	ㄈㄣˋ ㄉㄡˋ
風格	ㄈㄥ ㄍㄜˊ
分散	ㄈㄣ ㄙㄢˋ
風景	ㄈㄥ ㄐㄧㄥˇ
紛紛	ㄈㄣ ㄈㄣ
封閉	ㄈㄥ ㄅㄧˋ
否則	ㄈㄡˇ ㄗㄜˊ
風俗	ㄈㄥ ㄙㄨˊ
夫妻	ㄈㄨ ㄑㄧ
夫人	ㄈㄨ ㄖㄣ˙
夫婦	ㄈㄨ ㄈㄨˋ
符合	ㄈㄨˊ ㄏㄜˊ
付出	ㄈㄨˋ ㄔㄨ
符號	ㄈㄨˊ ㄏㄠˋ
附近	ㄈㄨˋ ㄐㄧㄣˋ
負擔	ㄈㄨˋ ㄉㄢ
複製	ㄈㄨˋ ㄓˋ
改善	ㄍㄞˇ ㄕㄢˋ
改正	ㄍㄞˇ ㄓㄥˋ
概括	ㄍㄞˋ ㄎㄨㄛˋ
感興趣	ㄍㄢˇ ㄒㄧㄥˋ ㄑㄩˋ
高潮	ㄍㄠ ㄔㄠˊ
蓋	ㄍㄞˋ
高價	ㄍㄠ ㄐㄧㄚˋ
格外	ㄍㄜˊ ㄨㄞˋ
高鐵	ㄍㄠ ㄊㄧㄝˇ
高尚	ㄍㄠ ㄕㄤˋ
隔	ㄍㄜˊ
隔開	ㄍㄜˊ ㄎㄞ
個別	ㄍㄜˋ ㄅㄧㄝˊ
各個	ㄍㄜˋ ㄍㄜˋ
個體	ㄍㄜˋ ㄊㄧˇ
根	ㄍㄣ
根據	ㄍㄣ ㄐㄩˋ
工程	ㄍㄨㄥ ㄔㄥˊ
供應	ㄍㄨㄥ ㄧㄥˋ
共	ㄍㄨㄥˋ
構成	ㄍㄡˋ ㄔㄥˊ
公元	ㄍㄨㄥ ㄩㄢˊ
構造	ㄍㄡˋ ㄗㄠˋ
購物	ㄍㄡˋ ㄨˋ
購買	ㄍㄡˋ ㄇㄞˇ
骨頭	ㄍㄨˇ ㄊㄡ˙
固定	ㄍㄨˋ ㄉㄧㄥˋ
怪	ㄍㄨㄞˋ
關	ㄍㄨㄢ
關閉	ㄍㄨㄢ ㄅㄧˋ
官方	ㄍㄨㄢ ㄈㄤ
官	ㄍㄨㄢ
光臨	ㄍㄨㄤ ㄌㄧㄣˊ
關於	ㄍㄨㄢ ㄩˊ
歸	ㄍㄨㄟ
逛	ㄍㄨㄤˋ
光盤	ㄍㄨㄤ ㄆㄢˊ
瓜	ㄍㄨㄚ
規律	ㄍㄨㄟ ㄌㄩˋ
規則	ㄍㄨㄟ ㄗㄜˊ
果實	ㄍㄨㄛˇ ㄕˊ
海水	ㄏㄞˇ ㄕㄨㄟˇ
過分	ㄍㄨㄛˋ ㄈㄣˋ
海鮮	ㄏㄞˇ ㄒㄧㄢ
含	ㄏㄢˊ
規模	ㄍㄨㄟ ㄇㄛˊ
含量	ㄏㄢˊ ㄌㄧㄤˋ
含有	ㄏㄢˊ ㄧㄡˇ
含義	ㄏㄢˊ ㄧˋ
寒假	ㄏㄢˊ ㄐㄧㄚˋ
寒冷	ㄏㄢˊ ㄌㄥˇ
航班	ㄏㄤˊ ㄅㄢ
航空	ㄏㄤˊ ㄎㄨㄥ
毫米	ㄏㄠˊ ㄇㄧˇ
行業	ㄏㄤˊ ㄧㄝˋ
好友	ㄏㄠˇ ㄧㄡˇ
毫升	ㄏㄠˊ ㄕㄥ
好	ㄏㄠˇ
號碼	ㄏㄠˋ ㄇㄚˇ
黑暗	ㄏㄟ ㄢˋ
合同	ㄏㄜˊ ㄊㄨㄥ˙
紅包	ㄏㄨㄥˊ ㄅㄠ
厚	ㄏㄡˋ
後頭	ㄏㄡˋ ㄊㄡ˙
忽視	ㄏㄨ ㄕˋ
戶	ㄏㄨˋ
呼吸	ㄏㄨ ㄒㄧ
花	ㄏㄨㄚ
護士	ㄏㄨˋ ㄕ˙
懷念	ㄏㄨㄞˊ ㄋㄧㄢˋ
劃	ㄏㄨㄚˋ
懷疑	ㄏㄨㄞˊ ㄧˊ
黃瓜	ㄏㄨㄤˊ ㄍㄨㄚ˙
緩解	ㄏㄨㄢˇ ㄐㄧㄝˇ
黃金	ㄏㄨㄤˊ ㄐㄧㄣ
回復	ㄏㄨㄟˊ ㄈㄨˋ
匯	ㄏㄨㄟˋ
彙報	ㄏㄨㄟˋ ㄅㄠˋ
婚禮	ㄏㄨㄣ ㄌㄧˇ
匯率	ㄏㄨㄟˋ ㄌㄩˋ
伙	ㄏㄨㄛˇ
火	ㄏㄨㄛˇ
或許	ㄏㄨㄛˋ ㄒㄩˇ
伙伴	ㄏㄨㄛˇ ㄅㄢˋ
獲	ㄏㄨㄛˋ
獲得	ㄏㄨㄛˋ ㄉㄜˊ
獲獎	ㄏㄨㄛˋ ㄐㄧㄤˇ
獲取	ㄏㄨㄛˋ ㄑㄩˇ
機構	ㄐㄧ ㄍㄡˋ
貨	ㄏㄨㄛˋ
幾乎	ㄐㄧ ㄏㄨ
積累	ㄐㄧ ㄌㄟˇ
激動	ㄐㄧ ㄉㄨㄥˋ
激烈	ㄐㄧ ㄌㄧㄝˋ
及格	ㄐㄧˊ ㄍㄜˊ
極	ㄐㄧˊ
機遇	ㄐㄧ ㄩˋ
即將	ㄐㄧˊ ㄐㄧㄤ
急忙	ㄐㄧˊ ㄇㄤˊ
記載	ㄐㄧˋ ㄗㄞˇ
極其	ㄐㄧˊ ㄑㄧˊ
技巧	ㄐㄧˋ ㄑㄧㄠˇ
集合	ㄐㄧˊ ㄏㄜˊ
紀律	ㄐㄧˋ ㄌㄩˋ
系	ㄒㄧˋ
季	ㄐㄧˋ
季度	ㄐㄧˋ ㄉㄨˋ
既	ㄐㄧˋ
既然	ㄐㄧˋ ㄖㄢˊ
加班	ㄐㄧㄚ ㄅㄢ
季節	ㄐㄧˋ ㄐㄧㄝˊ
寄	ㄐㄧˋ
加入	ㄐㄧㄚ ㄖㄨˋ
家務	ㄐㄧㄚ ㄨˋ
加油站	ㄐㄧㄚ ㄧㄡˊ ㄓㄢˋ
假如	ㄐㄧㄚˇ ㄖㄨˊ
檢測	ㄐㄧㄢˇ ㄘㄜˋ
減肥	ㄐㄧㄢˇ ㄈㄟˊ
減少	ㄐㄧㄢˇ ㄕㄠˇ
堅固	ㄐㄧㄢ ㄍㄨˋ
減	ㄐㄧㄢˇ
簡歷	ㄐㄧㄢˇ ㄌㄧˋ
健身	ㄐㄧㄢˋ ㄕㄣ
講究	ㄐㄧㄤˇ ㄐㄧㄡ˙
漸漸	ㄐㄧㄢˋ ㄐㄧㄢˋ
江	ㄐㄧㄤ
講座	ㄐㄧㄤˇ ㄗㄨㄛˋ
獎	ㄐㄧㄤˇ
獎金	ㄐㄧㄤˇ ㄐㄧㄣ
獎學金	ㄐㄧㄤˇ ㄒㄩㄝˊ ㄐㄧㄣ
降價	ㄐㄧㄤˋ ㄐㄧㄚˋ
降	ㄐㄧㄤˋ
降低	ㄐㄧㄤˋ ㄉㄧ
降落	ㄐㄧㄤˋ ㄌㄨㄛˋ
交換	ㄐㄧㄠ ㄏㄨㄢˋ
交際	ㄐㄧㄠ ㄐㄧˋ
教授	ㄐㄧㄠˋ ㄕㄡˋ
教訓	ㄐㄧㄠˋ ㄒㄩㄣ˙
階段	ㄐㄧㄝ ㄉㄨㄢˋ
街道	ㄐㄧㄝ ㄉㄠˋ
節省	ㄐㄧㄝˊ ㄕㄥˇ
結構	ㄐㄧㄝˊ ㄍㄡˋ
結	ㄐㄧㄝˊ
降溫	ㄐㄧㄤˋ ㄨㄣ
姐妹	ㄐㄧㄝˇ ㄇㄟˋ
結論	ㄐㄧㄝˊ ㄌㄨㄣˋ
解釋	ㄐㄧㄝˇ ㄕˋ
儘快	ㄐㄧㄣˇ ㄎㄨㄞˋ
盡力	ㄐㄧㄣˋ ㄌㄧˋ
進口	ㄐㄧㄣˋ ㄎㄡˇ
禁止	ㄐㄧㄣˋ ㄓˇ
緊密	ㄐㄧㄣˇ ㄇㄧˋ
近代	ㄐㄧㄣˋ ㄉㄞˋ
經典	ㄐㄧㄥ ㄉㄧㄢˇ
竟然	ㄐㄧㄥˋ ㄖㄢˊ
鏡頭	ㄐㄧㄥˋ ㄊㄡˊ
精力	ㄐㄧㄥ ㄌㄧˋ
鏡子	ㄐㄧㄥˋ ㄗ˙
酒吧	ㄐㄧㄡˇ ㄅㄚ
究竟	ㄐㄧㄡ ㄐㄧㄥˋ
居民	ㄐㄩ ㄇㄧㄣˊ
局	ㄐㄩˊ
居住	ㄐㄩ ㄓㄨˋ
距離	ㄐㄩˋ ㄌㄧˊ
巨大	ㄐㄩˋ ㄉㄚˋ
聚會	ㄐㄩˋ ㄏㄨㄟˋ
聚	ㄐㄩˋ
具備	ㄐㄩˋ ㄅㄟˋ
角色	ㄐㄩㄝˊ ㄙㄜˋ
開花	ㄎㄞ ㄏㄨㄚ
捲	ㄐㄩㄢˇ
開水	ㄎㄞ ㄕㄨㄟˇ
看來	ㄎㄢˋ ㄌㄞ˙
看不起	ㄎㄢˋ ㄅㄨ˙ ㄑㄧˇ
看望	ㄎㄢˋ ㄨㄤ˙
考察	ㄎㄠˇ ㄔㄚˊ
考慮	ㄎㄠˇ ㄌㄩˋ
可見	ㄎㄜˇ ㄐㄧㄢˋ
空間	ㄎㄨㄥ ㄐㄧㄢ
空	ㄎㄨㄥ
棵	ㄎㄜ
口袋	ㄎㄡˇ ㄉㄞ˙
苦	ㄎㄨˇ
口語	ㄎㄡˇ ㄩˇ
快遞	ㄎㄨㄞˋ ㄉㄧˋ
寬廣	ㄎㄨㄢ ㄍㄨㄤˇ
礦泉水	ㄎㄨㄤˋ ㄑㄩㄢˊ ㄕㄨㄟˇ
會計	ㄎㄨㄞˋ ㄐㄧ˙
擴大	ㄎㄨㄛˋ ㄉㄚˋ
擴展	ㄎㄨㄛˋ ㄓㄢˇ
寬	ㄎㄨㄢ
垃圾	ㄌㄚ ㄐㄧ
括號	ㄎㄨㄛˋ ㄏㄠˋ
拉開	ㄌㄚ ㄎㄞ˙
來不及	ㄌㄞˊ ㄅㄨ˙ ㄐㄧˊ
辣	ㄌㄚˋ
來得及	ㄌㄞˊ ㄉㄜ˙ ㄐㄧˊ
來源	ㄌㄞˊ ㄩㄢˊ
老家	ㄌㄠˇ ㄐㄧㄚ
老婆	ㄌㄠˇ ㄆㄛ˙
老公	ㄌㄠˇ ㄍㄨㄥ˙
老實	ㄌㄠˇ ㄕ˙
淚	ㄌㄟˋ
淚水	ㄌㄟˋ ㄕㄨㄟˇ
樂趣	ㄌㄜˋ ㄑㄩˋ
類型	ㄌㄟˋ ㄒㄧㄥˊ
釐米	ㄌㄧˊ ㄇㄧˇ
冷靜	ㄌㄥˇ ㄐㄧㄥˋ
離不開	ㄌㄧˊ ㄅㄨ˙ ㄎㄞ
力氣	ㄌㄧˋ ㄑㄧ˙
歷史	ㄌㄧˋ ㄕˇ
立即	ㄌㄧˋ ㄐㄧˊ
利益	ㄌㄧˋ ㄧˋ
利息	ㄌㄧˋ ㄒㄧ
量	ㄌㄧㄤˋ
良好	ㄌㄧㄤˊ ㄏㄠˇ
兩邊	ㄌㄧㄤˇ ㄅㄧㄢ
糧食	ㄌㄧㄤˊ ㄕ˙
了不起	ㄌㄧㄠˇ ㄅㄨ˙ ㄑㄧˇ
療養	ㄌㄧㄠˊ ㄧㄤˇ
了解	ㄌㄧㄠˇ ㄐㄧㄝˇ
列	ㄌㄧㄝˋ
列車	ㄌㄧㄝˋ ㄔㄜ
列入	ㄌㄧㄝˋ ㄖㄨˋ
列為	ㄌㄧㄝˋ ㄨㄟˊ
倆	ㄌㄧㄚˇ
臨時	ㄌㄧㄣˊ ㄕˊ
零食	ㄌㄧㄥˊ ㄕˊ
流傳	ㄌㄧㄡˊ ㄔㄨㄢˊ
樓梯	ㄌㄡˊ ㄊㄧ
陸續	ㄌㄨˋ ㄒㄩˋ
陸地	ㄌㄨˋ ㄉㄧˋ
律師	ㄌㄩˋ ㄕ
錄取	ㄌㄨˋ ㄑㄩˇ
輪	ㄌㄨㄣˊ
輪椅	ㄌㄨㄣˊ ㄧˇ
論文	ㄌㄨㄣˋ ㄨㄣˊ
輪船	ㄌㄨㄣˊ ㄔㄨㄢˊ
落	ㄌㄨㄛˋ
輪子	ㄌㄨㄣˊ ㄗ˙
毛巾	ㄇㄠˊ ㄐㄧㄣ
毛衣	ㄇㄠˊ ㄧ
帽子	ㄇㄠˋ ㄗ˙
沒法兒	ㄇㄟˊ ㄈㄚˇ ㄦ˙
沒錯	ㄇㄟˊ ㄘㄨㄛˋ
沒想到	ㄇㄟˊ ㄒㄧㄤˇ ㄉㄠˋ
美金	ㄇㄟˇ ㄐㄧㄣ
美女	ㄇㄟˇ ㄋㄩˇ
夢見	ㄇㄥˋ ㄐㄧㄢˋ
夢想	ㄇㄥˋ ㄒㄧㄤˇ
夢	ㄇㄥˋ
祕密	ㄇㄧˋ ㄇㄧˋ
祕書	ㄇㄧˋ ㄕㄨ
密碼	ㄇㄧˋ ㄇㄚˇ
密	ㄇㄧˋ
密切	ㄇㄧˋ ㄑㄧㄝ
面臨	ㄇㄧㄢˋ ㄌㄧㄣˊ
免費	ㄇㄧㄢˇ ㄈㄟˋ
面試	ㄇㄧㄢˋ ㄕˋ
描寫	ㄇㄧㄠˊ ㄒㄧㄝˇ
描述	ㄇㄧㄠˊ ㄕㄨˋ
名牌兒	ㄇㄧㄥˊ ㄆㄞˊ ㄦ˙
名人	ㄇㄧㄥˊ ㄖㄣˊ
名片	ㄇㄧㄥˊ ㄆㄧㄢˋ
摸	ㄇㄛ
模特兒	ㄇㄛˊ ㄊㄜˋ ㄦ˙
模型	ㄇㄛˊ ㄒㄧㄥˊ
末	ㄇㄛˋ
默默	ㄇㄛˋ ㄇㄛˋ
哪	ㄋㄚˇ
男女	ㄋㄢˊ ㄋㄩˇ
男士	ㄋㄢˊ ㄕˋ
難免	ㄋㄢˊ ㄇㄧㄢˇ
哪怕	ㄋㄚˇ ㄆㄚˋ
腦袋	ㄋㄠˇ ㄉㄞ˙
鬧	ㄋㄠˋ
鬧鐘	ㄋㄠˋ ㄓㄨㄥ
內部	ㄋㄟˋ ㄅㄨˋ
內科	ㄋㄟˋ ㄎㄜ
能幹	ㄋㄥˊ ㄍㄢˋ
寧靜	ㄋㄧㄥˊ ㄐㄧㄥˋ
濃	ㄋㄨㄥˊ
女士	ㄋㄩˇ ㄕˋ
暖氣	ㄋㄨㄢˇ ㄑㄧˋ
拍照	ㄆㄞ ㄓㄠˋ
排列	ㄆㄞˊ ㄌㄧㄝˋ
牌	ㄆㄞˊ
盤	ㄆㄢˊ
盤子	ㄆㄢˊ ㄗ˙
胖子	ㄆㄤˋ ㄗ˙
培訓	ㄆㄟˊ ㄒㄩㄣˋ
培訓班	ㄆㄟˊ ㄒㄩㄣˋ ㄅㄢ
培養	ㄆㄟˊ ㄧㄤˇ
批	ㄆㄧ
培育	ㄆㄟˊ ㄩˋ
品質	ㄆㄧㄣˇ ㄓˋ
片面	ㄆㄧㄢˋ ㄇㄧㄢˋ
平方	ㄆㄧㄥˊ ㄈㄤ
平均	ㄆㄧㄥˊ ㄐㄩㄣ
平靜	ㄆㄧㄥˊ ㄐㄧㄥˋ
迫切	ㄆㄛˋ ㄑㄧㄝˋ
平穩	ㄆㄧㄥˊ ㄨㄣˇ
妻子	ㄑㄧ ㄗ˙
破產	ㄆㄛˋ ㄔㄢˇ
期末	ㄑㄧ ㄇㄛˋ
期待	ㄑㄧ ㄉㄞˋ
期間	ㄑㄧ ㄐㄧㄢ
期中	ㄑㄧ ㄓㄨㄥ
期限	ㄑㄧ ㄒㄧㄢˋ
企業	ㄑㄧˇ ㄧㄝˋ
氣球	ㄑㄧˋ ㄑㄧㄡˊ
其餘	ㄑㄧˊ ㄩˊ
汽水	ㄑㄧˋ ㄕㄨㄟˇ
器官	ㄑㄧˋ ㄍㄨㄢ
前途	ㄑㄧㄢˊ ㄊㄨˊ
汽油	ㄑㄧˋ ㄧㄡˊ
淺	ㄑㄧㄢˇ
前頭	ㄑㄧㄢˊ ㄊㄡ˙
巧克力	ㄑㄧㄠˇ ㄎㄜˋ ㄌㄧˋ
親密	ㄑㄧㄣ ㄇㄧˋ
親愛	ㄑㄧ ㄋㄞˋ
切	ㄑㄧㄝˋ
青春	ㄑㄧㄥ ㄔㄨㄣ
輕鬆	ㄑㄧㄥ ㄙㄨㄥ
輕易	ㄑㄧㄥ ㄧ˙
清醒	ㄑㄧㄥ ㄒㄧㄥˇ
情景	ㄑㄧㄥˊ ㄐㄧㄥˇ
窮	ㄑㄩㄥˊ
窮人	ㄑㄩㄥˊ ㄖㄣˊ
趨勢	ㄑㄩ ㄕˋ
秋季	ㄑㄧㄡ ㄐㄧˋ
圈	ㄑㄩㄢ
權利	ㄑㄩㄢˊ ㄌㄧˋ
卻	ㄑㄩㄝˋ
確認	ㄑㄩㄝˋ ㄖㄣˋ
燃料	ㄖㄢˊ ㄌㄧㄠˋ
然而	ㄖㄢˊ ㄦ˙
燃燒	ㄖㄢˊ ㄕㄠ
熱心	ㄖㄜˋ ㄒㄧㄣ
熱鬧	ㄖㄜˋ ㄋㄠ˙
人家	ㄖㄣˊ ㄐㄧㄚ˙
日曆	ㄖˋ ㄌㄧˋ
如今	ㄖㄨˊ ㄐㄧㄣ
日記	ㄖˋ ㄐㄧˋ
弱	ㄖㄨㄛˋ
散	ㄙㄢˋ
掃	ㄙㄠˇ
色	ㄙㄜˋ
傘	ㄙㄢˇ
色彩	ㄙㄜˋ ㄘㄞˇ
閃	ㄕㄢˇ
閃電	ㄕㄢˇ ㄉㄧㄢˋ
曬	ㄕㄞˋ
傷害	ㄕㄤ ㄏㄞˋ
善於	ㄕㄢˋ ㄩˊ
善良	ㄕㄢˋ ㄌㄧㄤˊ
商務	ㄕㄤ ㄨˋ
上個月	ㄕㄤˋ ㄍㄜˋ ㄩㄝˋ
賞	ㄕㄤˇ
上門	ㄕㄤˋ ㄇㄣˊ
上樓	ㄕㄤˋ ㄌㄡˊ
燒	ㄕㄠ
設置	ㄕㄜˋ ㄓˋ
申請	ㄕㄣ ㄑㄧㄥˇ
身材	ㄕㄣ ㄘㄞˊ
設施	ㄕㄜˋ ㄕ
深厚	ㄕㄣ ㄏㄡˋ
身份	ㄕㄣ ㄈㄣ˙
身高	ㄕㄣ ㄍㄠ
神祕	ㄕㄣˊ ㄇㄧˋ
失敗	ㄕ ㄅㄞˋ
甚至	ㄕㄣˋ ㄓˋ
神話	ㄕㄣˊ ㄏㄨㄚˋ
失業	ㄕ ㄧㄝˋ
詩	ㄕ
詩人	ㄕ ㄖㄣˊ
失望	ㄕ ㄨㄤˋ
實用	ㄕˊ ㄩㄥˋ
濕	ㄕ
食堂	ㄕˊ ㄊㄤˊ
實施	ㄕˊ ㄕ
使勁	ㄕˇ ㄐㄧㄣˋ
士兵	ㄕˋ ㄅㄧㄥ
市區	ㄕˋ ㄑㄩ
似的	ㄕˋ ㄉㄜ˙
事物	ㄕˋ ㄨˋ
事先	ㄕˋ ㄒㄧㄢ
是否	ㄕˋ ㄈㄡˇ
試卷	ㄕˋ ㄐㄩㄢˋ
收回	ㄕㄡ ㄏㄨㄟˊ
收益	ㄕㄡ ㄧˋ
收穫	ㄕㄡ ㄏㄨㄛˋ
手裡	ㄕㄡˇ ㄌㄧ˙
守	ㄕㄡˇ
手術	ㄕㄡˇ ㄕㄨˋ
手工	ㄕㄡˇ ㄍㄨㄥ
受不了	ㄕㄡˋ ㄅㄨ˙ ㄌㄧㄠˇ
手套	ㄕㄡˇ ㄊㄠˋ
首	ㄕㄡˇ
售貨員	ㄕㄡˋ ㄏㄨㄛˋ ㄩㄢˊ
舒適	ㄕㄨ ㄕˋ
叔叔	ㄕㄨ ㄕㄨ˙
熟練	ㄕㄨˊ ㄌㄧㄢˋ
暑假	ㄕㄨˇ ㄐㄧㄚˋ
樹林	ㄕㄨˋ ㄌㄧㄣˊ
數據	ㄕㄨˋ ㄐㄩˋ
樹葉	ㄕㄨˋ ㄧㄝˋ
數碼	ㄕㄨˋ ㄇㄚˇ
刷	ㄕㄨㄚ
刷牙	ㄕㄨㄚ ㄧㄚˊ
刷子	ㄕㄨㄚ ㄗ˙
帥	ㄕㄨㄞˋ
帥哥	ㄕㄨㄞˋ ㄍㄜ
睡著	ㄕㄨㄟˋ ㄓㄠˊ
率先	ㄕㄨㄞˋ ㄒㄧㄢ
說不定	ㄕㄨㄛ ㄅㄨ˙ ㄉㄧㄥˋ
說服	ㄕㄨㄛ ㄈㄨˊ
似乎	ㄙˋ ㄏㄨ
順序	ㄕㄨㄣˋ ㄒㄩˋ
松樹	ㄙㄨㄥ ㄕㄨˋ
思考	ㄙ ㄎㄠˇ
松	ㄙㄨㄥ
塑料袋	ㄙㄨˋ ㄌㄧㄠˋ ㄉㄞˋ
酸	ㄙㄨㄢ
塑料	ㄙㄨˋ ㄌㄧㄠˋ
酸奶	ㄙㄨㄢ ㄋㄞˇ
隨手	ㄙㄨㄟˊ ㄕㄡˇ
孫子	ㄙㄨㄣ ㄗ˙
孫女	ㄙㄨㄣ ㄋㄩ˙
縮短	ㄙㄨㄛ ㄉㄨㄢˇ
臺階	ㄊㄞˊ ㄐㄧㄝ
縮小	ㄙㄨㄛ ㄒㄧㄠˇ
臺上	ㄊㄞˊ ㄕㄤˋ
套餐	ㄊㄠˋ ㄘㄢ
躺	ㄊㄤˇ
特殊	ㄊㄜˋ ㄕㄨ
特徵	ㄊㄜˋ ㄓㄥ
提醒	ㄊㄧˊ ㄒㄧㄥˇ
特價	ㄊㄜˋ ㄐㄧㄚˋ
提供	ㄊㄧˊ ㄍㄨㄥ
體重	ㄊㄧˇ ㄓㄨㄥˋ
體操	ㄊㄧˇ ㄘㄠ
體檢	ㄊㄧˇ ㄐㄧㄢˇ
替代	ㄊㄧˋ ㄉㄞˋ
替	ㄊㄧˋ
天真	ㄊㄧㄢ ㄓㄣ
填空	ㄊㄧㄢˊ ㄎㄨㄥˋ
填	ㄊㄧㄢˊ
挑	ㄊㄧㄠ
挑選	ㄊㄧㄠ ㄒㄩㄢˇ
調皮	ㄊㄧㄠˊ ㄆㄧˊ
貼	ㄊㄧㄝ
挑戰	ㄊㄧㄠˇ ㄓㄢˋ
停下	ㄊㄧㄥˊ ㄒㄧㄚˋ
挺	ㄊㄧㄥˇ
通知書	ㄊㄨㄥ ㄓ ㄕㄨ
童話	ㄊㄨㄥˊ ㄏㄨㄚˋ
同情	ㄊㄨㄥˊ ㄑㄧㄥˊ
統計	ㄊㄨㄥˇ ㄐㄧˋ
童年	ㄊㄨㄥˊ ㄋㄧㄢˊ
統一	ㄊㄨㄥˇ ㄧ
投	ㄊㄡˊ
痛快	ㄊㄨㄥˋ ㄎㄨㄞ˙
投訴	ㄊㄡˊ ㄙㄨˋ
投入	ㄊㄡˊ ㄖㄨˋ
透	ㄊㄡˋ
投資	ㄊㄡˊ ㄗ
途中	ㄊㄨˊ ㄓㄨㄥ
圖案	ㄊㄨˊ ㄢˋ
推遲	ㄊㄨㄟ ㄔˊ
土地	ㄊㄨˇ ㄉㄧ˙
透明	ㄊㄡˋ ㄇㄧㄥˊ
推銷	ㄊㄨㄟ ㄒㄧㄠ
襪子	ㄨㄚˋ ㄗ˙
脫	ㄊㄨㄛ
外匯	ㄨㄞˋ ㄏㄨㄟˋ
外交官	ㄨㄞˋ ㄐㄧㄠ ㄍㄨㄢ
外套	ㄨㄞˋ ㄊㄠˋ
晚點	ㄨㄢˇ ㄉㄧㄢˇ
彎	ㄨㄢ
萬一	ㄨㄢˋ ㄧ
王	ㄨㄤˊ
網絡	ㄨㄤˇ ㄌㄨㄛˋ
微笑	ㄨㄟ ㄒㄧㄠˋ
網址	ㄨㄤˇ ㄓˇ
圍巾	ㄨㄟˊ ㄐㄧㄣ
微信	ㄨㄟ ㄒㄧㄣˋ
維持	ㄨㄟˊ ㄔˊ
維護	ㄨㄟˊ ㄏㄨˋ
維修	ㄨㄟˊ ㄒㄧㄡ
尾巴	ㄨㄟˇ ㄅㄚ˙
未必	ㄨㄟˋ ㄅㄧˋ
未來	ㄨㄟˋ ㄌㄞˊ
位於	ㄨㄟˋ ㄩˊ
位置	ㄨㄟˋ ㄓ˙
喂	ㄨㄟˋ
味兒	ㄨㄟˋ ㄦ˙
穩	ㄨㄣˇ
穩定	ㄨㄣˇ ㄉㄧㄥˋ
無	ㄨˊ
無法	ㄨˊ ㄈㄚˇ
無聊	ㄨˊ ㄌㄧㄠˊ
無論	ㄨˊ ㄌㄨㄣˋ
問候	ㄨㄣˋ ㄏㄡˋ
無所謂	ㄨˊ ㄙㄨㄛˇ ㄨㄟˋ
無數	ㄨˊ ㄕㄨˋ
無限	ㄨˊ ㄒㄧㄢˋ
五顏六色	ㄨˇ ㄧㄢˊ-ㄌㄧㄡˋ ㄙㄜˋ
西瓜	ㄒㄧ ㄍㄨㄚ˙
誤會	ㄨˋ ㄏㄨㄟˋ
吸	ㄒㄧ
吸管	ㄒㄧ ㄍㄨㄢˇ
吸收	ㄒㄧ ㄕㄡ
吸煙	ㄒㄧ ㄧㄢ
吸引	ㄒㄧ ㄧㄣˇ
喜愛	ㄒㄧˇ ㄞˋ
系統	ㄒㄧˋ ㄊㄨㄥˇ
系列	ㄒㄧˋ ㄌㄧㄝˋ
細	ㄒㄧˋ
細節	ㄒㄧˋ ㄐㄧㄝˊ
細緻	ㄒㄧˋ ㄓˋ
下降	ㄒㄧㄚˋ ㄐㄧㄤˋ
下個月	ㄒㄧㄚˋ ㄍㄜˋ ㄩㄝˋ
下樓	ㄒㄧㄚˋ ㄌㄡˊ
夏季	ㄒㄧㄚˋ ㄐㄧˋ
下載	ㄒㄧㄚˋ ㄗㄞˋ
鮮	ㄒㄧㄢ
鮮花	ㄒㄧㄢ ㄏㄨㄚ
鮮明	ㄒㄧㄢ ㄇㄧㄥˊ
鹹	ㄒㄧㄢˊ
顯著	ㄒㄧㄢˇ ㄓㄨˋ
縣	ㄒㄧㄢˋ
限制	ㄒㄧㄢˋ ㄓˋ
相處	ㄒㄧㄤ ㄔㄨˇ
相反	ㄒㄧㄤ ㄈㄢˇ
箱	ㄒㄧㄤ
箱子	ㄒㄧㄤ ㄗ˙
想念	ㄒㄧㄤˇ ㄋㄧㄢˋ
想象	ㄒㄧㄤˇ ㄒㄧㄤˋ
項目	ㄒㄧㄤˋ ㄇㄨˋ
項	ㄒㄧㄤˋ
相片	ㄒㄧㄤˋ ㄆㄧㄢˋ
銷售	ㄒㄧㄠ ㄕㄡˋ
消化	ㄒㄧㄠ ㄏㄨㄚˋ
小吃	ㄒㄧㄠˇ ㄔ
小伙子	ㄒㄧㄠˇ ㄏㄨㄛˇ ㄗ˙
小型	ㄒㄧㄠˇ ㄒㄧㄥˊ
效率	ㄒㄧㄠˋ ㄌㄩˋ
些	ㄒㄧㄝ
心理	ㄒㄧㄣ ㄌㄧˇ
新郎	ㄒㄧㄣ ㄌㄤˊ
新娘	ㄒㄧㄣ ㄋㄧㄤˊ
新鮮	ㄒㄧㄣ ㄒㄧㄢ˙
新型	ㄒㄧㄣ ㄒㄧㄥˊ
興奮	ㄒㄧㄥ ㄈㄣˋ
形容	ㄒㄧㄥˊ ㄖㄨㄥˊ
形勢	ㄒㄧㄥˊ ㄕˋ
型	ㄒㄧㄥˊ
型號	ㄒㄧㄥˊ ㄏㄠˋ
醒	ㄒㄧㄥˇ
興趣	ㄒㄧㄥˋ ㄑㄩˋ
性質	ㄒㄧㄥˋ ㄓˋ
胸部	ㄒㄩㄥ ㄅㄨˋ
兄弟	ㄒㄩㄥ ㄉㄧ˙
修理	ㄒㄧㄡ ㄌㄧˇ
選擇	ㄒㄩㄢˇ ㄗㄜˊ
學年	ㄒㄩㄝˊ ㄋㄧㄢˊ
學分	ㄒㄩㄝˊ ㄈㄣ
學時	ㄒㄩㄝˊ ㄕˊ
學問	ㄒㄩㄝˊ ㄨㄣ˙
學術	ㄒㄩㄝˊ ㄕㄨˋ
尋找	ㄒㄩㄣˊ ㄓㄠˇ
牙	ㄧㄚˊ
迅速	ㄒㄩㄣˋ ㄙㄨˋ
亞運會	ㄧㄚˋ ㄩㄣˋ ㄏㄨㄟˋ
牙刷	ㄧㄚˊ ㄕㄨㄚ
呀	ㄧㄚ˙
延長	ㄧㄢˊ ㄔㄤˊ
延期	ㄧㄢˊ ㄑㄧ
嚴格	ㄧㄢˊ ㄍㄜˊ
嚴	ㄧㄢˊ
延續	ㄧㄢˊ ㄒㄩˋ
嚴重	ㄧㄢˊ ㄓㄨㄥˋ
研究	ㄧㄢˊ ㄐㄧㄡ
研究生	ㄧㄢˊ ㄐㄧㄡ ㄕㄥ
研製	ㄧㄢˊ ㄓˋ
鹽	ㄧㄢˊ
眼鏡	ㄧㄢˇ ㄐㄧㄥˋ
眼淚	ㄧㄢˇ ㄌㄟˋ
演講	ㄧㄢˇ ㄐㄧㄤˇ
陽臺	ㄧㄤˊ ㄊㄞˊ
腰	ㄧㄠ
眼裡	ㄧㄢˇ ㄌㄧ˙
養成	ㄧㄤˇ ㄔㄥˊ
藥物	ㄧㄠˋ ㄨˋ
搖	ㄧㄠˊ
要	ㄧㄠˋ
業餘	ㄧㄝˋ ㄩˊ
醫療	ㄧ ㄌㄧㄠˊ
醫學	ㄧ ㄒㄩㄝˊ
依靠	ㄧ ㄎㄠˋ
一律	ㄧ ㄌㄩˋ
一致	ㄧ ㄓˋ
葉子	ㄧㄝˋ ㄗ˙
依然	ㄧ ㄖㄢˊ
一再	ㄧ ㄗㄞˋ
移動	ㄧˊ ㄉㄨㄥˋ
移	ㄧˊ
遺產	ㄧˊ ㄔㄢˇ
移民	ㄧˊ ㄇㄧㄣˊ
遺傳	ㄧˊ ㄔㄨㄢˊ
疑問	ㄧˊ ㄨㄣˋ
以及	ㄧˇ ㄐㄧˊ
以內	ㄧˇ ㄋㄟˋ
一般來說	ㄧ ㄅㄢ ㄌㄞˊ ㄕㄨㄛ
義務	ㄧˋ ㄨˋ
議論	ㄧˋ ㄌㄨㄣˋ
引	ㄧㄣˇ
引導	ㄧㄣˇ ㄉㄠˇ
引起	ㄧㄣˇ ㄑㄧˇ
引進	ㄧㄣˇ ㄐㄧㄣˋ
應	ㄧㄥ
英勇	ㄧㄥ ㄩㄥˇ
營業	ㄧㄥˊ ㄧㄝˋ
影子	ㄧㄥˇ ㄗ˙
勇敢	ㄩㄥˇ ㄍㄢˇ
贏得	ㄧㄥˊ ㄉㄜˊ
用途	ㄩㄥˋ ㄊㄨˊ
優良	ㄧㄡ ㄌㄧㄤˊ
勇氣	ㄩㄥˇ ㄑㄧˋ
優美	ㄧㄡ ㄇㄟˇ
郵局	ㄧㄡˊ ㄐㄩˊ
優秀	ㄧㄡ ㄒㄧㄡˋ
有勁兒	ㄧㄡˇ ㄐㄧㄣˋ ㄦ˙
有限	ㄧㄡˇ ㄒㄧㄢˋ
有趣	ㄧㄡˇ ㄑㄩˋ
幼兒園	ㄧㄡˋ ㄦˊ ㄩㄢˊ
於是	ㄩˊ ㄕˋ
語法	ㄩˇ ㄈㄚˇ
玉	ㄩˋ
語音	ㄩˇ ㄧㄣ
預訂	ㄩˋ ㄉㄧㄥˋ
玉米	ㄩˋ ㄇㄧˇ
預測	ㄩˋ ㄘㄜˋ
遇	ㄩˋ
遇見	ㄩˋ ㄐㄧㄢ˙
遇到	ㄩˋ ㄉㄠˋ
原料	ㄩㄢˊ ㄌㄧㄠˋ
圓	ㄩㄢˊ
原則	ㄩㄢˊ ㄗㄜˊ
圓滿	ㄩㄢˊ ㄇㄢˇ
約會	ㄩㄝ ㄏㄨㄟ˙
月底	ㄩㄝˋ ㄉㄧˇ
運動會	ㄩㄣˋ ㄉㄨㄥˋ ㄏㄨㄟˋ
閱讀	ㄩㄝˋ ㄉㄨˊ
運動員	ㄩㄣˋ ㄉㄨㄥˋ ㄩㄢˊ
運氣	ㄩㄣˋ ㄑㄧ˙
運用	ㄩㄣˋ ㄩㄥˋ
在乎	ㄗㄞˋ ㄏㄨ˙
再三	ㄗㄞˋ ㄙㄢ
贊成	ㄗㄢˋ ㄔㄥˊ
在於	ㄗㄞˋ ㄩˊ
贊賞	ㄗㄢˋ ㄕㄤˇ
贊助	ㄗㄢˋ ㄓㄨˋ
造型	ㄗㄠˋ ㄒㄧㄥˊ
戰鬥	ㄓㄢˋ ㄉㄡˋ
戰士	ㄓㄢˋ ㄕˋ
戰勝	ㄓㄢˋ ㄕㄥˋ
戰爭	ㄓㄢˋ ㄓㄥ
丈夫	ㄓㄤˋ ㄈㄨ˙
著	ㄓㄜ˙
招呼	ㄓㄠ ㄏㄨ˙
著火	ㄓㄠˊ ㄏㄨㄛˇ
著急	ㄓㄠˊ ㄐㄧˊ
召開	ㄓㄠˋ ㄎㄞ
折	ㄓㄜˊ
針	ㄓㄣ
針對	ㄓㄣ ㄉㄨㄟˋ
陣	ㄓㄣˋ
爭論	ㄓㄥ ㄌㄨㄣˋ
征服	ㄓㄥ ㄈㄨˊ
政府	ㄓㄥˋ ㄈㄨˇ
徵求	ㄓㄥ ㄑㄧㄡˊ
政治	ㄓㄥˋ ㄓˋ
之前	ㄓ ㄑㄧㄢˊ
之後	ㄓ ㄏㄡˋ
之一	ㄓ ㄧ
支	ㄓ
之間	ㄓ ㄐㄧㄢ
植物	ㄓˊ ㄨˋ
制訂	ㄓˋ ㄉㄧㄥˋ
指揮	ㄓˇ ㄏㄨㄟ
質量	ㄓˋ ㄌㄧㄤˋ
治	ㄓˋ
治療	ㄓˋ ㄌㄧㄠˊ
智力	ㄓˋ ㄌㄧˋ
智能	ㄓˋ ㄋㄥˊ
中介	ㄓㄨㄥ ㄐㄧㄝˋ
種類	ㄓㄨㄥˇ ㄌㄟˋ
中獎	ㄓㄨㄥˋ ㄐㄧㄤˇ
種植	ㄓㄨㄥˋ ㄓˊ
種	ㄓㄨㄥˇ
逐漸	ㄓㄨˊ ㄐㄧㄢˋ
逐步	ㄓㄨˊ ㄅㄨˋ
重量	ㄓㄨㄥˋ ㄌㄧㄤˋ
主席	ㄓㄨˇ ㄒㄧˊ
祝福	ㄓㄨˋ ㄈㄨˊ
主題	ㄓㄨˇ ㄊㄧˊ
著名	ㄓㄨˋ ㄇㄧㄥˊ
抓緊	ㄓㄨㄚ ㄐㄧㄣˇ
專心	ㄓㄨㄢ ㄒㄧㄣ
轉動	ㄓㄨㄢˇ ㄉㄨㄥˋ
著作	ㄓㄨˋ ㄗㄨㄛˋ
轉告	ㄓㄨㄢˇ ㄍㄠˋ
轉身	ㄓㄨㄢˇ ㄕㄣ
轉彎	ㄓㄨㄢˇ ㄨㄢ
裝修	ㄓㄨㄤ ㄒㄧㄡ
裝置	ㄓㄨㄤ ㄓˋ
轉移	ㄓㄨㄢˇ ㄧˊ
準時	ㄓㄨㄣˇ ㄕˊ
追求	ㄓㄨㄟ ㄑㄧㄡˊ
資料	ㄗ ㄌㄧㄠˋ
自	ㄗˋ
資源	ㄗ ㄩㄢˊ
字母	ㄗˋ ㄇㄨˇ
綜合	ㄗㄨㄥ ㄏㄜˊ
自信	ㄗˋ ㄒㄧㄣˋ
總共	ㄗㄨㄥˇ ㄍㄨㄥˋ
總理	ㄗㄨㄥˇ ㄌㄧˇ
總統	ㄗㄨㄥˇ ㄊㄨㄥˇ
總之	ㄗㄨㄥˇ ㄓ
阻止	ㄗㄨˇ ㄓˇ
嘴巴	ㄗㄨㄟˇ ㄅㄚ˙
作出	ㄗㄨㄛˋ ㄔㄨ
作為	ㄗㄨㄛˋ ㄨㄟˊ
最初	ㄗㄨㄟˋ ㄔㄨ
做夢	ㄗㄨㄛˋ ㄇㄥˋ
